CET_TimeStamp,Actual_Total_Load,Day_Ahead_Price,Wind_Onshore_Gen_Actual,Wind_Onshore_generation_forecast,Residual_load
01.01.2018 01:00,2498,26.33,454,446,2044
01.01.2018 02:00,2431,26.43,432,430,1999
01.01.2018 03:00,2402,26.1,440,432,1962
01.01.2018 04:00,2358,24.7,473,431,1885
01.01.2018 05:00,2385,24.74,463,464,1922
01.01.2018 06:00,2441,18.01,511,533,1930
01.01.2018 07:00,2489,17.78,589,600,1900
01.01.2018 08:00,2487,17.8,696,690,1791
01.01.2018 09:00,2478,19.76,786,799,1692
01.01.2018 10:00,2502,20.73,887,880,1615
01.01.2018 11:00,2508,24.76,944,940,1564
01.01.2018 12:00,2504,25.68,947,953,1557
01.01.2018 13:00,2619,24.09,1001,1005,1618
01.01.2018 14:00,2605,25.01,987,991,1618
01.01.2018 15:00,2659,25.81,997,1001,1662
01.01.2018 16:00,2789,26.46,1046,1050,1743
01.01.2018 17:00,2919,27.03,1048,1051,1871
01.01.2018 18:00,3011,27.43,1055,1056,1956
01.01.2018 19:00,2977,27.29,1045,1047,1932
01.01.2018 20:00,2952,26.96,1033,1041,1919
01.01.2018 21:00,2939,26.7,988,1015,1951
01.01.2018 22:00,2781,26.47,945,953,1836
01.01.2018 23:00,2673,26.09,900,894,1773
01.02.2018 00:00,2589,24.88,829,837,1760
01.02.2018 01:00,2575,25.28,841,855,1734
01.02.2018 02:00,2473,23.16,796,801,1677
01.02.2018 03:00,2412,24.78,771,775,1641
01.02.2018 04:00,2389,25.03,762,762,1627
01.02.2018 05:00,2460,25.73,747,746,1713
01.02.2018 06:00,2625,26.84,741,730,1884
01.02.2018 07:00,2989,27.8,703,698,2286
01.02.2018 08:00,3357,30.5,656,659,2701
01.02.2018 09:00,3547,31.93,602,604,2945
01.02.2018 10:00,3532,33.53,493,499,3039
01.02.2018 11:00,3627,35.04,451,456,3176
01.02.2018 12:00,3623,35.22,418,424,3205
01.02.2018 13:00,3577,34.56,393,390,3184
01.02.2018 14:00,3614,34.1,414,410,3200
01.02.2018 15:00,3588,35.98,391,390,3197
01.02.2018 16:00,3643,38.05,403,399,3240
01.02.2018 17:00,3678,41.67,381,375,3297
01.02.2018 18:00,3710,42.39,363,363,3347
01.02.2018 19:00,3730,37.79,355,365,3375
01.02.2018 20:00,3563,34.08,360,342,3203
01.02.2018 21:00,3320,30.88,334,325,2986
01.02.2018 22:00,3133,28.85,325,340,2808
01.02.2018 23:00,3012,27.99,324,332,2688
01.03.2018 00:00,2825,27.6,338,336,2487
01.03.2018 01:00,2718,27.12,304,307,2414
01.03.2018 02:00,2631,26.61,348,352,2283
01.03.2018 03:00,2577,26.26,423,420,2154
01.03.2018 04:00,2533,26.23,500,486,2033
01.03.2018 05:00,2502,26.42,585,576,1917
01.03.2018 06:00,2594,27.47,683,685,1911
01.03.2018 07:00,2899,28.31,786,789,2113
01.03.2018 08:00,3189,28.95,895,899,2294
01.03.2018 09:00,3323,29.2,989,992,2334
01.03.2018 10:00,3399,29.28,1058,1062,2341
01.03.2018 11:00,3610,29.42,1170,1174,2440
01.03.2018 12:00,3646,29.25,1155,1159,2491
01.03.2018 13:00,3676,29.23,1173,1174,2503
01.03.2018 14:00,3804,29.49,1129,1154,2675
01.03.2018 15:00,3919,29.86,1039,1081,2880
01.03.2018 16:00,3891,30.51,952,962,2939
01.03.2018 17:00,3900,31.33,864,853,3036
01.03.2018 18:00,3948,31.59,784,771,3164
01.03.2018 19:00,3926,30.78,726,706,3200
01.03.2018 20:00,3809,30.15,621,618,3188
01.03.2018 21:00,3659,29.37,523,529,3136
01.03.2018 22:00,3453,28.93,433,436,3020
01.03.2018 23:00,3262,28.13,386,388,2876
01.04.2018 00:00,3013,27.31,331,333,2682
01.04.2018 01:00,2760,27.05,217,219,2543
01.04.2018 02:00,2706,26.78,193,195,2513
01.04.2018 03:00,2697,26.47,170,172,2527
01.04.2018 04:00,2704,26.49,149,150,2555
01.04.2018 05:00,2737,26.6,128,129,2609
01.04.2018 06:00,2872,27.01,116,116,2756
01.04.2018 07:00,3195,28.04,117,109,3078
01.04.2018 08:00,3518,30.43,157,99,3361
01.04.2018 09:00,3747,36.3,153,112,3594
01.04.2018 10:00,3760,34.97,133,142,3627
01.04.2018 11:00,3829,37.55,119,132,3710
01.04.2018 12:00,3834,36.02,124,138,3710
01.04.2018 13:00,3844,35.53,138,146,3706
01.04.2018 14:00,3863,35.3,150,158,3713
01.04.2018 15:00,3796,35.83,164,172,3632
01.04.2018 16:00,3841,37.83,159,163,3682
01.04.2018 17:00,3875,39.03,171,182,3704
01.04.2018 18:00,3875,37.91,182,185,3693
01.04.2018 19:00,3830,35.03,180,188,3650
01.04.2018 20:00,3750,31.87,172,180,3578
01.04.2018 21:00,3596,30.78,168,173,3428
01.04.2018 22:00,3373,30.27,156,155,3217
01.04.2018 23:00,3194,29.63,141,143,3053
01.05.2018 00:00,2951,28.05,133,135,2818
01.05.2018 01:00,2793,27.38,90,95,2703
01.05.2018 02:00,2715,26.93,77,80,2638
01.05.2018 03:00,2697,26.5,68,67,2629
01.05.2018 04:00,2704,26.5,49,48,2655
01.05.2018 05:00,2729,26.88,45,39,2684
01.05.2018 06:00,2823,27.66,40,34,2783
01.05.2018 07:00,3131,28.65,41,37,3090
01.05.2018 08:00,3502,30.44,34,37,3468
01.05.2018 09:00,3680,32.96,29,33,3651
01.05.2018 10:00,3696,35.43,28,30,3668
01.05.2018 11:00,3791,37.59,41,37,3750
01.05.2018 12:00,3777,37.55,42,45,3735
01.05.2018 13:00,3737,37.55,55,57,3682
01.05.2018 14:00,3695,37.52,66,61,3629
01.05.2018 15:00,3656,32.94,77,73,3579
01.05.2018 16:00,3699,37.51,67,79,3632
01.05.2018 17:00,3771,37.6,73,85,3698
01.05.2018 18:00,3771,37.56,88,93,3683
01.05.2018 19:00,3664,34,116,101,3548
01.05.2018 20:00,3510,32.25,133,117,3377
01.05.2018 21:00,3348,31.51,152,141,3196
01.05.2018 22:00,3230,31.25,135,147,3095
01.05.2018 23:00,3100,30.44,155,162,2945
01.06.2018 00:00,2932,29.64,175,169,2757
01.06.2018 01:00,2816,29.45,155,141,2661
01.06.2018 02:00,2746,28.55,137,133,2609
01.06.2018 03:00,2713,28.18,121,120,2592
01.06.2018 04:00,2700,28,102,104,2598
01.06.2018 05:00,2699,28.15,86,90,2613
01.06.2018 06:00,2734,28.7,77,80,2657
01.06.2018 07:00,2805,29.48,71,74,2734
01.06.2018 08:00,2941,30.35,70,71,2871
01.06.2018 09:00,3066,30.38,69,72,2997
01.06.2018 10:00,3196,30.9,72,75,3124
01.06.2018 11:00,3320,31.89,72,75,3248
01.06.2018 12:00,3367,32.86,68,71,3299
01.06.2018 13:00,3372,32.17,66,72,3306
01.06.2018 14:00,3346,31.79,84,86,3262
01.06.2018 15:00,3301,31.77,105,108,3196
01.06.2018 16:00,3331,33.05,155,141,3176
01.06.2018 17:00,3515,39.54,184,180,3331
01.06.2018 18:00,3521,41.39,229,222,3292
01.06.2018 19:00,3452,34.45,266,260,3186
01.06.2018 20:00,3328,31.93,324,297,3004
01.06.2018 21:00,3211,31.06,378,331,2833
01.06.2018 22:00,3195,30.72,394,349,2801
01.06.2018 23:00,3116,29.98,401,367,2715
01.07.2018 00:00,3056,29.03,364,380,2692
01.07.2018 01:00,2971,27.58,363,372,2608
01.07.2018 02:00,2931,25.9,329,324,2602
01.07.2018 03:00,2912,25.89,295,293,2617
01.07.2018 04:00,2914,26.16,269,268,2645
01.07.2018 05:00,2985,26.6,232,233,2753
01.07.2018 06:00,3028,27.14,212,208,2816
01.07.2018 07:00,3158,27.43,184,185,2974
01.07.2018 08:00,3329,27.69,152,151,3177
01.07.2018 09:00,3434,27.93,131,129,3303
01.07.2018 10:00,3596,28.33,102,104,3494
01.07.2018 11:00,3608,28.79,93,97,3515
01.07.2018 12:00,3581,28.95,122,127,3459
01.07.2018 13:00,3501,28.96,159,162,3342
01.07.2018 14:00,3407,28.27,215,218,3192
01.07.2018 15:00,3380,28.29,326,330,3054
01.07.2018 16:00,3464,28.62,447,452,3017
01.07.2018 17:00,3692,29.38,538,535,3154
01.07.2018 18:00,3819,30.88,618,612,3201
01.07.2018 19:00,3849,31.51,680,674,3169
01.07.2018 20:00,3773,31.12,726,713,3047
01.07.2018 21:00,3656,29.96,738,731,2918
01.07.2018 22:00,3489,28.94,746,749,2743
01.07.2018 23:00,3343,28.9,727,735,2616
01.08.2018 00:00,3136,27.57,689,693,2447
01.08.2018 01:00,3009,25.03,672,666,2337
01.08.2018 02:00,2911,23.96,616,605,2295
01.08.2018 03:00,2934,23.92,532,523,2402
01.08.2018 04:00,2942,25.48,458,454,2484
01.08.2018 05:00,2989,26.12,373,367,2616
01.08.2018 06:00,3097,27.96,282,283,2815
01.08.2018 07:00,3537,29.62,222,217,3315
01.08.2018 08:00,3990,41.9,160,154,3830
01.08.2018 09:00,4099,43.87,104,102,3995
01.08.2018 10:00,4090,42.57,65,69,4025
01.08.2018 11:00,4120,41.98,47,53,4073
01.08.2018 12:00,4159,41.54,38,43,4121
01.08.2018 13:00,4046,41.87,33,36,4013
01.08.2018 14:00,4044,41.87,35,38,4009
01.08.2018 15:00,4039,39.93,46,49,3993
01.08.2018 16:00,4144,40.97,62,64,4082
01.08.2018 17:00,4220,39.69,81,82,4139
01.08.2018 18:00,4239,40.26,94,98,4145
01.08.2018 19:00,4200,37.08,112,116,4088
01.08.2018 20:00,4093,31.16,123,126,3970
01.08.2018 21:00,3908,29.68,127,132,3781
01.08.2018 22:00,3692,28.92,112,118,3580
01.08.2018 23:00,3499,28.49,121,122,3378
01.09.2018 00:00,3313,28.09,136,135,3177
01.09.2018 01:00,3148,27.17,128,129,3020
01.09.2018 02:00,3095,25.29,148,151,2947
01.09.2018 03:00,3091,25.3,170,177,2921
01.09.2018 04:00,3142,26.58,199,205,2943
01.09.2018 05:00,3199,27.26,248,241,2951
01.09.2018 06:00,3397,28.25,284,296,3113
01.09.2018 07:00,3842,28.99,350,358,3492
01.09.2018 08:00,4258,31.54,444,435,3814
01.09.2018 09:00,4335,32.53,522,502,3813
01.09.2018 10:00,4250,32.26,597,575,3653
01.09.2018 11:00,4263,32.13,638,629,3625
01.09.2018 12:00,4186,32.32,666,660,3520
01.09.2018 13:00,4071,32.04,710,708,3361
01.09.2018 14:00,4003,31.8,760,765,3243
01.09.2018 15:00,3946,31.47,823,828,3123
01.09.2018 16:00,4001,31.4,915,915,3086
01.09.2018 17:00,4056,32.25,958,958,3098
01.09.2018 18:00,4075,32.87,1010,1012,3065
01.09.2018 19:00,3972,32.44,1066,1070,2906
01.09.2018 20:00,3863,31.5,1107,1109,2756
01.09.2018 21:00,3693,30.59,1136,1138,2557
01.09.2018 22:00,3502,30.15,1142,1146,2360
01.09.2018 23:00,3297,29.23,1120,1141,2177
01.10.2018 00:00,3105,28.56,1117,1126,1988
01.10.2018 01:00,2965,28.87,1094,1093,1871
01.10.2018 02:00,2879,28.3,1065,1073,1814
01.10.2018 03:00,2811,27.95,1053,1068,1758
01.10.2018 04:00,2823,27.57,1010,1028,1813
01.10.2018 05:00,2859,28.04,976,995,1883
01.10.2018 06:00,3069,30.17,930,956,2139
01.10.2018 07:00,3581,33.54,880,916,2701
01.10.2018 08:00,3892,44.01,838,873,3054
01.10.2018 09:00,3938,47.98,816,844,3122
01.10.2018 10:00,3891,47.98,806,814,3085
01.10.2018 11:00,3896,48.04,780,779,3116
01.10.2018 12:00,3898,47.78,737,740,3161
01.10.2018 13:00,3861,47.09,696,702,3165
01.10.2018 14:00,3913,44.15,653,662,3260
01.10.2018 15:00,3940,45.97,610,622,3330
01.10.2018 16:00,4029,46.83,592,599,3437
01.10.2018 17:00,4023,48.9,546,554,3477
01.10.2018 18:00,4003,51.9,497,507,3506
01.10.2018 19:00,3908,52.69,440,455,3468
01.10.2018 20:00,3800,44.94,411,418,3389
01.10.2018 21:00,3586,39.72,384,382,3202
01.10.2018 22:00,3351,35.81,377,370,2974
01.10.2018 23:00,3163,31.92,361,356,2802
01.11.2018 00:00,2928,30.34,333,335,2595
01.11.2018 01:00,2828,31.01,345,347,2483
01.11.2018 02:00,2714,30.03,336,331,2378
01.11.2018 03:00,2710,29.86,318,315,2392
01.11.2018 04:00,2729,29.97,302,302,2427
01.11.2018 05:00,2788,30.95,289,293,2499
01.11.2018 06:00,2983,33.24,288,290,2695
01.11.2018 07:00,3358,39.44,289,293,3069
01.11.2018 08:00,3669,51.37,301,308,3368
01.11.2018 09:00,3764,55.65,312,319,3452
01.11.2018 10:00,3680,55.11,321,324,3359
01.11.2018 11:00,3730,55.13,333,337,3397
01.11.2018 12:00,3724,54.57,327,330,3397
01.11.2018 13:00,3687,52.86,342,345,3345
01.11.2018 14:00,3694,46.87,367,371,3327
01.11.2018 15:00,3697,49.91,373,378,3324
01.11.2018 16:00,3789,52.28,447,450,3342
01.11.2018 17:00,3842,54.81,469,477,3373
01.11.2018 18:00,3878,56.38,506,515,3372
01.11.2018 19:00,3766,56.1,576,544,3190
01.11.2018 20:00,3729,40.06,597,563,3132
01.11.2018 21:00,3535,35.14,585,558,2950
01.11.2018 22:00,3387,33.14,578,565,2809
01.11.2018 23:00,3150,31.05,560,534,2590
01.12.2018 00:00,2933,30.06,546,513,2387
01.12.2018 01:00,2854,30,553,526,2301
01.12.2018 02:00,2785,29.42,516,498,2269
01.12.2018 03:00,2737,29.2,483,451,2254
01.12.2018 04:00,2773,29.18,465,443,2308
01.12.2018 05:00,2811,29.6,488,444,2323
01.12.2018 06:00,3088,31.22,477,456,2611
01.12.2018 07:00,3512,33.22,494,475,3018
01.12.2018 08:00,3929,44.19,484,459,3445
01.12.2018 09:00,3965,47.08,486,445,3479
01.12.2018 10:00,3971,44.35,454,445,3517
01.12.2018 11:00,4054,43.57,444,436,3610
01.12.2018 12:00,4056,43.44,420,434,3636
01.12.2018 13:00,4019,39.58,420,414,3599
01.12.2018 14:00,3997,37.63,425,405,3572
01.12.2018 15:00,3925,36.73,412,392,3513
01.12.2018 16:00,3836,35.2,410,377,3426
01.12.2018 17:00,3895,44.07,426,390,3469
01.12.2018 18:00,3907,45.89,437,408,3470
01.12.2018 19:00,3805,43.53,449,447,3356
01.12.2018 20:00,3579,33.11,455,440,3124
01.12.2018 21:00,3429,31.56,434,423,2995
01.12.2018 22:00,3251,31.45,407,406,2844
01.12.2018 23:00,3084,30.36,397,401,2687
13.01.2018 00:00,2975,29.54,372,375,2603
13.01.2018 01:00,2882,30.15,356,363,2526
13.01.2018 02:00,2794,29.63,354,358,2440
13.01.2018 03:00,2764,29.16,360,362,2404
13.01.2018 04:00,2753,28.93,372,373,2381
13.01.2018 05:00,2733,28.79,386,390,2347
13.01.2018 06:00,2824,28.98,406,408,2418
13.01.2018 07:00,2977,29.35,429,426,2548
13.01.2018 08:00,3236,30.28,418,441,2818
13.01.2018 09:00,3395,30.85,430,449,2965
13.01.2018 10:00,3528,31.51,447,454,3081
13.01.2018 11:00,3634,31.81,447,454,3187
13.01.2018 12:00,3737,31.89,451,457,3286
13.01.2018 13:00,3755,31.88,450,440,3305
13.01.2018 14:00,3762,31.85,418,416,3344
13.01.2018 15:00,3705,31.39,369,390,3336
13.01.2018 16:00,3695,31.33,349,358,3346
13.01.2018 17:00,3828,33.92,335,337,3493
13.01.2018 18:00,3828,37.96,341,339,3487
13.01.2018 19:00,3729,36.71,349,343,3380
13.01.2018 20:00,3620,32.07,356,341,3264
13.01.2018 21:00,3454,30.59,382,355,3072
13.01.2018 22:00,3329,29.8,363,349,2966
13.01.2018 23:00,3202,29.34,351,344,2851
14.01.2018 00:00,3080,28.8,341,340,2739
14.01.2018 01:00,2963,28.9,301,295,2662
14.01.2018 02:00,2891,28.44,287,287,2604
14.01.2018 03:00,2852,28.06,283,285,2569
14.01.2018 04:00,2824,27.97,279,289,2545
14.01.2018 05:00,2825,27.87,289,292,2536
14.01.2018 06:00,2864,28.01,304,304,2560
14.01.2018 07:00,2918,28.35,327,325,2591
14.01.2018 08:00,3040,28.55,348,344,2692
14.01.2018 09:00,3188,28.83,367,367,2821
14.01.2018 10:00,3344,29.41,387,395,2957
14.01.2018 11:00,3464,29.74,411,418,3053
14.01.2018 12:00,3554,30.13,427,437,3127
14.01.2018 13:00,3620,29.81,456,456,3164
14.01.2018 14:00,3630,29.44,455,444,3175
14.01.2018 15:00,3644,29.94,432,418,3212
14.01.2018 16:00,3726,31.32,393,395,3333
14.01.2018 17:00,3863,33.97,398,393,3465
14.01.2018 18:00,3960,37.08,415,415,3545
14.01.2018 19:00,3912,36.33,453,448,3459
14.01.2018 20:00,3796,33.38,488,485,3308
14.01.2018 21:00,3638,30.55,520,519,3118
14.01.2018 22:00,3463,29.69,568,558,2895
14.01.2018 23:00,3294,29.33,583,575,2711
15.01.2018 00:00,3143,28.82,597,592,2546
15.01.2018 01:00,3144,26.9,683,675,2461
15.01.2018 02:00,3139,24.61,698,693,2441
15.01.2018 03:00,3103,23.1,715,702,2388
15.01.2018 04:00,3078,20.89,723,711,2355
15.01.2018 05:00,3113,27.15,749,739,2364
15.01.2018 06:00,3315,28.74,797,792,2518
15.01.2018 07:00,3778,30.08,858,856,2920
15.01.2018 08:00,4173,32.35,921,923,3252
15.01.2018 09:00,4243,33.5,966,970,3277
15.01.2018 10:00,4163,32.57,1028,1033,3135
15.01.2018 11:00,4250,31.54,1086,1090,3164
15.01.2018 12:00,4280,30.3,1131,1135,3149
15.01.2018 13:00,4291,29.43,1168,1173,3123
15.01.2018 14:00,4231,29.29,1169,1173,3062
15.01.2018 15:00,4178,29.42,1193,1198,2985
15.01.2018 16:00,4228,29.24,1228,1232,3000
15.01.2018 17:00,4257,29.35,1288,1292,2969
15.01.2018 18:00,4260,30.01,1300,1302,2960
15.01.2018 19:00,4172,29.39,1330,1332,2842
15.01.2018 20:00,4097,29.16,1374,1376,2723
15.01.2018 21:00,3912,28.86,1364,1367,2548
15.01.2018 22:00,3738,28.03,1368,1371,2370
15.01.2018 23:00,3521,24.71,1375,1377,2146
16.01.2018 00:00,3300,16.53,1382,1383,1918
16.01.2018 01:00,3174,26.14,1373,1376,1801
16.01.2018 02:00,3113,23.78,1378,1380,1735
16.01.2018 03:00,3098,20.39,1373,1376,1725
16.01.2018 04:00,3087,21.51,1374,1377,1713
16.01.2018 05:00,3125,23.69,1359,1361,1766
16.01.2018 06:00,3250,27.91,1317,1322,1933
16.01.2018 07:00,3579,29.07,1258,1264,2321
16.01.2018 08:00,3976,31.65,1170,1171,2806
16.01.2018 09:00,4145,32.76,1068,1070,3077
16.01.2018 10:00,4131,33,977,980,3154
16.01.2018 11:00,4119,32.92,876,893,3243
16.01.2018 12:00,4106,32.97,798,800,3308
16.01.2018 13:00,4054,32.89,690,709,3364
16.01.2018 14:00,4041,32.9,593,611,3448
16.01.2018 15:00,3979,32.89,503,511,3476
16.01.2018 16:00,3973,33.78,440,427,3533
16.01.2018 17:00,4031,36.94,389,388,3642
16.01.2018 18:00,4105,42.18,344,355,3761
16.01.2018 19:00,4001,44.34,339,336,3662
16.01.2018 20:00,3894,33.99,289,281,3605
16.01.2018 21:00,3713,34.81,268,258,3445
16.01.2018 22:00,3520,30.69,247,247,3273
16.01.2018 23:00,3268,29.38,215,222,3053
17.01.2018 00:00,3034,27.88,216,213,2818
17.01.2018 01:00,2896,28.14,208,195,2688
17.01.2018 02:00,2888,27.75,201,191,2687
17.01.2018 03:00,2885,27.53,205,193,2680
17.01.2018 04:00,2927,27.47,191,195,2736
17.01.2018 05:00,2969,27.91,178,188,2791
17.01.2018 06:00,3149,29.05,170,182,2979
17.01.2018 07:00,3627,31.47,168,178,3459
17.01.2018 08:00,4044,39.04,160,177,3884
17.01.2018 09:00,4082,44.95,160,172,3922
17.01.2018 10:00,4003,42.49,144,159,3859
17.01.2018 11:00,4058,39.88,137,146,3921
17.01.2018 12:00,4039,38.99,151,153,3888
17.01.2018 13:00,3936,34.75,150,147,3786
17.01.2018 14:00,3923,32.54,145,141,3778
17.01.2018 15:00,3913,32.38,129,130,3784
17.01.2018 16:00,3938,33.11,127,122,3811
17.01.2018 17:00,4025,38.04,128,128,3897
17.01.2018 18:00,4118,38.9,161,159,3957
17.01.2018 19:00,3996,38.44,157,158,3839
17.01.2018 20:00,3930,34.26,179,183,3751
17.01.2018 21:00,3770,31.2,220,225,3550
17.01.2018 22:00,3559,30.57,215,219,3344
17.01.2018 23:00,3380,29.92,223,213,3157
18.01.2018 00:00,3175,29.33,215,218,2960
18.01.2018 01:00,3009,29.12,187,195,2822
18.01.2018 02:00,2939,28.6,194,190,2745
18.01.2018 03:00,2948,28.46,187,186,2761
18.01.2018 04:00,2971,28.34,170,176,2801
18.01.2018 05:00,3020,28.75,156,175,2864
18.01.2018 06:00,3194,29.92,140,160,3054
18.01.2018 07:00,3617,31.2,163,153,3454
18.01.2018 08:00,3965,42.93,173,164,3792
18.01.2018 09:00,4022,42.15,131,133,3891
18.01.2018 10:00,3998,42,132,139,3866
18.01.2018 11:00,3991,40.91,112,133,3879
18.01.2018 12:00,3968,39.34,110,130,3858
18.01.2018 13:00,3907,37.41,154,152,3753
18.01.2018 14:00,3935,35.82,140,152,3795
18.01.2018 15:00,3920,34.85,151,172,3769
18.01.2018 16:00,3966,36.73,158,187,3808
18.01.2018 17:00,4029,39.36,167,180,3862
18.01.2018 18:00,4099,42.15,176,186,3923
18.01.2018 19:00,4002,42.04,177,182,3825
18.01.2018 20:00,3933,41.49,173,177,3760
18.01.2018 21:00,3789,38.93,152,160,3637
18.01.2018 22:00,3631,34.3,137,142,3494
18.01.2018 23:00,3413,32.57,125,129,3288
19.01.2018 00:00,3201,30.45,117,119,3084
19.01.2018 01:00,3112,30,107,110,3005
19.01.2018 02:00,3065,29.97,94,95,2971
19.01.2018 03:00,3056,29.49,89,91,2967
19.01.2018 04:00,3039,29.56,85,87,2954
19.01.2018 05:00,3071,30.02,80,83,2991
19.01.2018 06:00,3260,31.76,76,78,3184
19.01.2018 07:00,3708,39.13,68,71,3640
19.01.2018 08:00,4120,49.85,61,65,4059
19.01.2018 09:00,4166,51.94,58,59,4108
19.01.2018 10:00,4131,50.36,51,54,4080
19.01.2018 11:00,4117,49.58,47,48,4070
19.01.2018 12:00,4052,46.88,35,38,4017
19.01.2018 13:00,3941,42.99,31,33,3910
19.01.2018 14:00,3860,41.67,28,32,3832
19.01.2018 15:00,3775,39.49,27,30,3748
19.01.2018 16:00,3774,41.78,37,37,3737
19.01.2018 17:00,3889,44.3,64,64,3825
19.01.2018 18:00,3968,49.57,68,67,3900
19.01.2018 19:00,3889,49.74,73,74,3816
19.01.2018 20:00,3763,44.79,107,104,3656
19.01.2018 21:00,3601,38.83,118,109,3483
19.01.2018 22:00,3364,36.94,100,93,3264
19.01.2018 23:00,3248,35.84,104,108,3144
20.01.2018 00:00,3076,32.61,110,111,2966
20.01.2018 01:00,2965,30.83,115,117,2850
20.01.2018 02:00,2916,29.72,119,122,2797
20.01.2018 03:00,2876,29.3,133,130,2743
20.01.2018 04:00,2874,29.01,138,137,2736
20.01.2018 05:00,2900,28.98,144,142,2756
20.01.2018 06:00,2966,29.23,148,149,2818
20.01.2018 07:00,3072,29.68,158,158,2914
20.01.2018 08:00,3225,30.85,163,163,3062
20.01.2018 09:00,3367,33.07,162,160,3205
20.01.2018 10:00,3481,37.09,155,152,3326
20.01.2018 11:00,3533,37.95,148,145,3385
20.01.2018 12:00,3556,40.68,134,133,3422
20.01.2018 13:00,3513,37.07,124,124,3389
20.01.2018 14:00,3449,34.01,123,124,3326
20.01.2018 15:00,3417,33.96,118,123,3299
20.01.2018 16:00,3435,38.24,130,135,3305
20.01.2018 17:00,3545,40.8,138,143,3407
20.01.2018 18:00,3632,44.68,157,159,3475
20.01.2018 19:00,3585,48.2,168,174,3417
20.01.2018 20:00,3467,36.97,173,177,3294
20.01.2018 21:00,3330,32.16,174,176,3156
20.01.2018 22:00,3237,32.65,165,167,3072
20.01.2018 23:00,3120,32.34,163,162,2957
21.01.2018 00:00,3008,31.75,155,153,2853
21.01.2018 01:00,2859,31.73,107,108,2752
21.01.2018 02:00,2814,30.41,103,105,2711
21.01.2018 03:00,2750,29.24,104,106,2646
21.01.2018 04:00,2731,28.71,109,110,2622
21.01.2018 05:00,2753,28.8,115,117,2638
21.01.2018 06:00,2842,29.05,121,123,2721
21.01.2018 07:00,2957,29.48,120,122,2837
21.01.2018 08:00,3077,30.75,116,118,2961
21.01.2018 09:00,3175,32.04,104,106,3071
21.01.2018 10:00,3305,34.45,95,97,3210
21.01.2018 11:00,3406,37.95,80,83,3326
21.01.2018 12:00,3437,39.95,62,64,3375
21.01.2018 13:00,3440,39.62,45,48,3395
21.01.2018 14:00,3401,36.86,37,40,3364
21.01.2018 15:00,3396,33.84,28,32,3368
21.01.2018 16:00,3469,34.62,26,30,3443
21.01.2018 17:00,3635,38.04,27,31,3608
21.01.2018 18:00,3751,42.93,34,38,3717
21.01.2018 19:00,3701,48.08,38,41,3663
21.01.2018 20:00,3642,42.92,40,43,3602
21.01.2018 21:00,3549,36.56,45,46,3504
21.01.2018 22:00,3372,32.53,53,54,3319
21.01.2018 23:00,3243,32.18,63,65,3180
22.01.2018 00:00,3117,30.52,76,77,3041
22.01.2018 01:00,3020,29.26,78,77,2942
22.01.2018 02:00,2961,28.58,98,90,2863
22.01.2018 03:00,2961,28.38,102,101,2859
22.01.2018 04:00,2962,28.53,113,113,2849
22.01.2018 05:00,3018,28.94,131,128,2887
22.01.2018 06:00,3203,29.73,153,151,3050
22.01.2018 07:00,3628,33.2,175,180,3453
22.01.2018 08:00,4062,42.95,197,205,3865
22.01.2018 09:00,4197,47.4,243,262,3954
22.01.2018 10:00,4093,45.9,231,241,3862
22.01.2018 11:00,4130,44.98,246,262,3884
22.01.2018 12:00,4147,48.39,296,309,3851
22.01.2018 13:00,4097,47,326,338,3771
22.01.2018 14:00,4159,47.39,338,352,3821
22.01.2018 15:00,4043,46.34,301,314,3742
22.01.2018 16:00,4020,43.94,321,301,3699
22.01.2018 17:00,4057,43.99,322,302,3735
22.01.2018 18:00,4221,50.72,309,318,3912
22.01.2018 19:00,4138,51,311,317,3827
22.01.2018 20:00,4037,48.05,294,302,3743
22.01.2018 21:00,3934,42.82,266,285,3668
22.01.2018 22:00,3734,38.99,254,274,3480
22.01.2018 23:00,3462,36.2,239,239,3223
23.01.2018 00:00,3277,33.5,211,213,3066
23.01.2018 01:00,3176,33.38,201,206,2975
23.01.2018 02:00,3101,31.74,179,190,2922
23.01.2018 03:00,3054,30.78,180,177,2874
23.01.2018 04:00,3083,30.38,174,171,2909
23.01.2018 05:00,3166,30.97,182,184,2984
23.01.2018 06:00,3390,32.48,215,218,3175
23.01.2018 07:00,3784,39.04,253,256,3531
23.01.2018 08:00,4124,48.93,297,288,3827
23.01.2018 09:00,4167,52.74,337,334,3830
23.01.2018 10:00,4175,50.79,341,339,3834
23.01.2018 11:00,4153,47.04,361,356,3792
23.01.2018 12:00,4148,43.83,393,404,3755
23.01.2018 13:00,4151,40.06,441,452,3710
23.01.2018 14:00,4174,37.28,500,510,3674
23.01.2018 15:00,4156,36.59,535,536,3621
23.01.2018 16:00,4174,36.6,532,540,3642
23.01.2018 17:00,4224,34.54,597,601,3627
23.01.2018 18:00,4258,37.02,666,677,3592
23.01.2018 19:00,4147,32.99,741,744,3406
23.01.2018 20:00,4033,32.69,827,821,3206
23.01.2018 21:00,3844,30.99,892,888,2952
23.01.2018 22:00,3574,29.62,958,958,2616
23.01.2018 23:00,3298,28.72,1048,1042,2250
24.01.2018 00:00,3017,28.11,1115,1113,1902
24.01.2018 01:00,2948,27.16,1229,1229,1719
24.01.2018 02:00,2855,26.92,1259,1260,1596
24.01.2018 03:00,2794,25.21,1255,1255,1539
24.01.2018 04:00,2721,25.62,1234,1236,1487
24.01.2018 05:00,2736,25.91,1172,1187,1564
24.01.2018 06:00,2880,27.39,1089,1120,1791
24.01.2018 07:00,3306,28.83,1024,1045,2282
24.01.2018 08:00,3716,31.94,957,984,2759
24.01.2018 09:00,3691,32.39,925,920,2766
24.01.2018 10:00,3592,31.88,885,878,2707
24.01.2018 11:00,3591,30.57,869,873,2722
24.01.2018 12:00,3701,29.9,950,961,2751
24.01.2018 13:00,3558,29.82,973,968,2585
24.01.2018 14:00,3588,29.4,1021,1014,2567
24.01.2018 15:00,3571,29.36,1103,1103,2468
24.01.2018 16:00,3641,29.35,1223,1227,2418
24.01.2018 17:00,3702,29.33,1294,1298,2408
24.01.2018 18:00,3739,29.7,1334,1338,2405
24.01.2018 19:00,3633,29.27,1363,1366,2270
24.01.2018 20:00,3546,29.04,1390,1393,2156
24.01.2018 21:00,3373,28.45,1388,1390,1985
24.01.2018 22:00,3283,28.15,1373,1375,1910
24.01.2018 23:00,3042,25.04,1353,1356,1689
25.01.2018 00:00,2814,15.59,1293,1313,1521
25.01.2018 01:00,2700,21.76,1246,1253,1454
25.01.2018 02:00,2624,15.85,1186,1198,1438
25.01.2018 03:00,2575,15.18,1161,1154,1414
25.01.2018 04:00,2584,17.8,1138,1128,1446
25.01.2018 05:00,2620,22.52,1114,1100,1506
25.01.2018 06:00,2787,26,1089,1087,1698
25.01.2018 07:00,3227,28.12,1064,1070,2163
25.01.2018 08:00,3640,30.2,1045,1040,2595
25.01.2018 09:00,3703,30.95,996,989,2707
25.01.2018 10:00,3724,30.96,957,968,2767
25.01.2018 11:00,3743,30.86,917,932,2826
25.01.2018 12:00,3682,30.49,900,897,2782
25.01.2018 13:00,3616,30.22,863,847,2753
25.01.2018 14:00,3562,30.29,798,783,2764
25.01.2018 15:00,3595,30.43,729,744,2866
25.01.2018 16:00,3727,30.85,653,685,3074
25.01.2018 17:00,3844,31.83,638,665,3206
25.01.2018 18:00,3844,45.65,628,637,3216
25.01.2018 19:00,3683,44.51,598,604,3085
25.01.2018 20:00,3550,32.14,584,583,2966
25.01.2018 21:00,3419,31.48,558,560,2861
25.01.2018 22:00,3262,30.72,519,518,2743
25.01.2018 23:00,3089,29.71,492,492,2597
26.01.2018 00:00,2857,28.98,449,448,2408
26.01.2018 01:00,2804,29.28,438,439,2366
26.01.2018 02:00,2783,28.99,405,401,2378
26.01.2018 03:00,2777,28.94,365,361,2412
26.01.2018 04:00,2773,29.1,317,317,2456
26.01.2018 05:00,2838,29.55,262,267,2576
26.01.2018 06:00,2998,30.1,215,221,2783
26.01.2018 07:00,3384,38.95,182,187,3202
26.01.2018 08:00,3748,48.21,154,157,3594
26.01.2018 09:00,3813,51.39,119,121,3694
26.01.2018 10:00,3744,53.21,105,107,3639
26.01.2018 11:00,3772,52.72,104,106,3668
26.01.2018 12:00,3759,51.9,96,100,3663
26.01.2018 13:00,3717,49.02,130,133,3587
26.01.2018 14:00,3666,48.02,135,139,3531
26.01.2018 15:00,3575,47.78,113,116,3462
26.01.2018 16:00,3547,47.09,111,113,3436
26.01.2018 17:00,3670,47.09,142,143,3528
26.01.2018 18:00,3779,49.92,165,162,3614
26.01.2018 19:00,3702,52.74,196,199,3506
26.01.2018 20:00,3573,44.28,221,228,3352
26.01.2018 21:00,3361,32.45,253,258,3108
26.01.2018 22:00,3213,31.55,303,301,2910
26.01.2018 23:00,3071,30.65,346,341,2725
27.01.2018 00:00,2887,30.19,351,359,2536
27.01.2018 01:00,2687,30.8,346,350,2341
27.01.2018 02:00,2582,30.22,358,355,2224
27.01.2018 03:00,2533,30.01,362,347,2171
27.01.2018 04:00,2522,29.99,346,342,2176
27.01.2018 05:00,2523,30.23,328,328,2195
27.01.2018 06:00,2565,30.78,317,316,2248
27.01.2018 07:00,2760,30.76,313,308,2447
27.01.2018 08:00,2927,30.76,283,284,2644
27.01.2018 09:00,3051,37.22,274,274,2777
27.01.2018 10:00,3140,40.01,251,253,2889
27.01.2018 11:00,3187,38.03,238,233,2949
27.01.2018 12:00,3237,33.95,251,248,2986
27.01.2018 13:00,3158,32.77,222,226,2936
27.01.2018 14:00,3100,31.99,212,227,2888
27.01.2018 15:00,3047,31.46,221,231,2826
27.01.2018 16:00,3116,31.08,248,248,2868
27.01.2018 17:00,3272,31.29,292,302,2980
27.01.2018 18:00,3375,35.84,362,376,3013
27.01.2018 19:00,3214,32.63,486,475,2728
27.01.2018 20:00,3020,31.96,622,607,2398
27.01.2018 21:00,2863,30,728,735,2135
27.01.2018 22:00,2710,29.04,887,886,1823
27.01.2018 23:00,2647,28.69,995,997,1652
28.01.2018 00:00,2662,28.23,1113,1108,1549
28.01.2018 01:00,2734,28.21,1273,1278,1461
28.01.2018 02:00,2622,27.72,1301,1305,1321
28.01.2018 03:00,2555,26.88,1297,1300,1258
28.01.2018 04:00,2519,26.59,1283,1285,1236
28.01.2018 05:00,2568,26.72,1270,1274,1298
28.01.2018 06:00,2651,27.09,1246,1251,1405
28.01.2018 07:00,2675,27.43,1234,1237,1441
28.01.2018 08:00,2727,27.5,1238,1237,1489
28.01.2018 09:00,2828,27.89,1248,1248,1580
28.01.2018 10:00,2970,28.07,1266,1271,1704
28.01.2018 11:00,3098,28.68,1288,1294,1810
28.01.2018 12:00,3160,28.73,1313,1318,1847
28.01.2018 13:00,3162,28.67,1325,1329,1837
28.01.2018 14:00,3123,28.53,1339,1343,1784
28.01.2018 15:00,3082,28.19,1330,1334,1752
28.01.2018 16:00,3099,28.58,1324,1326,1775
28.01.2018 17:00,3182,28.82,1301,1303,1881
28.01.2018 18:00,3339,29.25,1290,1296,2049
28.01.2018 19:00,3359,29.31,1274,1283,2085
28.01.2018 20:00,3261,29.03,1245,1238,2016
28.01.2018 21:00,3129,28.8,1212,1205,1917
28.01.2018 22:00,2991,28.58,1177,1180,1814
28.01.2018 23:00,2812,27.96,1125,1130,1687
29.01.2018 00:00,2645,27.58,1092,1084,1553
29.01.2018 01:00,2580,27.67,1034,1023,1546
29.01.2018 02:00,2611,26.9,924,944,1687
29.01.2018 03:00,2629,26.15,806,822,1823
29.01.2018 04:00,2683,27.43,688,689,1995
29.01.2018 05:00,2808,27.74,589,603,2219
29.01.2018 06:00,2972,28.56,574,559,2398
29.01.2018 07:00,3223,29.77,573,559,2650
29.01.2018 08:00,3524,30.78,611,616,2913
29.01.2018 09:00,3546,30.9,734,739,2812
29.01.2018 10:00,3564,30.6,853,856,2711
29.01.2018 11:00,3708,30.56,966,969,2742
29.01.2018 12:00,3720,30.52,1008,1012,2712
29.01.2018 13:00,3570,30.41,1030,1034,2540
29.01.2018 14:00,3554,30.34,1073,1077,2481
29.01.2018 15:00,3552,30.34,1099,1103,2453
29.01.2018 16:00,3530,30.52,1123,1125,2407
29.01.2018 17:00,3586,30.6,1175,1176,2411
29.01.2018 18:00,3758,31.98,1151,1156,2607
29.01.2018 19:00,3775,33.44,1126,1144,2649
29.01.2018 20:00,3534,30.67,1164,1167,2370
29.01.2018 21:00,3338,29.77,1111,1106,2227
29.01.2018 22:00,3241,29.14,1125,1124,2116
29.01.2018 23:00,3031,28.67,1104,1109,1927
30.01.2018 00:00,2856,28.13,1091,1094,1765
30.01.2018 01:00,2853,27.96,1155,1158,1698
30.01.2018 02:00,2794,27.76,1151,1153,1643
30.01.2018 03:00,2747,27.4,1141,1143,1606
30.01.2018 04:00,2738,27.54,1116,1118,1622
30.01.2018 05:00,2769,27.88,1088,1091,1681
30.01.2018 06:00,2948,28.7,1038,1040,1910
30.01.2018 07:00,3438,31.09,980,982,2458
30.01.2018 08:00,3824,34.57,929,936,2895
30.01.2018 09:00,3877,33.42,885,890,2992
30.01.2018 10:00,3860,32.83,883,885,2977
30.01.2018 11:00,3832,32.93,867,867,2965
30.01.2018 12:00,3812,32.43,907,908,2905
30.01.2018 13:00,3709,32.33,897,895,2812
30.01.2018 14:00,3663,32.19,883,879,2780
30.01.2018 15:00,3622,32.16,850,854,2772
30.01.2018 16:00,3648,32.37,819,822,2829
30.01.2018 17:00,3734,32.86,782,780,2952
30.01.2018 18:00,3937,43.64,748,738,3189
30.01.2018 19:00,3860,42.36,728,713,3132
30.01.2018 20:00,3782,36.5,688,670,3094
30.01.2018 21:00,3629,33.17,638,617,2991
30.01.2018 22:00,3412,32.37,576,542,2836
30.01.2018 23:00,3175,31.12,543,510,2632
31.01.2018 00:00,2945,30.11,514,487,2431
31.01.2018 01:00,2839,29.61,543,512,2296
31.01.2018 02:00,2796,28.98,551,524,2245
31.01.2018 03:00,2715,28.1,553,515,2162
31.01.2018 04:00,2673,27.99,562,519,2111
31.01.2018 05:00,2742,27.85,566,537,2176
31.01.2018 06:00,2910,28.06,577,560,2333
31.01.2018 07:00,3341,30.07,607,602,2734
31.01.2018 08:00,3717,31.35,648,652,3069
31.01.2018 09:00,3749,31.82,677,684,3072
31.01.2018 10:00,3692,30.89,749,763,2943
31.01.2018 11:00,3752,30.71,822,847,2930
31.01.2018 12:00,3729,30.03,875,895,2854
31.01.2018 13:00,3746,29.61,914,941,2832
31.01.2018 14:00,3744,29.38,917,941,2827
31.01.2018 15:00,3696,29.63,906,924,2790
31.01.2018 16:00,3762,29.63,924,931,2838
31.01.2018 17:00,3838,30.26,881,905,2957
31.01.2018 18:00,3914,32.05,842,862,3072
31.01.2018 19:00,3811,33.53,839,811,2972
31.01.2018 20:00,3673,31.74,790,777,2883
31.01.2018 21:00,3455,29.92,758,756,2697
31.01.2018 22:00,3280,28.85,737,731,2543
31.01.2018 23:00,3084,28.32,701,714,2383
02.01.2018 00:00,2925,27.38,706,714,2219
02.01.2018 01:00,2772,27.05,688,692,2084
02.01.2018 02:00,2773,26.06,689,698,2084
02.01.2018 03:00,2708,25.56,713,692,1995
02.01.2018 04:00,2674,26.79,736,714,1938
02.01.2018 05:00,2736,26.96,749,730,1987
02.01.2018 06:00,2916,28.85,751,769,2165
02.01.2018 07:00,3298,30.66,777,782,2521
02.01.2018 08:00,3734,34.11,796,801,2938
02.01.2018 09:00,3774,32.73,808,817,2966
02.01.2018 10:00,3734,32.48,834,836,2900
02.01.2018 11:00,3719,32.41,855,842,2864
02.01.2018 12:00,3853,31.57,838,851,3015
02.01.2018 13:00,3939,31.08,840,863,3099
02.01.2018 14:00,3953,31.45,831,841,3122
02.01.2018 15:00,3912,31.6,767,755,3145
02.01.2018 16:00,3882,31.52,703,688,3179
02.01.2018 17:00,3917,32.1,680,664,3237
02.01.2018 18:00,4076,32.98,689,666,3387
02.01.2018 19:00,3999,33.16,684,663,3315
02.01.2018 20:00,3808,32.26,585,564,3223
02.01.2018 21:00,3620,31.43,522,520,3098
02.01.2018 22:00,3406,31.46,502,486,2904
02.01.2018 23:00,3230,30.84,485,477,2745
02.02.2018 00:00,3020,29.36,470,452,2550
02.02.2018 01:00,2857,30.12,391,372,2466
02.02.2018 02:00,2789,29.87,360,345,2429
02.02.2018 03:00,2754,29.79,321,307,2433
02.02.2018 04:00,2737,29.74,314,280,2423
02.02.2018 05:00,2773,30.1,283,248,2490
02.02.2018 06:00,3003,32.18,236,232,2767
02.02.2018 07:00,3458,33.66,203,203,3255
02.02.2018 08:00,3861,43.04,166,171,3695
02.02.2018 09:00,3944,46.05,146,141,3798
02.02.2018 10:00,3964,46.8,131,126,3833
02.02.2018 11:00,3989,46.79,127,122,3862
02.02.2018 12:00,3955,44.32,130,129,3825
02.02.2018 13:00,3888,43.07,135,134,3753
02.02.2018 14:00,3821,39.97,136,137,3685
02.02.2018 15:00,3742,39.92,139,139,3603
02.02.2018 16:00,3721,40.12,152,153,3569
02.02.2018 17:00,3724,42.25,165,164,3559
02.02.2018 18:00,3878,48.02,191,194,3687
02.02.2018 19:00,3881,46.8,238,239,3643
02.02.2018 20:00,3810,43.08,251,247,3559
02.02.2018 21:00,3678,34.14,249,250,3429
02.02.2018 22:00,3562,33.38,262,266,3300
02.02.2018 23:00,3439,32.9,285,272,3154
02.03.2018 00:00,3293,31.92,292,282,3001
02.03.2018 01:00,3240,32.91,300,295,2940
02.03.2018 02:00,3220,32.23,309,306,2911
02.03.2018 03:00,3218,32,312,304,2906
02.03.2018 04:00,3213,31.99,321,303,2892
02.03.2018 05:00,3235,32.25,302,293,2933
02.03.2018 06:00,3302,32.87,292,285,3010
02.03.2018 07:00,3425,32.93,284,280,3141
02.03.2018 08:00,3552,33.36,276,274,3276
02.03.2018 09:00,3678,33.8,256,268,3422
02.03.2018 10:00,3832,37.08,252,262,3580
02.03.2018 11:00,3842,41.02,244,250,3598
02.03.2018 12:00,3819,42.38,242,250,3577
02.03.2018 13:00,3746,37.07,246,260,3500
02.03.2018 14:00,3678,33.87,253,259,3425
02.03.2018 15:00,3629,33.45,246,254,3383
02.03.2018 16:00,3605,33.49,244,251,3361
02.03.2018 17:00,3645,37.08,266,274,3379
02.03.2018 18:00,3748,45.14,302,307,3446
02.03.2018 19:00,3679,41.09,327,332,3352
02.03.2018 20:00,3540,34.67,374,374,3166
02.03.2018 21:00,3442,33.36,433,427,3009
02.03.2018 22:00,3336,32.93,488,477,2848
02.03.2018 23:00,3221,32.69,506,494,2715
02.04.2018 00:00,3150,32.15,522,518,2628
02.04.2018 01:00,3132,32.5,642,643,2490
02.04.2018 02:00,3028,31.3,650,656,2378
02.04.2018 03:00,2938,30.96,677,677,2261
02.04.2018 04:00,2918,30.99,723,704,2195
02.04.2018 05:00,2939,30.83,777,738,2162
02.04.2018 06:00,2991,30.79,791,765,2200
02.04.2018 07:00,3161,30.84,797,793,2364
02.04.2018 08:00,3245,31.23,799,790,2446
02.04.2018 09:00,3352,31.6,785,770,2567
02.04.2018 10:00,3482,32.38,760,747,2722
02.04.2018 11:00,3500,33.1,741,735,2759
02.04.2018 12:00,3576,34.44,725,725,2851
02.04.2018 13:00,3557,33.4,698,706,2859
02.04.2018 14:00,3503,32.08,682,697,2821
02.04.2018 15:00,3522,31.84,671,678,2851
02.04.2018 16:00,3580,32.15,686,678,2894
02.04.2018 17:00,3701,34.25,686,677,3015
02.04.2018 18:00,3931,39.71,681,672,3250
02.04.2018 19:00,3932,42.91,655,664,3277
02.04.2018 20:00,3851,40.01,634,636,3217
02.04.2018 21:00,3823,36.15,570,586,3253
02.04.2018 22:00,3700,35,524,546,3176
02.04.2018 23:00,3574,34.26,482,501,3092
02.05.2018 00:00,3449,32.92,463,469,2986
02.05.2018 01:00,3328,32.14,426,420,2902
02.05.2018 02:00,3225,31.18,422,407,2803
02.05.2018 03:00,3242,30.92,413,409,2829
02.05.2018 04:00,3298,30.93,395,394,2903
02.05.2018 05:00,3350,31.55,373,380,2977
02.05.2018 06:00,3610,33.67,368,366,3242
02.05.2018 07:00,4067,41.41,357,351,3710
02.05.2018 08:00,4476,75.1,317,322,4159
02.05.2018 09:00,4536,81.26,287,292,4249
02.05.2018 10:00,4477,80.43,243,251,4234
02.05.2018 11:00,4491,70.02,203,204,4288
02.05.2018 12:00,4423,53.89,159,166,4264
02.05.2018 13:00,4327,48.63,123,133,4204
02.05.2018 14:00,4237,48.09,108,115,4129
02.05.2018 15:00,4161,48.06,101,101,4060
02.05.2018 16:00,4157,49.97,106,106,4051
02.05.2018 17:00,4148,63.97,114,114,4034
02.05.2018 18:00,4389,93.26,128,130,4261
02.05.2018 19:00,4419,78.44,146,145,4273
02.05.2018 20:00,4354,55.41,153,151,4201
02.05.2018 21:00,4301,47.75,149,146,4152
02.05.2018 22:00,4175,39.97,139,141,4036
02.05.2018 23:00,4030,39,136,137,3894
02.06.2018 00:00,3846,36.02,132,133,3714
02.06.2018 01:00,3697,36.12,127,126,3570
02.06.2018 02:00,3662,35,128,126,3534
02.06.2018 03:00,3683,34.65,125,123,3558
02.06.2018 04:00,3705,35.38,124,119,3581
02.06.2018 05:00,3741,36.25,119,116,3622
02.06.2018 06:00,3944,37.36,114,112,3830
02.06.2018 07:00,4331,43.95,107,101,4224
02.06.2018 08:00,4640,58.65,96,91,4544
02.06.2018 09:00,4677,64.58,74,78,4603
02.06.2018 10:00,4619,63.69,67,72,4552
02.06.2018 11:00,4590,59.59,68,72,4522
02.06.2018 12:00,4534,49.76,76,79,4458
02.06.2018 13:00,4478,45.64,104,107,4374
02.06.2018 14:00,4416,44.61,119,122,4297
02.06.2018 15:00,4351,46.92,117,120,4234
02.06.2018 16:00,4341,49.45,159,161,4182
02.06.2018 17:00,4355,53.75,145,148,4210
02.06.2018 18:00,4614,63.89,187,191,4427
02.06.2018 19:00,4511,65.5,176,181,4335
02.06.2018 20:00,4419,58.08,175,181,4244
02.06.2018 21:00,4254,47.3,178,184,4076
02.06.2018 22:00,4111,40.26,181,189,3930
02.06.2018 23:00,3861,37.22,163,171,3698
02.07.2018 00:00,3643,33.98,169,176,3474
02.07.2018 01:00,3492,33.72,178,181,3314
02.07.2018 02:00,3461,33.45,173,175,3288
02.07.2018 03:00,3453,32.91,166,164,3287
02.07.2018 04:00,3467,33.07,153,155,3314
02.07.2018 05:00,3512,33.66,145,149,3367
02.07.2018 06:00,3654,34.44,136,140,3518
02.07.2018 07:00,4036,40.93,137,140,3899
02.07.2018 08:00,4381,60.07,150,152,4231
02.07.2018 09:00,4460,61.33,190,189,4270
02.07.2018 10:00,4453,58.97,219,216,4234
02.07.2018 11:00,4373,57.88,209,209,4164
02.07.2018 12:00,4268,46.99,195,199,4073
02.07.2018 13:00,4147,44.95,239,240,3908
02.07.2018 14:00,4085,46.22,240,240,3845
02.07.2018 15:00,4024,49,249,244,3775
02.07.2018 16:00,4067,49.77,273,269,3794
02.07.2018 17:00,4141,52.17,280,275,3861
02.07.2018 18:00,4373,61.47,325,320,4048
02.07.2018 19:00,4286,64.14,332,325,3954
02.07.2018 20:00,4149,55.2,349,340,3800
02.07.2018 21:00,3992,43.74,362,354,3630
02.07.2018 22:00,3829,40.23,373,371,3456
02.07.2018 23:00,3610,35.93,349,352,3261
02.08.2018 00:00,3391,32.91,340,337,3051
02.08.2018 01:00,3284,33.61,368,358,2916
02.08.2018 02:00,3241,33.06,351,355,2890
02.08.2018 03:00,3220,32.74,334,342,2886
02.08.2018 04:00,3253,32.6,327,328,2926
02.08.2018 05:00,3309,33.4,316,306,2993
02.08.2018 06:00,3449,34.81,273,271,3176
02.08.2018 07:00,3880,43.45,239,242,3641
02.08.2018 08:00,4242,59.61,218,220,4024
02.08.2018 09:00,4307,64.9,203,206,4104
02.08.2018 10:00,4208,65.37,187,187,4021
02.08.2018 11:00,4226,58.5,179,177,4047
02.08.2018 12:00,4154,59.6,171,170,3983
02.08.2018 13:00,4062,49.96,165,166,3897
02.08.2018 14:00,4021,47.8,133,136,3888
02.08.2018 15:00,3963,48.03,160,163,3803
02.08.2018 16:00,3968,49.08,160,164,3808
02.08.2018 17:00,3954,54.11,162,161,3792
02.08.2018 18:00,4155,63.14,171,170,3984
02.08.2018 19:00,4145,60.07,184,186,3961
02.08.2018 20:00,4024,55.72,186,186,3838
02.08.2018 21:00,3859,45.89,188,186,3671
02.08.2018 22:00,3771,40.97,190,191,3581
02.08.2018 23:00,3559,31.82,181,180,3378
02.09.2018 00:00,3379,30.95,181,178,3198
02.09.2018 01:00,3321,31.01,272,259,3049
02.09.2018 02:00,3279,30.65,280,267,2999
02.09.2018 03:00,3260,30.31,283,277,2977
02.09.2018 04:00,3297,30.4,285,288,3012
02.09.2018 05:00,3364,30.59,289,288,3075
02.09.2018 06:00,3535,31.43,281,279,3254
02.09.2018 07:00,3932,34.22,285,283,3647
02.09.2018 08:00,4211,45.56,288,285,3923
02.09.2018 09:00,4200,48.36,299,297,3901
02.09.2018 10:00,4256,46.21,319,311,3937
02.09.2018 11:00,4166,44.33,345,327,3821
02.09.2018 12:00,4005,38.96,373,357,3632
02.09.2018 13:00,3870,39.11,405,393,3465
02.09.2018 14:00,3798,39.11,374,375,3424
02.09.2018 15:00,3743,41.09,357,365,3386
02.09.2018 16:00,3793,41.1,320,331,3473
02.09.2018 17:00,3846,45.07,297,302,3549
02.09.2018 18:00,4059,48.4,284,288,3775
02.09.2018 19:00,4029,48.8,316,310,3713
02.09.2018 20:00,3828,42.06,329,313,3499
02.09.2018 21:00,3619,32.73,330,317,3289
02.09.2018 22:00,3448,31.89,307,299,3141
02.09.2018 23:00,3320,31.56,277,281,3043
02.10.2018 00:00,3195,31.17,245,250,2950
02.10.2018 01:00,3108,31.53,239,241,2869
02.10.2018 02:00,3039,31.27,210,213,2829
02.10.2018 03:00,2976,31.06,199,199,2777
02.10.2018 04:00,2996,31.15,190,190,2806
02.10.2018 05:00,3033,31.43,180,184,2853
02.10.2018 06:00,3087,31.8,182,185,2905
02.10.2018 07:00,3202,31.8,180,184,3022
02.10.2018 08:00,3300,31.41,182,184,3118
02.10.2018 09:00,3417,36.07,178,179,3239
02.10.2018 10:00,3557,36.07,169,171,3388
02.10.2018 11:00,3608,40.49,166,173,3442
02.10.2018 12:00,3590,40.47,182,174,3408
02.10.2018 13:00,3594,36.06,185,167,3409
02.10.2018 14:00,3594,36,168,150,3426
02.10.2018 15:00,3567,31.99,137,142,3430
02.10.2018 16:00,3540,32.72,110,119,3430
02.10.2018 17:00,3615,38.82,110,117,3505
02.10.2018 18:00,3795,41.72,131,129,3664
02.10.2018 19:00,3760,44.35,161,157,3599
02.10.2018 20:00,3638,40.57,177,177,3461
02.10.2018 21:00,3510,34.44,186,189,3324
02.10.2018 22:00,3374,32.46,194,191,3180
02.10.2018 23:00,3233,31.54,193,195,3040
02.11.2018 00:00,3095,30.01,211,207,2884
02.11.2018 01:00,2999,29.62,194,196,2805
02.11.2018 02:00,2971,29.33,211,209,2760
02.11.2018 03:00,2958,28.99,245,239,2713
02.11.2018 04:00,2906,28.84,276,269,2630
02.11.2018 05:00,2951,28.89,317,326,2634
02.11.2018 06:00,2983,28.79,378,396,2605
02.11.2018 07:00,3065,28.94,455,478,2610
02.11.2018 08:00,3199,29.06,544,543,2655
02.11.2018 09:00,3290,29.36,602,602,2688
02.11.2018 10:00,3388,29.67,677,679,2711
02.11.2018 11:00,3468,29.9,748,743,2720
02.11.2018 12:00,3482,30,812,807,2670
02.11.2018 13:00,3492,29.83,891,887,2601
02.11.2018 14:00,3458,29.71,933,933,2525
02.11.2018 15:00,3468,29.61,965,963,2503
02.11.2018 16:00,3545,30.01,988,987,2557
02.11.2018 17:00,3641,30.36,1004,1007,2637
02.11.2018 18:00,3786,30.82,1033,1033,2753
02.11.2018 19:00,3891,31.35,1055,1051,2836
02.11.2018 20:00,3840,31.03,1077,1070,2763
02.11.2018 21:00,3689,30.3,1088,1086,2601
02.11.2018 22:00,3491,29.91,1090,1091,2401
02.11.2018 23:00,3325,29.63,1090,1092,2235
02.12.2018 00:00,3190,29.06,1094,1097,2096
02.12.2018 01:00,2927,28.9,954,956,1973
02.12.2018 02:00,2880,28.57,978,981,1902
02.12.2018 03:00,2842,28.01,1025,1028,1817
02.12.2018 04:00,2881,28.81,1071,1074,1810
02.12.2018 05:00,2902,28.9,1116,1119,1786
02.12.2018 06:00,3052,29.37,1151,1155,1901
02.12.2018 07:00,3481,30.54,1179,1183,2302
02.12.2018 08:00,3898,31.84,1194,1198,2704
02.12.2018 09:00,3962,32.3,1213,1213,2749
02.12.2018 10:00,4010,32.17,1227,1228,2783
02.12.2018 11:00,4082,32.12,1240,1242,2842
02.12.2018 12:00,4081,31.86,1248,1251,2833
02.12.2018 13:00,4020,31.58,1246,1244,2774
02.12.2018 14:00,4005,31.58,1238,1236,2767
02.12.2018 15:00,3955,31.59,1223,1221,2732
02.12.2018 16:00,3945,31.77,1214,1217,2731
02.12.2018 17:00,3896,32.52,1202,1201,2694
02.12.2018 18:00,4054,37.3,1185,1186,2869
02.12.2018 19:00,4040,35.78,1164,1157,2876
02.12.2018 20:00,3920,33.98,1127,1128,2793
02.12.2018 21:00,3762,32.44,1074,1078,2688
02.12.2018 22:00,3538,31.92,1026,1026,2512
02.12.2018 23:00,3346,31.1,962,960,2384
13.02.2018 00:00,3144,30.96,893,886,2251
13.02.2018 01:00,3175,30.79,895,907,2280
13.02.2018 02:00,3068,30.57,838,832,2230
13.02.2018 03:00,3017,30.5,762,764,2255
13.02.2018 04:00,3029,30.78,690,707,2339
13.02.2018 05:00,3088,31.08,631,641,2457
13.02.2018 06:00,3215,32.68,571,564,2644
13.02.2018 07:00,3665,37.1,520,521,3145
13.02.2018 08:00,3974,45.49,457,462,3517
13.02.2018 09:00,4044,47.45,400,413,3644
13.02.2018 10:00,4021,46.41,369,373,3652
13.02.2018 11:00,3990,42.95,315,325,3675
13.02.2018 12:00,4014,38.05,272,290,3742
13.02.2018 13:00,3943,34.5,257,264,3686
13.02.2018 14:00,3978,34.06,226,235,3752
13.02.2018 15:00,3925,35.95,192,195,3733
13.02.2018 16:00,3933,36.32,166,168,3767
13.02.2018 17:00,3955,44.27,165,169,3790
13.02.2018 18:00,4082,49.85,164,171,3918
13.02.2018 19:00,4058,53.07,167,170,3891
13.02.2018 20:00,3988,43.86,169,169,3819
13.02.2018 21:00,3899,38.97,163,161,3736
13.02.2018 22:00,3734,36.08,166,163,3568
13.02.2018 23:00,3532,32.23,163,165,3369
14.02.2018 00:00,3401,31.18,157,158,3244
14.02.2018 01:00,3180,32.06,63,64,3117
14.02.2018 02:00,3141,31.71,54,54,3087
14.02.2018 03:00,3131,31.52,49,50,3082
14.02.2018 04:00,3161,31.59,45,47,3116
14.02.2018 05:00,3194,32.43,46,45,3148
14.02.2018 06:00,3345,33.63,51,47,3294
14.02.2018 07:00,3722,41.79,50,49,3672
14.02.2018 08:00,4046,48.28,51,54,3995
14.02.2018 09:00,4091,56.28,55,57,4036
14.02.2018 10:00,4008,53.72,62,63,3946
14.02.2018 11:00,3984,44.91,70,69,3914
14.02.2018 12:00,3892,40.13,75,75,3817
14.02.2018 13:00,3775,35.91,81,82,3694
14.02.2018 14:00,3753,35.12,88,88,3665
14.02.2018 15:00,3699,35.96,90,90,3609
14.02.2018 16:00,3743,40,96,92,3647
14.02.2018 17:00,3733,41.2,114,103,3619
14.02.2018 18:00,3921,44.99,145,129,3776
14.02.2018 19:00,3941,44.53,188,172,3753
14.02.2018 20:00,3861,40.01,227,214,3634
14.02.2018 21:00,3720,36.63,273,255,3447
14.02.2018 22:00,3506,32.61,326,293,3180
14.02.2018 23:00,3252,31.19,363,328,2889
15.02.2018 00:00,3029,29.77,392,361,2637
15.02.2018 01:00,3064,30.08,479,469,2585
15.02.2018 02:00,3000,30,495,480,2505
15.02.2018 03:00,2980,30.01,494,496,2486
15.02.2018 04:00,2998,29.73,508,513,2490
15.02.2018 05:00,3045,30.05,537,524,2508
15.02.2018 06:00,3280,30.8,560,550,2720
15.02.2018 07:00,3729,31.37,596,591,3133
15.02.2018 08:00,4066,32.77,635,628,3431
15.02.2018 09:00,4156,34.06,681,674,3475
15.02.2018 10:00,4130,33.51,731,729,3399
15.02.2018 11:00,4133,32.85,793,793,3340
15.02.2018 12:00,4062,32.78,856,858,3206
15.02.2018 13:00,4028,32.74,919,922,3109
15.02.2018 14:00,4040,32.98,938,940,3102
15.02.2018 15:00,4031,33.17,923,926,3108
15.02.2018 16:00,4026,33.41,906,910,3120
15.02.2018 17:00,4015,33.79,916,919,3099
15.02.2018 18:00,4193,35.18,932,936,3261
15.02.2018 19:00,4162,36.96,954,956,3208
15.02.2018 20:00,3972,35.14,961,962,3011
15.02.2018 21:00,3810,33.92,949,947,2861
15.02.2018 22:00,3653,33.89,903,898,2750
15.02.2018 23:00,3553,33.01,829,842,2724
16.02.2018 00:00,3435,32.15,731,751,2704
16.02.2018 01:00,3284,32.05,639,652,2645
16.02.2018 02:00,3158,31.86,515,533,2643
16.02.2018 03:00,3128,31.78,399,430,2729
16.02.2018 04:00,3115,31.51,332,357,2783
16.02.2018 05:00,3125,31.99,297,320,2828
16.02.2018 06:00,3308,33.02,286,299,3022
16.02.2018 07:00,3723,34.99,276,303,3447
16.02.2018 08:00,4029,45.2,264,297,3765
16.02.2018 09:00,4082,46.27,255,270,3827
16.02.2018 10:00,4057,45.82,277,278,3780
16.02.2018 11:00,4078,44.45,297,297,3781
16.02.2018 12:00,4061,37.93,340,336,3721
16.02.2018 13:00,4010,34.94,367,369,3643
16.02.2018 14:00,3907,34.8,404,405,3503
16.02.2018 15:00,3849,34.42,447,438,3402
16.02.2018 16:00,3766,34.94,461,442,3305
16.02.2018 17:00,3843,35.63,511,499,3332
16.02.2018 18:00,3963,43.15,512,501,3451
16.02.2018 19:00,3925,49.05,488,500,3437
16.02.2018 20:00,3832,39.39,447,481,3385
16.02.2018 21:00,3583,35.81,402,437,3181
16.02.2018 22:00,3417,34.92,393,402,3024
16.02.2018 23:00,3195,33.57,378,368,2817
17.02.2018 00:00,3009,32.96,340,339,2669
17.02.2018 01:00,2850,34.67,306,310,2544
17.02.2018 02:00,2762,33.97,283,283,2479
17.02.2018 03:00,2771,33.97,249,249,2522
17.02.2018 04:00,2781,33.61,218,227,2563
17.02.2018 05:00,2789,33.62,199,202,2590
17.02.2018 06:00,2825,33.86,180,177,2645
17.02.2018 07:00,2990,34.59,165,164,2825
17.02.2018 08:00,3146,35.49,141,144,3005
17.02.2018 09:00,3293,36.9,117,116,3176
17.02.2018 10:00,3406,40.66,98,97,3308
17.02.2018 11:00,3398,44.6,84,84,3314
17.02.2018 12:00,3348,42.4,69,72,3279
17.02.2018 13:00,3310,40.64,63,66,3247
17.02.2018 14:00,3274,38.01,58,61,3216
17.02.2018 15:00,3239,35.97,56,59,3183
17.02.2018 16:00,3243,35.93,46,50,3197
17.02.2018 17:00,3311,38.52,39,42,3272
17.02.2018 18:00,3496,44.99,36,39,3460
17.02.2018 19:00,3557,49.77,56,59,3501
17.02.2018 20:00,3435,47.31,40,42,3395
17.02.2018 21:00,3288,39.47,35,37,3253
17.02.2018 22:00,3188,37.69,28,31,3160
17.02.2018 23:00,3084,35.85,26,28,3058
18.02.2018 00:00,2946,34.88,24,27,2922
18.02.2018 01:00,2831,34.91,22,25,2809
18.02.2018 02:00,2780,34.82,29,31,2751
18.02.2018 03:00,2758,33.98,36,38,2722
18.02.2018 04:00,2724,33.89,46,47,2678
18.02.2018 05:00,2730,33.83,57,57,2673
18.02.2018 06:00,2770,33.99,64,63,2706
18.02.2018 07:00,2831,33.51,69,70,2762
18.02.2018 08:00,2901,33.56,70,75,2831
18.02.2018 09:00,3015,34.23,78,83,2937
18.02.2018 10:00,3145,35.42,99,91,3046
18.02.2018 11:00,3234,35.75,118,108,3116
18.02.2018 12:00,3263,35.97,138,144,3125
18.02.2018 13:00,3237,34.71,161,164,3076
18.02.2018 14:00,3198,35,181,175,3017
18.02.2018 15:00,3143,34.38,183,174,2960
18.02.2018 16:00,3135,34.94,166,166,2969
18.02.2018 17:00,3198,36.24,160,170,3038
18.02.2018 18:00,3421,41.35,194,202,3227
18.02.2018 19:00,3510,47.45,225,227,3285
18.02.2018 20:00,3443,44.04,231,233,3212
18.02.2018 21:00,3289,40,253,254,3036
18.02.2018 22:00,3119,36.96,256,260,2863
18.02.2018 23:00,3000,35.36,245,241,2755
19.02.2018 00:00,2834,33.77,236,230,2598
19.02.2018 01:00,2817,33.77,247,241,2570
19.02.2018 02:00,2809,33.56,213,217,2596
19.02.2018 03:00,2773,33.78,183,186,2590
19.02.2018 04:00,2795,33.94,157,157,2638
19.02.2018 05:00,2862,35.07,135,133,2727
19.02.2018 06:00,3037,37.65,112,111,2925
19.02.2018 07:00,3453,47.33,97,94,3356
19.02.2018 08:00,3733,57.95,76,71,3657
19.02.2018 09:00,3886,61.28,57,56,3829
19.02.2018 10:00,3893,61.63,44,47,3849
19.02.2018 11:00,3869,59.67,41,47,3828
19.02.2018 12:00,3868,58.11,36,39,3832
19.02.2018 13:00,3805,54.24,39,40,3766
19.02.2018 14:00,3791,52.67,38,38,3753
19.02.2018 15:00,3787,53.24,49,49,3738
19.02.2018 16:00,3800,52.68,62,61,3738
19.02.2018 17:00,3756,49.75,88,85,3668
19.02.2018 18:00,3889,59.92,126,123,3763
19.02.2018 19:00,3899,67.84,175,176,3724
19.02.2018 20:00,3879,54.39,224,229,3655
19.02.2018 21:00,3788,43.3,260,264,3528
19.02.2018 22:00,3610,42,282,289,3328
19.02.2018 23:00,3418,38.12,296,303,3122
20.02.2018 00:00,3215,35.77,300,306,2915
20.02.2018 01:00,2976,37.27,279,283,2697
20.02.2018 02:00,2960,36.43,292,293,2668
20.02.2018 03:00,2990,36.06,305,308,2685
20.02.2018 04:00,3011,35.65,310,311,2701
20.02.2018 05:00,3082,36.95,313,316,2769
20.02.2018 06:00,3259,40.69,307,312,2952
20.02.2018 07:00,3649,47.19,298,305,3351
20.02.2018 08:00,3923,60.05,282,286,3641
20.02.2018 09:00,4022,61.92,258,260,3764
20.02.2018 10:00,4051,61.85,239,237,3812
20.02.2018 11:00,4111,59.89,211,213,3900
20.02.2018 12:00,4045,56.1,179,181,3866
20.02.2018 13:00,3955,53.38,158,156,3797
20.02.2018 14:00,3966,51.67,143,143,3823
20.02.2018 15:00,3946,50.7,134,136,3812
20.02.2018 16:00,3942,49.87,126,128,3816
20.02.2018 17:00,3942,50.25,128,125,3814
20.02.2018 18:00,4045,53.51,134,131,3911
20.02.2018 19:00,4035,61.91,141,143,3894
20.02.2018 20:00,3897,58.19,138,142,3759
20.02.2018 21:00,3747,46.93,122,128,3625
20.02.2018 22:00,3602,42.89,126,118,3476
20.02.2018 23:00,3382,40.84,117,102,3265
21.02.2018 00:00,3211,37.41,97,87,3114
21.02.2018 01:00,3050,37.46,48,51,3002
21.02.2018 02:00,3011,37.05,43,46,2968
21.02.2018 03:00,3001,36.78,35,40,2966
21.02.2018 04:00,2979,36.64,37,39,2942
21.02.2018 05:00,3030,37.33,39,41,2991
21.02.2018 06:00,3227,39.06,41,43,3186
21.02.2018 07:00,3617,45.65,45,46,3572
21.02.2018 08:00,3926,59.13,42,44,3884
21.02.2018 09:00,4029,62.18,42,45,3987
21.02.2018 10:00,4027,61.98,44,48,3983
21.02.2018 11:00,4057,56.87,52,54,4005
21.02.2018 12:00,4020,49.71,59,58,3961
21.02.2018 13:00,3947,45.85,60,65,3887
21.02.2018 14:00,3947,45.11,65,70,3882
21.02.2018 15:00,3905,44.58,71,76,3834
21.02.2018 16:00,3915,44.97,73,76,3842
21.02.2018 17:00,3952,47.41,82,85,3870
21.02.2018 18:00,4085,55.43,93,96,3992
21.02.2018 19:00,4098,58.93,109,111,3989
21.02.2018 20:00,3983,55.24,128,130,3855
21.02.2018 21:00,3843,48.13,143,145,3700
21.02.2018 22:00,3665,43.97,173,174,3492
21.02.2018 23:00,3467,39.89,179,182,3288
22.02.2018 00:00,3268,37.28,180,182,3088
22.02.2018 01:00,3138,39.17,143,145,2995
22.02.2018 02:00,3083,38.31,151,153,2932
22.02.2018 03:00,3070,37.95,160,160,2910
22.02.2018 04:00,3093,38.04,173,166,2920
22.02.2018 05:00,3172,39.05,177,170,2995
22.02.2018 06:00,3382,42.02,179,170,3203
22.02.2018 07:00,3808,49.93,178,172,3630
22.02.2018 08:00,4088,59.19,157,153,3931
22.02.2018 09:00,4170,67.97,114,115,4056
22.02.2018 10:00,4127,62.57,82,88,4045
22.02.2018 11:00,4072,57.91,61,64,4011
22.02.2018 12:00,4054,49.41,51,58,4003
22.02.2018 13:00,3913,45.92,31,36,3882
22.02.2018 14:00,3851,45.1,22,28,3829
22.02.2018 15:00,3817,45.2,24,28,3793
22.02.2018 16:00,3830,45.69,23,25,3807
22.02.2018 17:00,3797,49.8,25,25,3772
22.02.2018 18:00,3950,57.73,31,31,3919
22.02.2018 19:00,4069,61.45,52,43,4017
22.02.2018 20:00,3958,55.8,53,46,3905
22.02.2018 21:00,3855,45.83,49,52,3806
22.02.2018 22:00,3664,44.44,46,45,3618
22.02.2018 23:00,3491,42.44,54,53,3437
23.02.2018 00:00,3305,38.2,68,62,3237
23.02.2018 01:00,3152,38.58,56,49,3096
23.02.2018 02:00,3123,37.53,61,57,3062
23.02.2018 03:00,3121,37.24,70,70,3051
23.02.2018 04:00,3142,37.13,77,78,3065
23.02.2018 05:00,3198,37.54,78,80,3120
23.02.2018 06:00,3392,39.85,74,76,3318
23.02.2018 07:00,3801,48.36,85,87,3716
23.02.2018 08:00,4086,61.62,74,76,4012
23.02.2018 09:00,4231,63.03,113,115,4118
23.02.2018 10:00,4177,55.5,85,88,4092
23.02.2018 11:00,4245,54.1,100,104,4145
23.02.2018 12:00,4168,46.35,98,102,4070
23.02.2018 13:00,4051,42.77,109,110,3942
23.02.2018 14:00,3971,40.29,113,113,3858
23.02.2018 15:00,3898,39.44,140,142,3758
23.02.2018 16:00,3874,39.74,177,178,3697
23.02.2018 17:00,3840,44.33,181,180,3659
23.02.2018 18:00,3998,50.48,219,220,3779
23.02.2018 19:00,3983,53.97,255,246,3728
23.02.2018 20:00,3898,48.09,303,289,3595
23.02.2018 21:00,3750,41.81,321,315,3429
23.02.2018 22:00,3551,38.71,337,347,3214
23.02.2018 23:00,3370,37.78,377,380,2993
24.02.2018 00:00,3214,36.05,400,402,2814
24.02.2018 01:00,3188,37.55,442,447,2746
24.02.2018 02:00,3175,37.05,446,455,2729
24.02.2018 03:00,3185,36.95,461,456,2724
24.02.2018 04:00,3166,36.84,457,457,2709
24.02.2018 05:00,3161,36.99,475,475,2686
24.02.2018 06:00,3277,37.05,487,485,2790
24.02.2018 07:00,3434,37.59,478,479,2956
24.02.2018 08:00,3527,37.96,458,467,3069
24.02.2018 09:00,3659,38.03,428,444,3231
24.02.2018 10:00,3738,40.21,414,426,3324
24.02.2018 11:00,3718,41.38,406,414,3312
24.02.2018 12:00,3562,41.17,373,373,3189
24.02.2018 13:00,3510,38.87,352,354,3158
24.02.2018 14:00,3450,37.78,331,337,3119
24.02.2018 15:00,3388,36.95,317,318,3071
24.02.2018 16:00,3387,36.95,282,276,3105
24.02.2018 17:00,3496,37.79,268,262,3228
24.02.2018 18:00,3751,40.84,283,286,3468
24.02.2018 19:00,3846,43.31,276,283,3570
24.02.2018 20:00,3728,40.78,283,288,3445
24.02.2018 21:00,3589,38.86,299,303,3290
24.02.2018 22:00,3492,37.84,329,323,3163
24.02.2018 23:00,3449,37.37,339,338,3110
25.02.2018 00:00,3328,36.96,342,337,2986
25.02.2018 01:00,3207,37.66,281,277,2926
25.02.2018 02:00,3188,37.51,284,279,2904
25.02.2018 03:00,3222,37.21,294,292,2928
25.02.2018 04:00,3221,36.87,310,311,2911
25.02.2018 05:00,3254,36.78,321,327,2933
25.02.2018 06:00,3302,37.19,361,357,2941
25.02.2018 07:00,3418,37.63,387,382,3031
25.02.2018 08:00,3472,38.11,413,404,3059
25.02.2018 09:00,3590,38.43,429,423,3161
25.02.2018 10:00,3694,39.13,438,436,3256
25.02.2018 11:00,3642,39.33,448,444,3194
25.02.2018 12:00,3642,38.93,447,458,3195
25.02.2018 13:00,3596,38.5,459,471,3137
25.02.2018 14:00,3505,37.6,451,464,3054
25.02.2018 15:00,3414,36.74,457,463,2957
25.02.2018 16:00,3434,36.8,469,478,2965
25.02.2018 17:00,3537,37.47,495,502,3042
25.02.2018 18:00,3743,41.77,536,539,3207
25.02.2018 19:00,3981,45.96,574,579,3407
25.02.2018 20:00,4045,43.59,623,613,3422
25.02.2018 21:00,4033,39.94,655,644,3378
25.02.2018 22:00,3877,38.07,676,662,3201
25.02.2018 23:00,3642,37.84,678,670,2964
26.02.2018 00:00,3551,36.51,678,676,2873
26.02.2018 01:00,3465,36.03,653,655,2812
26.02.2018 02:00,3460,36.04,658,670,2802
26.02.2018 03:00,3464,36.04,661,674,2803
26.02.2018 04:00,3456,36.12,694,693,2762
26.02.2018 05:00,3541,36.75,708,703,2833
26.02.2018 06:00,3727,38.94,710,702,3017
26.02.2018 07:00,4171,46.63,709,708,3462
26.02.2018 08:00,4380,67.66,694,680,3686
26.02.2018 09:00,4551,64.67,691,673,3860
26.02.2018 10:00,4594,48.59,652,651,3942
26.02.2018 11:00,4543,46.32,605,617,3938
26.02.2018 12:00,4425,43.63,581,587,3844
26.02.2018 13:00,4238,41.96,543,553,3695
26.02.2018 14:00,4131,41.21,519,524,3612
26.02.2018 15:00,4068,41.25,522,527,3546
26.02.2018 16:00,4051,42.23,496,495,3555
26.02.2018 17:00,4007,45,502,506,3505
26.02.2018 18:00,4227,52.95,556,552,3671
26.02.2018 19:00,4401,73.73,582,594,3819
26.02.2018 20:00,4318,57.65,640,624,3678
26.02.2018 21:00,4235,46.81,667,647,3568
26.02.2018 22:00,4081,43.1,680,664,3401
26.02.2018 23:00,3967,40,688,690,3279
27.02.2018 00:00,3768,38.93,688,678,3080
27.02.2018 01:00,3699,39.75,738,718,2961
27.02.2018 02:00,3646,38.28,761,746,2885
27.02.2018 03:00,3640,37.66,792,785,2848
27.02.2018 04:00,3605,37.69,825,819,2780
27.02.2018 05:00,3655,38.7,875,861,2780
27.02.2018 06:00,3835,40.81,931,915,2904
27.02.2018 07:00,4308,43.09,995,983,3313
27.02.2018 08:00,4628,71.98,1030,1026,3598
27.02.2018 09:00,4719,72.38,1069,1067,3650
27.02.2018 10:00,4730,50.53,1094,1088,3636
27.02.2018 11:00,4665,45.85,1109,1108,3556
27.02.2018 12:00,4555,43.13,1137,1139,3418
27.02.2018 13:00,4516,42.44,1167,1172,3349
27.02.2018 14:00,4497,41.91,1198,1201,3299
27.02.2018 15:00,4515,42.27,1204,1207,3311
27.02.2018 16:00,4533,45.27,1221,1224,3312
27.02.2018 17:00,4579,47.01,1215,1216,3364
27.02.2018 18:00,4718,62.1,1218,1218,3500
27.02.2018 19:00,4848,73.32,1198,1199,3650
27.02.2018 20:00,4810,52.31,1171,1173,3639
27.02.2018 21:00,4700,45.85,1141,1143,3559
27.02.2018 22:00,4499,40.99,1100,1103,3399
27.02.2018 23:00,4251,38.72,1062,1065,3189
28.02.2018 00:00,4069,37.72,1022,1023,3047
28.02.2018 01:00,3939,37.98,1005,1002,2934
28.02.2018 02:00,3883,37.7,988,987,2895
28.02.2018 03:00,3876,37.7,980,979,2896
28.02.2018 04:00,3867,37.82,975,974,2892
28.02.2018 05:00,3888,38.06,968,968,2920
28.02.2018 06:00,4145,39.02,964,963,3181
28.02.2018 07:00,4535,44.98,957,957,3578
28.02.2018 08:00,4880,57.38,940,939,3940
28.02.2018 09:00,4921,70.67,955,954,3966
28.02.2018 10:00,4912,68.83,967,965,3945
28.02.2018 11:00,4893,68.04,988,984,3905
28.02.2018 12:00,4814,50.09,1001,997,3813
28.02.2018 13:00,4655,44.97,983,979,3672
28.02.2018 14:00,4637,43.47,980,975,3657
28.02.2018 15:00,4552,42.89,945,942,3607
28.02.2018 16:00,4527,42.82,907,901,3620
28.02.2018 17:00,4495,44.96,877,866,3618
28.02.2018 18:00,4629,67.94,871,860,3758
28.02.2018 19:00,4787,72.91,841,831,3946
28.02.2018 20:00,4733,50.87,825,811,3908
28.02.2018 21:00,4630,44.91,826,816,3804
28.02.2018 22:00,4460,41.54,818,808,3642
28.02.2018 23:00,4227,38.72,802,797,3425
03.01.2018 00:00,4004,37.76,782,772,3222
03.01.2018 01:00,3770,39.52,710,698,3060
03.01.2018 02:00,3720,39.05,692,687,3028
03.01.2018 03:00,3718,38.83,687,688,3031
03.01.2018 04:00,3719,39.02,695,695,3024
03.01.2018 05:00,3768,39.6,702,693,3066
03.01.2018 06:00,3917,42.02,705,689,3212
03.01.2018 07:00,4253,62.17,702,688,3551
03.01.2018 08:00,4568,199.92,712,702,3856
03.01.2018 09:00,4689,255.02,717,710,3972
03.01.2018 10:00,4644,205,719,714,3925
03.01.2018 11:00,4517,192.64,724,723,3793
03.01.2018 12:00,4429,131.61,733,741,3696
03.01.2018 13:00,4314,107.98,759,770,3555
03.01.2018 14:00,4275,90.03,767,771,3508
03.01.2018 15:00,4249,58.55,783,766,3466
03.01.2018 16:00,4262,62.05,766,752,3496
03.01.2018 17:00,4263,67.63,763,753,3500
03.01.2018 18:00,4363,119.65,758,752,3605
03.01.2018 19:00,4417,153.34,750,743,3667
03.01.2018 20:00,4349,99.94,748,732,3601
03.01.2018 21:00,4209,59.47,744,737,3465
03.01.2018 22:00,4032,51.15,743,737,3289
03.01.2018 23:00,3828,41.99,719,732,3109
03.02.2018 00:00,3668,39.09,694,721,2974
03.02.2018 01:00,3707,40.01,767,792,2940
03.02.2018 02:00,3683,38.86,747,776,2936
03.02.2018 03:00,3683,38.81,734,761,2949
03.02.2018 04:00,3678,38.99,744,765,2934
03.02.2018 05:00,3695,40.07,750,761,2945
03.02.2018 06:00,3857,40.44,775,776,3082
03.02.2018 07:00,4200,44.03,784,785,3416
03.02.2018 08:00,4439,67.81,771,776,3668
03.02.2018 09:00,4529,119.06,751,759,3778
03.02.2018 10:00,4565,119.47,730,758,3835
03.02.2018 11:00,4619,100.02,721,752,3898
03.02.2018 12:00,4552,80,679,718,3873
03.02.2018 13:00,4460,60.58,654,683,3806
03.02.2018 14:00,4428,52.97,643,668,3785
03.02.2018 15:00,4297,46.59,615,619,3682
03.02.2018 16:00,4273,43.81,583,595,3690
03.02.2018 17:00,4260,43.99,561,582,3699
03.02.2018 18:00,4375,51.75,560,574,3815
03.02.2018 19:00,4485,75.95,527,548,3958
03.02.2018 20:00,4370,63.76,501,517,3869
03.02.2018 21:00,4169,47.95,464,481,3705
03.02.2018 22:00,4036,43.76,493,509,3543
03.02.2018 23:00,3834,41.69,454,465,3380
03.03.2018 00:00,3616,39.76,382,392,3234
03.03.2018 01:00,3418,41.81,274,276,3144
03.03.2018 02:00,3350,40.22,249,256,3101
03.03.2018 03:00,3350,39.06,239,248,3111
03.03.2018 04:00,3331,39.54,242,246,3089
03.03.2018 05:00,3358,39.77,251,247,3107
03.03.2018 06:00,3403,40.83,257,252,3146
03.03.2018 07:00,3496,42.48,264,259,3232
03.03.2018 08:00,3598,42.91,276,266,3322
03.03.2018 09:00,3838,44.27,280,276,3558
03.03.2018 10:00,3961,50.79,288,292,3673
03.03.2018 11:00,3966,50.53,291,299,3675
03.03.2018 12:00,3894,46.08,285,297,3609
03.03.2018 13:00,3833,43.12,297,296,3536
03.03.2018 14:00,3722,41.61,309,278,3413
03.03.2018 15:00,3669,40.88,267,265,3402
03.03.2018 16:00,3659,40.41,250,252,3409
03.03.2018 17:00,3691,40.97,233,228,3458
03.03.2018 18:00,3839,50.12,207,209,3632
03.03.2018 19:00,3951,59.7,196,197,3755
03.03.2018 20:00,3833,45.11,184,189,3649
03.03.2018 21:00,3652,41,187,181,3465
03.03.2018 22:00,3474,40.2,202,178,3272
03.03.2018 23:00,3358,39.06,178,164,3180
03.04.2018 00:00,3259,38.48,153,154,3106
03.04.2018 01:00,3144,40.37,101,109,3043
03.04.2018 02:00,3108,40.02,99,96,3009
03.04.2018 03:00,3075,39.68,93,92,2982
03.04.2018 04:00,3084,39.56,100,99,2984
03.04.2018 05:00,3112,39.48,97,99,3015
03.04.2018 06:00,3161,39.51,104,106,3057
03.04.2018 07:00,3210,39.89,117,114,3093
03.04.2018 08:00,3289,40,127,122,3162
03.04.2018 09:00,3421,41.58,140,130,3281
03.04.2018 10:00,3495,41.65,167,150,3328
03.04.2018 11:00,3516,42.97,198,169,3318
03.04.2018 12:00,3528,42.68,217,195,3311
03.04.2018 13:00,3516,41.71,217,216,3299
03.04.2018 14:00,3502,40.77,214,227,3288
03.04.2018 15:00,3483,40.22,214,221,3269
03.04.2018 16:00,3498,39.5,211,223,3287
03.04.2018 17:00,3581,40.05,240,251,3341
03.04.2018 18:00,3704,44.36,270,266,3434
03.04.2018 19:00,3877,47.68,301,300,3576
03.04.2018 20:00,3825,45.34,336,343,3489
03.04.2018 21:00,3701,40.96,358,370,3343
03.04.2018 22:00,3536,39.65,360,399,3176
03.04.2018 23:00,3400,38.7,389,412,3011
03.05.2018 00:00,3255,38.25,410,433,2845
03.05.2018 01:00,3173,37.9,440,449,2733
03.05.2018 02:00,3110,37.43,441,475,2669
03.05.2018 03:00,3033,37.47,476,503,2557
03.05.2018 04:00,3028,37.8,514,542,2514
03.05.2018 05:00,3102,38.15,588,597,2514
03.05.2018 06:00,3249,38.68,667,661,2582
03.05.2018 07:00,3623,44.82,735,732,2888
03.05.2018 08:00,3946,53.94,824,809,3122
03.05.2018 09:00,4062,64.06,842,856,3220
03.05.2018 10:00,4123,62.63,886,909,3237
03.05.2018 11:00,4212,56.02,916,927,3296
03.05.2018 12:00,4277,54.98,905,910,3372
03.05.2018 13:00,4261,49.02,876,894,3385
03.05.2018 14:00,4229,48.11,840,834,3389
03.05.2018 15:00,4128,53.43,767,753,3361
03.05.2018 16:00,4062,53.78,695,677,3367
03.05.2018 17:00,4045,54.16,633,622,3412
03.05.2018 18:00,4071,69.67,570,559,3501
03.05.2018 19:00,4109,83.16,505,499,3604
03.05.2018 20:00,4085,81.61,431,447,3654
03.05.2018 21:00,3954,59.59,352,383,3602
03.05.2018 22:00,3707,49.8,328,361,3379
03.05.2018 23:00,3464,43.69,300,296,3164
03.06.2018 00:00,3209,40.4,269,262,2940
03.06.2018 01:00,3005,38.96,219,220,2786
03.06.2018 02:00,2977,37.96,198,206,2779
03.06.2018 03:00,2921,37.39,182,192,2739
03.06.2018 04:00,2934,36.78,182,181,2752
03.06.2018 05:00,3022,37.42,182,184,2840
03.06.2018 06:00,3254,39.49,178,183,3076
03.06.2018 07:00,3709,45.77,193,201,3516
03.06.2018 08:00,4010,58.26,185,192,3825
03.06.2018 09:00,4060,65.19,172,169,3888
03.06.2018 10:00,3977,65.02,131,134,3846
03.06.2018 11:00,3911,63.28,111,113,3800
03.06.2018 12:00,3838,55.03,90,98,3748
03.06.2018 13:00,3714,52.39,98,102,3616
03.06.2018 14:00,3596,50.07,101,99,3495
03.06.2018 15:00,3541,48.98,116,111,3425
03.06.2018 16:00,3560,48.76,146,143,3414
03.06.2018 17:00,3533,48.24,176,182,3357
03.06.2018 18:00,3656,53.99,268,270,3388
03.06.2018 19:00,3822,59.24,376,383,3446
03.06.2018 20:00,3870,55.21,478,488,3392
03.06.2018 21:00,3732,45.99,488,495,3244
03.06.2018 22:00,3521,43.04,513,515,3008
03.06.2018 23:00,3311,40.58,515,532,2796
03.07.2018 00:00,3077,38.6,509,528,2568
03.07.2018 01:00,2949,38.13,502,513,2447
03.07.2018 02:00,2942,37.66,515,528,2427
03.07.2018 03:00,2939,37.1,543,553,2396
03.07.2018 04:00,2935,36.91,560,569,2375
03.07.2018 05:00,3012,37.54,597,612,2415
03.07.2018 06:00,3215,39.88,634,646,2581
03.07.2018 07:00,3660,45.2,659,677,3001
03.07.2018 08:00,3964,54.51,664,687,3300
03.07.2018 09:00,4076,60.3,664,683,3412
03.07.2018 10:00,4040,58.56,649,662,3391
03.07.2018 11:00,3986,55.18,620,633,3366
03.07.2018 12:00,3967,54.78,597,611,3370
03.07.2018 13:00,3869,50.27,579,595,3290
03.07.2018 14:00,3850,47.82,592,581,3258
03.07.2018 15:00,3924,46.51,568,573,3356
03.07.2018 16:00,3939,46.75,554,570,3385
03.07.2018 17:00,3886,47.72,552,574,3334
03.07.2018 18:00,3979,53.7,577,594,3402
03.07.2018 19:00,4103,60.95,581,595,3522
03.07.2018 20:00,4051,56.9,551,553,3500
03.07.2018 21:00,3957,46.04,543,547,3414
03.07.2018 22:00,3710,42.26,481,483,3229
03.07.2018 23:00,3458,39.79,436,435,3022
03.08.2018 00:00,3210,37.29,383,381,2827
03.08.2018 01:00,3148,37.37,374,370,2774
03.08.2018 02:00,3098,35.89,336,336,2762
03.08.2018 03:00,3052,35.73,300,299,2752
03.08.2018 04:00,3047,35.63,268,269,2779
03.08.2018 05:00,3067,36.09,238,242,2829
03.08.2018 06:00,3204,36.97,202,204,3002
03.08.2018 07:00,3612,40.54,174,176,3438
03.08.2018 08:00,3916,46.2,147,149,3769
03.08.2018 09:00,4022,46.96,124,124,3898
03.08.2018 10:00,4024,44.91,100,100,3924
03.08.2018 11:00,3993,42.4,88,87,3905
03.08.2018 12:00,3942,41.51,78,76,3864
03.08.2018 13:00,3885,40.89,89,91,3796
03.08.2018 14:00,3887,40.34,96,98,3791
03.08.2018 15:00,3866,39.51,111,113,3755
03.08.2018 16:00,3864,39.47,102,106,3762
03.08.2018 17:00,3870,40.51,123,125,3747
03.08.2018 18:00,3922,42.99,110,113,3812
03.08.2018 19:00,3991,47.66,131,129,3860
03.08.2018 20:00,3916,44.21,148,146,3768
03.08.2018 21:00,3774,38.8,161,167,3613
03.08.2018 22:00,3611,37.73,161,174,3450
03.08.2018 23:00,3375,36.52,187,191,3188
03.09.2018 00:00,3143,35.57,233,210,2910
03.09.2018 01:00,2980,35.77,167,165,2813
03.09.2018 02:00,2931,35.33,162,170,2769
03.09.2018 03:00,2875,34.99,174,169,2701
03.09.2018 04:00,2863,34.99,201,174,2662
03.09.2018 05:00,2974,35.55,173,178,2801
03.09.2018 06:00,3136,36.4,174,185,2962
03.09.2018 07:00,3470,38.14,172,172,3298
03.09.2018 08:00,3758,41.98,172,168,3586
03.09.2018 09:00,3823,43.93,188,165,3635
03.09.2018 10:00,3794,41.94,214,168,3580
03.09.2018 11:00,3820,40.69,215,181,3605
03.09.2018 12:00,3832,39.81,213,216,3619
03.09.2018 13:00,3760,38.51,246,253,3514
03.09.2018 14:00,3696,39.72,247,263,3449
03.09.2018 15:00,3573,40.38,285,259,3288
03.09.2018 16:00,3587,40.84,314,284,3273
03.09.2018 17:00,3641,41.56,310,303,3331
03.09.2018 18:00,3754,45.03,284,285,3470
03.09.2018 19:00,3859,54.01,260,263,3599
03.09.2018 20:00,3841,46.22,245,254,3596
03.09.2018 21:00,3624,47.71,206,217,3418
03.09.2018 22:00,3434,41.42,159,161,3275
03.09.2018 23:00,3262,39.76,140,141,3122
03.10.2018 00:00,3091,37.9,122,123,2969
03.10.2018 01:00,2969,37.88,125,128,2844
03.10.2018 02:00,2909,36.84,108,110,2801
03.10.2018 03:00,2881,36.44,92,94,2789
03.10.2018 04:00,2863,36.04,83,84,2780
03.10.2018 05:00,2888,36.27,73,74,2815
03.10.2018 06:00,2984,36.51,65,66,2919
03.10.2018 07:00,3074,36.72,58,58,3016
03.10.2018 08:00,3218,37.25,54,52,3164
03.10.2018 09:00,3364,37.56,45,45,3319
03.10.2018 10:00,3472,37.89,38,44,3434
03.10.2018 11:00,3476,37.66,34,40,3442
03.10.2018 12:00,3443,37.39,34,39,3409
03.10.2018 13:00,3354,37.03,38,41,3316
03.10.2018 14:00,3270,36.59,46,50,3224
03.10.2018 15:00,3185,36.36,63,58,3122
03.10.2018 16:00,3151,36.31,81,79,3070
03.10.2018 17:00,3246,36.76,108,113,3138
03.10.2018 18:00,3386,38.67,156,160,3230
03.10.2018 19:00,3555,41.3,225,231,3330
03.10.2018 20:00,3518,41.28,294,298,3224
03.10.2018 21:00,3336,38.43,355,347,2981
03.10.2018 22:00,3212,36.71,414,407,2798
03.10.2018 23:00,3115,36.38,440,449,2675
03.11.2018 00:00,3043,36.06,478,494,2565
03.11.2018 01:00,2957,36.38,517,533,2440
03.11.2018 02:00,2896,35.94,543,558,2353
03.11.2018 03:00,2878,35.76,588,582,2290
03.11.2018 04:00,2909,35.78,623,610,2286
03.11.2018 05:00,2920,35.69,633,641,2287
03.11.2018 06:00,2903,36.02,676,678,2227
03.11.2018 07:00,2949,36.33,692,699,2257
03.11.2018 08:00,2990,36.13,714,717,2276
03.11.2018 09:00,3189,36.34,713,721,2476
03.11.2018 10:00,3330,36.54,721,729,2609
03.11.2018 11:00,3354,36.86,713,715,2641
03.11.2018 12:00,3389,36.87,706,698,2683
03.11.2018 13:00,3308,36.51,706,680,2602
03.11.2018 14:00,3341,36.22,682,675,2659
03.11.2018 15:00,3244,35.52,687,671,2557
03.11.2018 16:00,3200,35.5,685,667,2515
03.11.2018 17:00,3313,36.02,665,679,2648
03.11.2018 18:00,3439,37.02,673,678,2766
03.11.2018 19:00,3563,37.49,682,696,2881
03.11.2018 20:00,3510,38.06,675,693,2835
03.11.2018 21:00,3360,36.9,682,683,2678
03.11.2018 22:00,3193,36.06,664,672,2529
03.11.2018 23:00,3041,35.71,620,649,2421
03.12.2018 00:00,2933,34.95,613,624,2320
03.12.2018 01:00,2856,34.31,640,633,2216
03.12.2018 02:00,2797,33.1,590,594,2207
03.12.2018 03:00,2769,34.01,550,556,2219
03.12.2018 04:00,2813,35.01,493,489,2320
03.12.2018 05:00,2870,35.84,453,447,2417
03.12.2018 06:00,3055,38.2,404,418,2651
03.12.2018 07:00,3421,41.59,385,394,3036
03.12.2018 08:00,3793,49.37,356,347,3437
03.12.2018 09:00,3875,50.48,314,301,3561
03.12.2018 10:00,3877,49.99,298,296,3579
03.12.2018 11:00,3874,47.91,210,219,3664
03.12.2018 12:00,3805,46.23,171,173,3634
03.12.2018 13:00,3692,45,117,120,3575
03.12.2018 14:00,3704,42.48,90,91,3614
03.12.2018 15:00,3666,41.65,102,105,3564
03.12.2018 16:00,3626,41.67,72,74,3554
03.12.2018 17:00,3585,42.49,70,72,3515
03.12.2018 18:00,3662,46.96,74,77,3588
03.12.2018 19:00,3758,50.24,80,83,3678
03.12.2018 20:00,3675,49.94,81,82,3594
03.12.2018 21:00,3539,42.24,79,81,3460
03.12.2018 22:00,3352,39.71,76,79,3276
03.12.2018 23:00,3107,37.6,77,83,3030
13.03.2018 00:00,2903,36.58,91,96,2812
13.03.2018 01:00,2771,37.35,109,115,2662
13.03.2018 02:00,2725,36.94,134,138,2591
13.03.2018 03:00,2706,35.97,160,157,2546
13.03.2018 04:00,2701,35.62,167,174,2534
13.03.2018 05:00,2762,36.79,184,193,2578
13.03.2018 06:00,2920,38.29,198,206,2722
13.03.2018 07:00,3283,40.6,218,228,3065
13.03.2018 08:00,3637,46.46,217,228,3420
13.03.2018 09:00,3733,47.51,210,215,3523
13.03.2018 10:00,3693,47.07,175,182,3518
13.03.2018 11:00,3710,46.95,172,180,3538
13.03.2018 12:00,3741,44.59,195,201,3546
13.03.2018 13:00,3610,45.81,169,165,3441
13.03.2018 14:00,3652,43.97,200,197,3452
13.03.2018 15:00,3627,43.9,205,195,3422
13.03.2018 16:00,3661,42.36,206,196,3455
13.03.2018 17:00,3669,41.85,210,210,3459
13.03.2018 18:00,3810,46.04,207,219,3603
13.03.2018 19:00,3893,50.92,223,232,3670
13.03.2018 20:00,3852,50.19,227,231,3625
13.03.2018 21:00,3717,43.91,235,243,3482
13.03.2018 22:00,3505,42,239,247,3266
13.03.2018 23:00,3261,39.46,240,244,3021
14.03.2018 00:00,3089,37.66,245,249,2844
14.03.2018 01:00,2965,37.04,266,268,2699
14.03.2018 02:00,2917,36.08,270,267,2647
14.03.2018 03:00,2890,36.06,269,267,2621
14.03.2018 04:00,2905,36.1,266,269,2639
14.03.2018 05:00,2969,37.12,257,264,2712
14.03.2018 06:00,3161,39.15,258,264,2903
14.03.2018 07:00,3542,45.27,255,257,3287
14.03.2018 08:00,3888,60.6,236,238,3652
14.03.2018 09:00,3993,64.98,188,194,3805
14.03.2018 10:00,3965,61.99,167,171,3798
14.03.2018 11:00,4028,57.98,128,131,3900
14.03.2018 12:00,4016,53.83,110,112,3906
14.03.2018 13:00,3976,49.58,92,94,3884
14.03.2018 14:00,3918,48.45,63,65,3855
14.03.2018 15:00,3918,46.99,66,64,3852
14.03.2018 16:00,3904,47.66,73,68,3831
14.03.2018 17:00,3897,47.77,65,61,3832
14.03.2018 18:00,3941,53.63,76,74,3865
14.03.2018 19:00,3993,62.81,97,92,3896
14.03.2018 20:00,3928,59.48,126,117,3802
14.03.2018 21:00,3789,47.52,141,128,3648
14.03.2018 22:00,3626,40.93,172,161,3454
14.03.2018 23:00,3382,38.58,182,176,3200
15.03.2018 00:00,3196,37.74,188,186,3008
15.03.2018 01:00,3061,37.99,190,187,2871
15.03.2018 02:00,3001,37.59,199,192,2802
15.03.2018 03:00,2980,37.56,210,210,2770
15.03.2018 04:00,3006,38.07,231,232,2775
15.03.2018 05:00,3075,38.55,275,266,2800
15.03.2018 06:00,3263,40.46,318,314,2945
15.03.2018 07:00,3636,41.59,382,379,3254
15.03.2018 08:00,3927,53.07,463,444,3464
15.03.2018 09:00,4018,73.48,530,502,3488
15.03.2018 10:00,4059,71.18,602,587,3457
15.03.2018 11:00,4142,58,606,625,3536
15.03.2018 12:00,4123,53.37,673,676,3450
15.03.2018 13:00,3976,50.32,707,702,3269
15.03.2018 14:00,3881,46.02,772,752,3109
15.03.2018 15:00,3841,43.93,831,822,3010
15.03.2018 16:00,3870,43.99,900,893,2970
15.03.2018 17:00,3775,42.27,942,933,2833
15.03.2018 18:00,3913,42.16,993,990,2920
15.03.2018 19:00,4056,43.87,1037,1035,3019
15.03.2018 20:00,4060,43.37,1066,1064,2994
15.03.2018 21:00,3960,41.25,1090,1092,2870
15.03.2018 22:00,3776,40.85,1100,1101,2676
15.03.2018 23:00,3544,39.18,1089,1090,2455
16.03.2018 00:00,3343,38.08,1073,1074,2270
16.03.2018 01:00,3228,37.82,1041,1038,2187
16.03.2018 02:00,3255,37.6,1020,1018,2235
16.03.2018 03:00,3276,37.53,1025,1023,2251
16.03.2018 04:00,3294,37.56,1034,1033,2260
16.03.2018 05:00,3375,38.1,1047,1044,2328
16.03.2018 06:00,3551,40.59,1068,1067,2483
16.03.2018 07:00,3862,42.31,1086,1087,2776
16.03.2018 08:00,4216,47,1114,1113,3102
16.03.2018 09:00,4254,49.04,1148,1149,3106
16.03.2018 10:00,4210,46.77,1181,1185,3029
16.03.2018 11:00,4223,44.68,1218,1222,3005
16.03.2018 12:00,4204,43.61,1227,1231,2977
16.03.2018 13:00,4130,42.49,1215,1219,2915
16.03.2018 14:00,4097,41.92,1211,1214,2886
16.03.2018 15:00,3979,41.81,1203,1206,2776
16.03.2018 16:00,3951,41.2,1196,1199,2755
16.03.2018 17:00,3903,40.95,1194,1195,2709
16.03.2018 18:00,4001,42.27,1168,1169,2833
16.03.2018 19:00,4219,43.96,1135,1134,3084
16.03.2018 20:00,4136,42.85,1102,1104,3034
16.03.2018 21:00,3952,41.14,1091,1092,2861
16.03.2018 22:00,3802,39.54,1086,1085,2716
16.03.2018 23:00,3640,38.04,1078,1076,2562
17.03.2018 00:00,3534,37.86,1047,1048,2487
17.03.2018 01:00,3428,38.59,1039,1039,2389
17.03.2018 02:00,3387,38.3,1006,1009,2381
17.03.2018 03:00,3355,38.1,991,993,2364
17.03.2018 04:00,3361,37.88,986,985,2375
17.03.2018 05:00,3389,37.66,987,984,2402
17.03.2018 06:00,3445,37.9,1000,1001,2445
17.03.2018 07:00,3535,37.95,1009,1011,2526
17.03.2018 08:00,3706,38.12,1014,1020,2692
17.03.2018 09:00,3838,38.4,1002,1016,2836
17.03.2018 10:00,3867,38.72,1041,1049,2826
17.03.2018 11:00,3807,38.84,1052,1061,2755
17.03.2018 12:00,3751,38.24,1068,1081,2683
17.03.2018 13:00,3666,37.81,1087,1087,2579
17.03.2018 14:00,3637,37.57,1086,1088,2551
17.03.2018 15:00,3549,37.22,1069,1074,2480
17.03.2018 16:00,3538,36.78,1037,1040,2501
17.03.2018 17:00,3573,36.83,987,990,2586
17.03.2018 18:00,3688,37.93,926,927,2762
17.03.2018 19:00,3806,39.47,855,855,2951
17.03.2018 20:00,3795,38.95,795,797,3000
17.03.2018 21:00,3655,37.78,739,744,2916
17.03.2018 22:00,3557,37.5,663,675,2894
17.03.2018 23:00,3456,37.63,577,611,2879
18.03.2018 00:00,3317,37.28,533,553,2784
18.03.2018 01:00,3350,37.75,552,555,2798
18.03.2018 02:00,3347,37.44,509,513,2838
18.03.2018 03:00,3345,37.31,463,476,2882
18.03.2018 04:00,3354,37.37,446,453,2908
18.03.2018 05:00,3325,37.36,410,416,2915
18.03.2018 06:00,3362,37.14,383,391,2979
18.03.2018 07:00,3382,35.88,354,361,3028
18.03.2018 08:00,3493,36.56,305,315,3188
18.03.2018 09:00,3524,37.03,246,259,3278
18.03.2018 10:00,3489,37.74,200,211,3289
18.03.2018 11:00,3335,37.39,217,174,3118
18.03.2018 12:00,3328,36.98,158,145,3170
18.03.2018 13:00,3212,36.27,130,119,3082
18.03.2018 14:00,3141,35.64,113,122,3028
18.03.2018 15:00,3089,35.31,97,91,2992
18.03.2018 16:00,3043,35.16,90,86,2953
18.03.2018 17:00,3103,36.28,87,88,3016
18.03.2018 18:00,3240,37.49,99,97,3141
18.03.2018 19:00,3549,40.38,111,107,3438
18.03.2018 20:00,3643,41.06,109,112,3534
18.03.2018 21:00,3488,39.78,126,128,3362
18.03.2018 22:00,3418,38.06,141,143,3277
18.03.2018 23:00,3284,38.06,150,149,3134
19.03.2018 00:00,3202,36.88,164,160,3038
19.03.2018 01:00,3125,34.1,171,168,2954
19.03.2018 02:00,3094,33.05,195,197,2899
19.03.2018 03:00,3151,33.35,218,220,2933
19.03.2018 04:00,3191,34.27,247,248,2944
19.03.2018 05:00,3368,36.42,281,283,3087
19.03.2018 06:00,3602,39.47,310,312,3292
19.03.2018 07:00,3973,43.62,335,338,3638
19.03.2018 08:00,4171,52.21,323,326,3848
19.03.2018 09:00,4174,60.09,305,308,3869
19.03.2018 10:00,4111,52.13,317,320,3794
19.03.2018 11:00,3945,47.91,321,323,3624
19.03.2018 12:00,3934,45.72,368,368,3566
19.03.2018 13:00,3831,45.91,423,425,3408
19.03.2018 14:00,3770,42.24,465,471,3305
19.03.2018 15:00,3675,41.49,501,510,3174
19.03.2018 16:00,3700,41.12,543,545,3157
19.03.2018 17:00,3677,41.17,552,543,3125
19.03.2018 18:00,3766,42.32,518,516,3248
19.03.2018 19:00,3850,47,477,480,3373
19.03.2018 20:00,3912,41.98,423,436,3489
19.03.2018 21:00,3821,40.75,374,384,3447
19.03.2018 22:00,3638,40,327,337,3311
19.03.2018 23:00,3433,39.52,309,321,3124
20.03.2018 00:00,3187,37.36,295,307,2892
20.03.2018 01:00,3045,38.02,309,326,2736
20.03.2018 02:00,3026,37.28,366,382,2660
20.03.2018 03:00,2981,37.06,483,476,2498
20.03.2018 04:00,3047,36.59,581,587,2466
20.03.2018 05:00,3161,36.59,632,668,2529
20.03.2018 06:00,3374,38.53,686,704,2688
20.03.2018 07:00,3682,41.71,725,717,2957
20.03.2018 08:00,3990,49.95,715,687,3275
20.03.2018 09:00,4062,49.85,634,638,3428
20.03.2018 10:00,3958,43.42,572,601,3386
20.03.2018 11:00,3740,43.15,505,521,3235
20.03.2018 12:00,3635,42.56,480,485,3155
20.03.2018 13:00,3542,42.09,483,463,3059
20.03.2018 14:00,3503,41.72,457,436,3046
20.03.2018 15:00,3467,41.4,408,401,3059
20.03.2018 16:00,3445,41.22,358,354,3087
20.03.2018 17:00,3432,41.29,311,316,3121
20.03.2018 18:00,3565,45.99,279,273,3286
20.03.2018 19:00,3766,56.92,261,262,3505
20.03.2018 20:00,3806,63.36,206,212,3600
20.03.2018 21:00,3679,50.06,172,169,3507
20.03.2018 22:00,3574,45.96,149,136,3425
20.03.2018 23:00,3395,41.86,107,101,3288
21.03.2018 00:00,3247,39.6,85,79,3162
21.03.2018 01:00,3184,39.46,84,86,3100
21.03.2018 02:00,3150,39.34,107,112,3043
21.03.2018 03:00,3156,39.25,148,152,3008
21.03.2018 04:00,3179,38.99,199,200,2980
21.03.2018 05:00,3237,39.35,250,250,2987
21.03.2018 06:00,3423,40.39,299,297,3124
21.03.2018 07:00,3766,42.68,339,342,3427
21.03.2018 08:00,4011,52.03,348,350,3663
21.03.2018 09:00,4022,62.37,306,307,3716
21.03.2018 10:00,3965,57.42,274,279,3691
21.03.2018 11:00,3887,54.02,283,291,3604
21.03.2018 12:00,3767,42.4,308,323,3459
21.03.2018 13:00,3643,41.98,349,357,3294
21.03.2018 14:00,3608,41.25,381,380,3227
21.03.2018 15:00,3575,41.1,374,376,3201
21.03.2018 16:00,3591,41.25,409,413,3182
21.03.2018 17:00,3566,41.34,457,433,3109
21.03.2018 18:00,3642,42.66,480,473,3162
21.03.2018 19:00,3722,45.9,540,535,3182
21.03.2018 20:00,3778,43.48,546,577,3232
21.03.2018 21:00,3649,41.84,601,625,3048
21.03.2018 22:00,3388,41.26,628,639,2760
21.03.2018 23:00,3102,38.98,634,620,2468
22.03.2018 00:00,3009,37.06,613,596,2396
22.03.2018 01:00,3017,36.32,588,599,2429
22.03.2018 02:00,2931,35.59,533,554,2398
22.03.2018 03:00,2886,35.78,509,527,2377
22.03.2018 04:00,2917,36.06,501,502,2416
22.03.2018 05:00,2992,37.9,478,462,2514
22.03.2018 06:00,3151,38.59,407,379,2744
22.03.2018 07:00,3518,39.8,327,315,3191
22.03.2018 08:00,3927,42.45,208,241,3719
22.03.2018 09:00,3996,43.2,102,128,3894
22.03.2018 10:00,3938,42.32,55,75,3883
22.03.2018 11:00,3902,41.75,34,35,3868
22.03.2018 12:00,3853,41.25,30,29,3823
22.03.2018 13:00,3783,40.87,27,28,3756
22.03.2018 14:00,3759,40.62,27,31,3732
22.03.2018 15:00,3746,41.22,31,30,3715
22.03.2018 16:00,3725,42.99,38,38,3687
22.03.2018 17:00,3689,42.33,50,45,3639
22.03.2018 18:00,3789,52,63,65,3726
22.03.2018 19:00,3796,70.26,76,83,3720
22.03.2018 20:00,3760,52.05,86,91,3674
22.03.2018 21:00,3603,48.04,84,86,3519
22.03.2018 22:00,3419,43.27,87,86,3332
22.03.2018 23:00,3229,42,80,77,3149
23.03.2018 00:00,3053,41.43,74,74,2979
23.03.2018 01:00,2924,41.39,76,76,2848
23.03.2018 02:00,2853,41.12,73,72,2780
23.03.2018 03:00,2883,40.95,66,63,2817
23.03.2018 04:00,2906,40.49,53,54,2853
23.03.2018 05:00,2936,40.55,38,43,2898
23.03.2018 06:00,3151,42.78,24,30,3127
23.03.2018 07:00,3484,52.05,17,22,3467
23.03.2018 08:00,3837,65.62,13,15,3824
23.03.2018 09:00,3922,70.42,12,14,3910
23.03.2018 10:00,3839,65.72,13,15,3826
23.03.2018 11:00,3842,60.4,17,18,3825
23.03.2018 12:00,3771,56.72,29,29,3742
23.03.2018 13:00,3657,48.06,51,51,3606
23.03.2018 14:00,3556,44.12,66,69,3490
23.03.2018 15:00,3480,42.95,83,85,3397
23.03.2018 16:00,3395,42.49,104,101,3291
23.03.2018 17:00,3373,42.48,120,119,3253
23.03.2018 18:00,3462,43.43,145,143,3317
23.03.2018 19:00,3555,45.31,176,176,3379
23.03.2018 20:00,3531,43.67,209,202,3322
23.03.2018 21:00,3322,41.9,222,217,3100
23.03.2018 22:00,3127,41.19,237,240,2890
23.03.2018 23:00,2973,40.48,248,249,2725
24.03.2018 00:00,2881,39.61,258,258,2623
24.03.2018 01:00,2810,40.24,253,255,2557
24.03.2018 02:00,2757,39.05,260,263,2497
24.03.2018 03:00,2782,38.05,255,255,2527
24.03.2018 04:00,2775,37.48,244,247,2531
24.03.2018 05:00,2781,38.14,241,245,2540
24.03.2018 06:00,2808,38.35,239,237,2569
24.03.2018 07:00,2850,38.86,230,228,2620
24.03.2018 08:00,3001,40.18,229,222,2772
24.03.2018 09:00,3173,41.58,233,218,2940
24.03.2018 10:00,3261,41.5,232,222,3029
24.03.2018 11:00,3283,40.67,230,232,3053
24.03.2018 12:00,3272,40.15,226,238,3046
24.03.2018 13:00,3178,39.72,236,239,2942
24.03.2018 14:00,3126,39.23,256,247,2870
24.03.2018 15:00,3056,39.22,242,235,2814
24.03.2018 16:00,3088,39.43,239,234,2849
24.03.2018 17:00,3169,40.55,243,244,2926
24.03.2018 18:00,3275,42.42,255,256,3020
24.03.2018 19:00,3368,44.13,286,284,3082
24.03.2018 20:00,3345,43.8,306,309,3039
24.03.2018 21:00,3188,42.33,310,318,2878
24.03.2018 22:00,3060,41.94,327,330,2733
24.03.2018 23:00,2918,40.29,323,321,2595
25.03.2018 00:00,2799,38.07,308,315,2491
25.03.2018 01:00,2727,38.52,287,298,2440
25.03.2018 02:00,2666,38.01,274,279,2392
25.03.2018 03:00,2761.949947,36.96376226,446.1037531,443.144979,2315.846194
25.03.2018 04:00,2661,37.85,260,263,2401
25.03.2018 05:00,2662,37.28,241,247,2421
25.03.2018 06:00,2703,37.51,232,239,2471
25.03.2018 07:00,2792,37.99,224,231,2568
25.03.2018 08:00,2822,38.67,216,219,2606
25.03.2018 09:00,2906,39.64,200,203,2706
25.03.2018 10:00,3033,40.92,192,195,2841
25.03.2018 11:00,3081,41.02,186,188,2895
25.03.2018 12:00,3069,40.82,190,191,2879
25.03.2018 13:00,3042,40.28,197,198,2845
25.03.2018 14:00,2944,39.66,180,180,2764
25.03.2018 15:00,2860,39.11,180,180,2680
25.03.2018 16:00,2828,38.62,176,176,2652
25.03.2018 17:00,2883,38.25,165,167,2718
25.03.2018 18:00,2946,38.96,161,161,2785
25.03.2018 19:00,3069,40.92,179,178,2890
25.03.2018 20:00,3217,43.51,186,185,3031
25.03.2018 21:00,3179,43.07,196,193,2983
25.03.2018 22:00,3030,42,201,201,2829
25.03.2018 23:00,2874,41.11,196,200,2678
26.03.2018 00:00,2723,39.54,197,202,2526
26.03.2018 01:00,2608,40.36,195,200,2413
26.03.2018 02:00,2577,39.53,193,198,2384
26.03.2018 03:00,2558,38.92,195,200,2363
26.03.2018 04:00,2571,38.01,188,196,2383
26.03.2018 05:00,2653,39.34,180,187,2473
26.03.2018 06:00,2872,41.65,164,171,2708
26.03.2018 07:00,3255,45.89,145,153,3110
26.03.2018 08:00,3567,51.6,133,129,3434
26.03.2018 09:00,3714,63.81,116,111,3598
26.03.2018 10:00,3758,67.59,107,104,3651
26.03.2018 11:00,3816,57.93,100,109,3716
26.03.2018 12:00,3760,54.88,88,97,3672
26.03.2018 13:00,3669,51.97,100,107,3569
26.03.2018 14:00,3628,50.54,110,112,3518
26.03.2018 15:00,3612,47.92,117,120,3495
26.03.2018 16:00,3604,45.34,122,124,3482
26.03.2018 17:00,3549,44.03,131,133,3418
26.03.2018 18:00,3569,45.09,140,142,3429
26.03.2018 19:00,3558,49.55,152,154,3406
26.03.2018 20:00,3657,53.48,174,175,3483
26.03.2018 21:00,3674,48.06,202,204,3472
26.03.2018 22:00,3526,45.34,239,239,3287
26.03.2018 23:00,3297,43.64,297,284,3000
27.03.2018 00:00,3123,42.1,348,325,2775
27.03.2018 01:00,2995,42.4,368,349,2627
27.03.2018 02:00,2928,40.15,359,353,2569
27.03.2018 03:00,2876,39.75,352,350,2524
27.03.2018 04:00,2887,39.53,353,347,2534
27.03.2018 05:00,2984,39.86,351,342,2633
27.03.2018 06:00,3177,41.83,335,336,2842
27.03.2018 07:00,3644,45.62,332,337,3312
27.03.2018 08:00,3888,54.92,317,331,3571
27.03.2018 09:00,3955,67.48,321,330,3634
27.03.2018 10:00,3993,60.69,331,331,3662
27.03.2018 11:00,4061,55.98,340,340,3721
27.03.2018 12:00,4035,52.38,347,347,3688
27.03.2018 13:00,3977,47.53,351,360,3626
27.03.2018 14:00,3959,44.96,349,362,3610
27.03.2018 15:00,3918,44.18,333,346,3585
27.03.2018 16:00,3920,43.99,319,333,3601
27.03.2018 17:00,3815,43.86,320,322,3495
27.03.2018 18:00,3811,44.19,346,349,3465
27.03.2018 19:00,3807,44.44,390,382,3417
27.03.2018 20:00,3811,45.49,478,430,3333
27.03.2018 21:00,3851,44.24,519,473,3332
27.03.2018 22:00,3721,42.8,531,528,3190
27.03.2018 23:00,3498,41.1,573,555,2925
28.03.2018 00:00,3329,39.79,593,566,2736
28.03.2018 01:00,3249,41.46,630,604,2619
28.03.2018 02:00,3277,41.47,622,617,2655
28.03.2018 03:00,3270,41.38,618,633,2652
28.03.2018 04:00,3269,41.61,631,628,2638
28.03.2018 05:00,3307,41.68,652,635,2655
28.03.2018 06:00,3514,43.48,670,662,2844
28.03.2018 07:00,3878,45.61,692,682,3186
28.03.2018 08:00,4110,53.95,708,697,3402
28.03.2018 09:00,4180,67.33,733,728,3447
28.03.2018 10:00,4184,59.84,773,769,3411
28.03.2018 11:00,4098,54.99,804,802,3294
28.03.2018 12:00,3976,48.77,830,828,3146
28.03.2018 13:00,3858,46.26,827,825,3031
28.03.2018 14:00,3774,45.13,829,828,2945
28.03.2018 15:00,3755,45,798,800,2957
28.03.2018 16:00,3754,44.07,832,834,2922
28.03.2018 17:00,3674,43.46,841,840,2833
28.03.2018 18:00,3721,44,850,849,2871
28.03.2018 19:00,3764,44.93,870,869,2894
28.03.2018 20:00,3840,46.99,891,890,2949
28.03.2018 21:00,3911,45.56,928,929,2983
28.03.2018 22:00,3715,43.35,969,970,2746
28.03.2018 23:00,3543,40.81,1006,1006,2537
29.03.2018 00:00,3312,39.46,1031,1030,2281
29.03.2018 01:00,3173,39.29,1062,1061,2111
29.03.2018 02:00,3106,38.98,1082,1081,2024
29.03.2018 03:00,3090,38.41,1108,1108,1982
29.03.2018 04:00,3080,38.91,1137,1138,1943
29.03.2018 05:00,3166,39.12,1166,1169,2000
29.03.2018 06:00,3270,39.58,1189,1192,2081
29.03.2018 07:00,3571,39.8,1207,1210,2364
29.03.2018 08:00,3961,42.36,1228,1232,2733
29.03.2018 09:00,4149,43.6,1247,1249,2902
29.03.2018 10:00,4132,43.34,1268,1269,2864
29.03.2018 11:00,4125,41.86,1278,1280,2847
29.03.2018 12:00,4071,40.93,1287,1288,2784
29.03.2018 13:00,3970,40.52,1278,1280,2692
29.03.2018 14:00,3892,39.92,1265,1267,2627
29.03.2018 15:00,3816,39.56,1229,1231,2587
29.03.2018 16:00,3765,39.63,1198,1200,2567
29.03.2018 17:00,3752,39.85,1152,1167,2600
29.03.2018 18:00,3764,41.34,1098,1117,2666
29.03.2018 19:00,3715,42.12,1056,1077,2659
29.03.2018 20:00,3728,43.61,1031,1024,2697
29.03.2018 21:00,3632,42.63,980,959,2652
29.03.2018 22:00,3463,42.48,935,909,2528
29.03.2018 23:00,3282,42.08,875,861,2407
30.03.2018 00:00,3085,40.87,823,826,2262
30.03.2018 01:00,3010,39.92,805,826,2205
30.03.2018 02:00,2951,39.49,739,758,2212
30.03.2018 03:00,2977,39.17,664,684,2313
30.03.2018 04:00,2951,39.23,605,620,2346
30.03.2018 05:00,2962,39.34,567,567,2395
30.03.2018 06:00,3025,39.88,522,528,2503
30.03.2018 07:00,3096,39.96,493,494,2603
30.03.2018 08:00,3246,41.48,458,456,2788
30.03.2018 09:00,3439,43.53,418,422,3021
30.03.2018 10:00,3454,43.17,379,379,3075
30.03.2018 11:00,3462,42.59,330,331,3132
30.03.2018 12:00,3378,41.71,272,274,3106
30.03.2018 13:00,3302,40.92,228,231,3074
30.03.2018 14:00,3223,40.33,206,208,3017
30.03.2018 15:00,3187,40.16,179,183,3008
30.03.2018 16:00,3142,40.11,155,158,2987
30.03.2018 17:00,3132,40.33,140,142,2992
30.03.2018 18:00,3158,41.04,134,134,3024
30.03.2018 19:00,3161,41.82,137,131,3024
30.03.2018 20:00,3192,42.71,142,133,3050
30.03.2018 21:00,3230,42.4,150,140,3080
30.03.2018 22:00,3123,42.23,157,147,2966
30.03.2018 23:00,3035,40.87,156,159,2879
31.03.2018 00:00,2937,39.5,171,171,2766
31.03.2018 01:00,2829,39.98,163,159,2666
31.03.2018 02:00,2782,40.07,199,196,2583
31.03.2018 03:00,2769,39.94,236,230,2533
31.03.2018 04:00,2777,40,264,263,2513
31.03.2018 05:00,2763,40.1,273,283,2490
31.03.2018 06:00,2756,39.92,300,308,2456
31.03.2018 07:00,2811,39.68,313,327,2498
31.03.2018 08:00,2962,39.78,338,347,2624
31.03.2018 09:00,3147,40.52,380,371,2767
31.03.2018 10:00,3245,40.74,386,384,2859
31.03.2018 11:00,3238,40.65,415,399,2823
31.03.2018 12:00,3160,40.2,416,426,2744
31.03.2018 13:00,3091,40,413,413,2678
31.03.2018 14:00,3085,39.77,431,433,2654
31.03.2018 15:00,3095,39.45,448,447,2647
31.03.2018 16:00,3076,39.27,477,484,2599
31.03.2018 17:00,3073,39.14,532,516,2541
31.03.2018 18:00,3082,39.34,588,549,2494
31.03.2018 19:00,3053,40.05,600,557,2453
31.03.2018 20:00,3093,40.72,588,572,2505
31.03.2018 21:00,3107,40.74,595,584,2512
31.03.2018 22:00,2985,40.24,583,579,2402
31.03.2018 23:00,2843,39.98,597,567,2246
04.01.2018 00:00,0,39.56,566,566,-566
04.01.2018 01:00,2705,39.8,566,561,2139
04.01.2018 02:00,2644,39.57,583,589,2061
04.01.2018 03:00,2651,39.45,602,615,2049
04.01.2018 04:00,2688,39.43,652,641,2036
04.01.2018 05:00,2695,39.53,665,673,2030
04.01.2018 06:00,2712,39.33,708,698,2004
04.01.2018 07:00,2769,39.51,740,738,2029
04.01.2018 08:00,2792,39.39,785,768,2007
04.01.2018 09:00,2884,39.62,790,763,2094
04.01.2018 10:00,2959,39.61,777,749,2182
04.01.2018 11:00,3046,39.52,775,756,2271
04.01.2018 12:00,3149,39.17,743,744,2406
04.01.2018 13:00,3231,38.86,725,747,2506
04.01.2018 14:00,3220,38.48,723,727,2497
04.01.2018 15:00,3188,38.15,734,714,2454
04.01.2018 16:00,3174,38.03,740,717,2434
04.01.2018 17:00,3167,38.13,731,714,2436
04.01.2018 18:00,3184,38.59,715,709,2469
04.01.2018 19:00,3225,39.22,679,691,2546
04.01.2018 20:00,3310,39.64,657,671,2653
04.01.2018 21:00,3340,40,632,635,2708
04.01.2018 22:00,3222,39.89,598,604,2624
04.01.2018 23:00,3086,39.81,557,565,2529
04.02.2018 00:00,2991,39.22,533,552,2458
04.02.2018 01:00,2914,38.58,549,563,2365
04.02.2018 02:00,2846,37.97,550,558,2296
04.02.2018 03:00,2808,37.14,549,542,2259
04.02.2018 04:00,2823,37.06,540,538,2283
04.02.2018 05:00,2827,37.72,536,534,2291
04.02.2018 06:00,2868,39.12,515,516,2353
04.02.2018 07:00,2946,39.96,489,493,2457
04.02.2018 08:00,3004,39.62,442,459,2562
04.02.2018 09:00,3102,40.33,397,411,2705
04.02.2018 10:00,3130,40.56,365,367,2765
04.02.2018 11:00,3088,40.63,333,326,2755
04.02.2018 12:00,3033,40.32,320,317,2713
04.02.2018 13:00,2928,39.91,310,316,2618
04.02.2018 14:00,2854,39.52,326,332,2528
04.02.2018 15:00,2749,38.79,345,343,2404
04.02.2018 16:00,2627,38.62,321,319,2306
04.02.2018 17:00,2605,39.08,309,308,2296
04.02.2018 18:00,2677,39.53,283,284,2394
04.02.2018 19:00,2802,40.11,228,232,2574
04.02.2018 20:00,2952,40.88,187,193,2765
04.02.2018 21:00,3072,41.09,164,168,2908
04.02.2018 22:00,2964,40.92,128,130,2836
04.02.2018 23:00,2831,39.96,118,118,2713
04.03.2018 00:00,2710,39.22,106,103,2604
04.03.2018 01:00,2694,40.07,85,87,2609
04.03.2018 02:00,2677,39.33,72,78,2605
04.03.2018 03:00,2695,39.01,71,79,2624
04.03.2018 04:00,2696,39.04,88,96,2608
04.03.2018 05:00,2698,39.31,144,155,2554
04.03.2018 06:00,2856,40.52,208,220,2648
04.03.2018 07:00,3188,42.72,309,302,2879
04.03.2018 08:00,3523,46.18,397,400,3126
04.03.2018 09:00,3764,50.46,469,469,3295
04.03.2018 10:00,3820,49.83,536,520,3284
04.03.2018 11:00,3911,49.64,553,532,3358
04.03.2018 12:00,3924,45.68,535,526,3389
04.03.2018 13:00,3888,45.02,499,493,3389
04.03.2018 14:00,3797,44.74,463,457,3334
04.03.2018 15:00,3740,43.96,397,410,3343
04.03.2018 16:00,3744,43.28,354,360,3390
04.03.2018 17:00,3638,43.22,314,312,3324
04.03.2018 18:00,3673,44.54,300,303,3373
04.03.2018 19:00,3691,47.53,303,305,3388
04.03.2018 20:00,3652,49.95,296,302,3356
04.03.2018 21:00,3625,47.85,309,322,3316
04.03.2018 22:00,3403,42.87,340,351,3063
04.03.2018 23:00,3099,40.5,391,379,2708
04.04.2018 00:00,2877,39.13,436,409,2441
04.04.2018 01:00,2801,39.31,473,459,2328
04.04.2018 02:00,2706,38.51,501,482,2205
04.04.2018 03:00,2641,38.75,536,497,2105
04.04.2018 04:00,2639,38.94,521,507,2118
04.04.2018 05:00,2706,38.84,538,559,2168
04.04.2018 06:00,2801,40.08,587,583,2214
04.04.2018 07:00,3181,42.75,595,606,2586
04.04.2018 08:00,3541,48.5,612,628,2929
04.04.2018 09:00,3592,55.51,623,600,2969
04.04.2018 10:00,3494,48.76,560,524,2934
04.04.2018 11:00,3505,45,513,501,2992
04.04.2018 12:00,3395,44.9,467,454,2928
04.04.2018 13:00,3301,43.21,391,387,2910
04.04.2018 14:00,3273,42.58,311,330,2962
04.04.2018 15:00,3184,41.32,254,280,2930
04.04.2018 16:00,3132,41.03,216,215,2916
04.04.2018 17:00,3078,41.15,155,158,2923
04.04.2018 18:00,3026,41.49,118,121,2908
04.04.2018 19:00,3014,42.4,99,101,2915
04.04.2018 20:00,3075,42.79,118,116,2957
04.04.2018 21:00,3209,43.74,150,154,3059
04.04.2018 22:00,3129,42.54,196,204,2933
04.04.2018 23:00,2911,40.07,258,287,2653
04.05.2018 00:00,2652,37.95,322,354,2330
04.05.2018 01:00,2402,39.39,337,343,2065
04.05.2018 02:00,2296,38.88,486,446,1810
04.05.2018 03:00,2241,38.8,549,522,1692
04.05.2018 04:00,2198,39.09,537,511,1661
04.05.2018 05:00,2365,38.96,473,483,1892
04.05.2018 06:00,2558,40.23,444,446,2114
04.05.2018 07:00,2952,42.24,413,420,2539
04.05.2018 08:00,3233,47.64,418,402,2815
04.05.2018 09:00,3362,52.28,333,347,3029
04.05.2018 10:00,3354,51.98,306,327,3048
04.05.2018 11:00,3397,47.98,281,303,3116
04.05.2018 12:00,3498,46.53,297,326,3201
04.05.2018 13:00,3436,44.06,345,355,3091
04.05.2018 14:00,3412,43.28,374,384,3038
04.05.2018 15:00,3335,42.42,416,423,2919
04.05.2018 16:00,3284,42.29,467,470,2817
04.05.2018 17:00,3191,42.44,532,535,2659
04.05.2018 18:00,3060,42.5,635,622,2425
04.05.2018 19:00,3024,42.65,739,722,2285
04.05.2018 20:00,3162,42.71,842,847,2320
04.05.2018 21:00,3155,42.55,930,943,2225
04.05.2018 22:00,3096,41.2,1041,1054,2055
04.05.2018 23:00,2845,39.9,1150,1151,1695
04.06.2018 00:00,2687,36.87,1223,1215,1464
04.06.2018 01:00,2613,36.55,1286,1284,1327
04.06.2018 02:00,2641,35.05,1327,1326,1314
04.06.2018 03:00,2666,33.97,1354,1353,1312
04.06.2018 04:00,2692,33.45,1365,1364,1327
04.06.2018 05:00,2744,33.72,1373,1374,1371
04.06.2018 06:00,2904,39.04,1375,1376,1529
04.06.2018 07:00,3209,41.39,1355,1355,1854
04.06.2018 08:00,3518,45.64,1337,1337,2181
04.06.2018 09:00,3595,49.33,1323,1321,2272
04.06.2018 10:00,3537,43.98,1309,1307,2228
04.06.2018 11:00,3465,41.94,1301,1296,2164
04.06.2018 12:00,3343,40.87,1275,1266,2068
04.06.2018 13:00,3197,40.4,1226,1208,1971
04.06.2018 14:00,3084,40.08,1132,1129,1952
04.06.2018 15:00,2922,39.48,1012,1022,1910
04.06.2018 16:00,2829,39.37,876,893,1953
04.06.2018 17:00,2764,39.75,740,755,2024
04.06.2018 18:00,2834,40.22,575,586,2259
04.06.2018 19:00,2870,40.53,406,414,2464
04.06.2018 20:00,2921,41.41,286,291,2635
04.06.2018 21:00,2997,40.98,224,225,2773
04.06.2018 22:00,2860,40.53,186,187,2674
04.06.2018 23:00,2760,39.65,166,167,2594
04.07.2018 00:00,2659,37.54,152,154,2507
04.07.2018 01:00,2576,39.1,117,121,2459
04.07.2018 02:00,2530,38.44,120,126,2410
04.07.2018 03:00,2508,38.28,157,162,2351
04.07.2018 04:00,2530,38.13,231,232,2299
04.07.2018 05:00,2509,38.5,326,314,2183
04.07.2018 06:00,2505,38.83,406,403,2099
04.07.2018 07:00,2419,38.75,507,487,1912
04.07.2018 08:00,2483,39.11,581,557,1902
04.07.2018 09:00,2696,40.96,618,594,2078
04.07.2018 10:00,2832,41.75,655,648,2177
04.07.2018 11:00,2807,41.81,679,672,2128
04.07.2018 12:00,2725,40.92,727,725,1998
04.07.2018 13:00,2619,40.06,784,784,1835
04.07.2018 14:00,2598,39.43,827,827,1771
04.07.2018 15:00,2544,39,821,820,1723
04.07.2018 16:00,2549,38.73,779,773,1770
04.07.2018 17:00,2565,38.45,728,719,1837
04.07.2018 18:00,2690,38.93,718,700,1972
04.07.2018 19:00,2790,39.51,614,608,2176
04.07.2018 20:00,2934,40.45,599,611,2335
04.07.2018 21:00,2992,40.48,590,599,2402
04.07.2018 22:00,2885,39.09,622,621,2263
04.07.2018 23:00,2698,38.07,622,617,2076
04.08.2018 00:00,2491,38.82,615,614,1876
04.08.2018 01:00,2295,39.15,563,570,1732
04.08.2018 02:00,2248,38.98,568,565,1680
04.08.2018 03:00,2278,38.96,530,532,1748
04.08.2018 04:00,2348,39.02,497,494,1851
04.08.2018 05:00,2389,39.13,460,456,1929
04.08.2018 06:00,2420,39.28,416,414,2004
04.08.2018 07:00,2492,38.97,384,381,2108
04.08.2018 08:00,2533,38.86,332,331,2201
04.08.2018 09:00,2574,39.42,291,287,2283
04.08.2018 10:00,2588,39.82,241,234,2347
04.08.2018 11:00,2554,40.05,223,207,2331
04.08.2018 12:00,2506,39.84,215,211,2291
04.08.2018 13:00,2404,39.49,208,215,2196
04.08.2018 14:00,2337,39.12,255,267,2082
04.08.2018 15:00,2279,38.88,264,272,2015
04.08.2018 16:00,2246,38.8,243,250,2003
04.08.2018 17:00,2249,38.85,255,247,1994
04.08.2018 18:00,2395,39.07,284,283,2111
04.08.2018 19:00,2518,39.46,323,328,2195
04.08.2018 20:00,2540,40.72,341,343,2199
04.08.2018 21:00,2566,42.26,339,349,2227
04.08.2018 22:00,2414,41.68,377,383,2037
04.08.2018 23:00,2209,39.9,378,387,1831
04.09.2018 00:00,2074,38.8,359,363,1715
04.09.2018 01:00,2058,38.57,383,387,1675
04.09.2018 02:00,2061,38,336,337,1725
04.09.2018 03:00,2067,37.94,288,291,1779
04.09.2018 04:00,2123,37.97,244,245,1879
04.09.2018 05:00,2229,39.1,203,202,2026
04.09.2018 06:00,2417,39.92,154,153,2263
04.09.2018 07:00,2796,42.46,121,117,2675
04.09.2018 08:00,3043,50.04,93,84,2950
04.09.2018 09:00,3078,61.14,63,58,3015
04.09.2018 10:00,3038,52.01,45,36,2993
04.09.2018 11:00,3008,47.77,41,30,2967
04.09.2018 12:00,2955,44.78,44,30,2911
04.09.2018 13:00,2883,42.94,46,34,2837
04.09.2018 14:00,2824,42.5,47,43,2777
04.09.2018 15:00,2782,41.51,46,51,2736
04.09.2018 16:00,2763,41.35,50,55,2713
04.09.2018 17:00,2700,41.96,54,56,2646
04.09.2018 18:00,2683,43.68,57,60,2626
04.09.2018 19:00,2651,44.91,78,79,2573
04.09.2018 20:00,2639,45.26,114,108,2525
04.09.2018 21:00,2728,43.66,141,143,2587
04.09.2018 22:00,2632,41.26,172,196,2460
04.09.2018 23:00,2388,39.63,228,243,2160
04.10.2018 00:00,2202,38.36,268,280,1934
04.10.2018 01:00,2059,38.45,288,287,1771
04.10.2018 02:00,2047,37.04,352,351,1695
04.10.2018 03:00,1969,37.03,409,409,1560
04.10.2018 04:00,2012,37.05,480,484,1532
04.10.2018 05:00,2070,37.78,559,571,1511
04.10.2018 06:00,2303,39.09,633,652,1670
04.10.2018 07:00,2727,41.37,722,764,2005
04.10.2018 08:00,3136,44.32,814,849,2322
04.10.2018 09:00,3220,45.74,879,906,2341
04.10.2018 10:00,3149,44.01,926,937,2223
04.10.2018 11:00,3123,43.26,944,969,2179
04.10.2018 12:00,3063,41.98,980,1009,2083
04.10.2018 13:00,2962,42,1019,1026,1943
04.10.2018 14:00,2880,41.67,1047,1043,1833
04.10.2018 15:00,2841,41.07,1071,1069,1770
04.10.2018 16:00,2837,40.82,1095,1097,1742
04.10.2018 17:00,2797,40.9,1130,1129,1667
04.10.2018 18:00,2846,41.08,1163,1144,1683
04.10.2018 19:00,2914,41.27,1189,1175,1725
04.10.2018 20:00,3009,41.26,1205,1208,1804
04.10.2018 21:00,3092,41.16,1214,1216,1878
04.10.2018 22:00,3003,40.55,1211,1211,1792
04.10.2018 23:00,2805,39.42,1208,1208,1597
04.11.2018 00:00,2619,37.94,1189,1188,1430
04.11.2018 01:00,2550,38.69,1174,1183,1376
04.11.2018 02:00,2532,38.14,1139,1158,1393
04.11.2018 03:00,2538,37.99,1113,1138,1425
04.11.2018 04:00,2574,38.28,1075,1118,1499
04.11.2018 05:00,2647,38.42,1042,1101,1605
04.11.2018 06:00,2788,39.62,1028,1081,1760
04.11.2018 07:00,3092,40.7,1007,1060,2085
04.11.2018 08:00,3437,44.57,969,1032,2468
04.11.2018 09:00,3490,46.69,974,1019,2516
04.11.2018 10:00,3380,44.69,1009,1031,2371
04.11.2018 11:00,3287,43.55,1036,1040,2251
04.11.2018 12:00,3173,42.13,1042,1053,2131
04.11.2018 13:00,3102,41.3,1060,1057,2042
04.11.2018 14:00,3025,41.35,1063,1059,1962
04.11.2018 15:00,2921,40.66,1061,1058,1860
04.11.2018 16:00,2858,40.62,1044,1036,1814
04.11.2018 17:00,2812,40.89,1033,1027,1779
04.11.2018 18:00,2869,40.95,1024,1026,1845
04.11.2018 19:00,2964,41.21,1035,1034,1929
04.11.2018 20:00,3048,41.57,1023,1035,2025
04.11.2018 21:00,3098,41.68,1005,1008,2093
04.11.2018 22:00,2989,41.09,990,992,1999
04.11.2018 23:00,2759,40.2,989,962,1770
04.12.2018 00:00,2576,39.32,973,958,1603
04.12.2018 01:00,2494,39.64,966,970,1528
04.12.2018 02:00,2432,39.41,977,959,1455
04.12.2018 03:00,2412,39.35,966,952,1446
04.12.2018 04:00,2436,39.41,957,935,1479
04.12.2018 05:00,2483,39.51,967,954,1516
04.12.2018 06:00,2654,39.76,978,969,1676
04.12.2018 07:00,2995,41.06,967,969,2028
04.12.2018 08:00,3339,44.74,966,966,2373
04.12.2018 09:00,3495,49.99,973,1026,2522
04.12.2018 10:00,3352,43.88,945,995,2407
04.12.2018 11:00,3221,41.98,1042,1045,2179
04.12.2018 12:00,3110,41.08,1096,1069,2014
04.12.2018 13:00,3078,40.72,1147,1131,1931
04.12.2018 14:00,2981,40.45,1115,1119,1866
04.12.2018 15:00,2910,39.6,1130,1133,1780
04.12.2018 16:00,2848,39.51,1169,1170,1679
04.12.2018 17:00,2811,39.56,1174,1176,1637
04.12.2018 18:00,2870,39.63,1188,1190,1682
04.12.2018 19:00,2925,39.66,1218,1220,1707
04.12.2018 20:00,2923,40.11,1227,1230,1696
04.12.2018 21:00,2983,39.84,1241,1242,1742
04.12.2018 22:00,2868,39.54,1250,1251,1618
04.12.2018 23:00,2644,39.32,1251,1252,1393
13.04.2018 00:00,2477,38.93,1238,1239,1239
13.04.2018 01:00,2367,38.69,1228,1228,1139
13.04.2018 02:00,2335,38.36,1223,1224,1112
13.04.2018 03:00,2336,38.31,1218,1222,1118
13.04.2018 04:00,2330,38.52,1218,1223,1112
13.04.2018 05:00,2353,38.52,1221,1221,1132
13.04.2018 06:00,2497,39.15,1215,1214,1282
13.04.2018 07:00,2805,40.81,1205,1205,1600
13.04.2018 08:00,3167,43.85,1193,1195,1974
13.04.2018 09:00,3255,46.53,1171,1172,2084
13.04.2018 10:00,3164,45.06,1138,1138,2026
13.04.2018 11:00,3088,41.93,1148,1140,1940
13.04.2018 12:00,2994,40.48,1155,1144,1839
13.04.2018 13:00,2888,39.66,1159,1153,1729
13.04.2018 14:00,2806,39.16,1187,1181,1619
13.04.2018 15:00,2703,39.01,1162,1160,1541
13.04.2018 16:00,2625,38.54,1179,1178,1446
13.04.2018 17:00,2568,38.96,1196,1195,1372
13.04.2018 18:00,2592,39.47,1209,1211,1383
13.04.2018 19:00,2591,39.6,1224,1227,1367
13.04.2018 20:00,2571,39.66,1237,1240,1334
13.04.2018 21:00,2554,39.48,1239,1240,1315
13.04.2018 22:00,2492,39.41,1223,1223,1269
13.04.2018 23:00,2323,39.01,1181,1183,1142
14.04.2018 00:00,2197,37.72,1138,1132,1059
14.04.2018 01:00,2105,31.64,1079,1075,1026
14.04.2018 02:00,2076,29.2,992,1014,1084
14.04.2018 03:00,2050,29,912,943,1138
14.04.2018 04:00,2064,29.92,855,875,1209
14.04.2018 05:00,2067,33.67,778,806,1289
14.04.2018 06:00,2117,32.8,737,751,1380
14.04.2018 07:00,2164,36.93,665,681,1499
14.04.2018 08:00,2351,38.91,597,612,1754
14.04.2018 09:00,2536,39.74,545,525,1991
14.04.2018 10:00,2647,39.92,480,460,2167
14.04.2018 11:00,2597,39.87,387,357,2210
14.04.2018 12:00,2539,39.77,379,334,2160
14.04.2018 13:00,2430,39.47,311,296,2119
14.04.2018 14:00,2336,39.14,304,277,2032
14.04.2018 15:00,2278,38.96,271,264,2007
14.04.2018 16:00,2240,38.87,236,229,2004
14.04.2018 17:00,2320,39.06,191,197,2129
14.04.2018 18:00,2400,39.34,149,154,2251
14.04.2018 19:00,2468,40.05,123,126,2345
14.04.2018 20:00,2511,40.95,106,105,2405
14.04.2018 21:00,2528,41.03,87,87,2441
14.04.2018 22:00,2447,41.14,82,80,2365
14.04.2018 23:00,2318,40.95,81,74,2237
15.04.2018 00:00,2198,39.99,73,65,2125
15.04.2018 01:00,2095,39.56,81,73,2014
15.04.2018 02:00,2026,39.3,87,74,1939
15.04.2018 03:00,1982,38.97,85,74,1897
15.04.2018 04:00,1975,38.91,78,74,1897
15.04.2018 05:00,1971,39.02,80,74,1891
15.04.2018 06:00,2027,38.98,72,81,1955
15.04.2018 07:00,2058,39.11,68,78,1990
15.04.2018 08:00,2149,39.53,70,80,2079
15.04.2018 09:00,2307,39.85,73,68,2234
15.04.2018 10:00,2493,40.13,71,68,2422
15.04.2018 11:00,2605,40.57,63,70,2542
15.04.2018 12:00,2635,40.33,63,72,2572
15.04.2018 13:00,2595,39.89,61,59,2534
15.04.2018 14:00,2545,39.5,61,61,2484
15.04.2018 15:00,2525,39.38,61,56,2464
15.04.2018 16:00,2500,39.33,54,50,2446
15.04.2018 17:00,2529,39.39,45,48,2484
15.04.2018 18:00,2598,39.64,41,45,2557
15.04.2018 19:00,2651,39.76,37,40,2614
15.04.2018 20:00,2711,41.17,43,44,2668
15.04.2018 21:00,2743,42.49,50,44,2693
15.04.2018 22:00,2643,41.73,52,48,2591
15.04.2018 23:00,436,40.32,48,51,388
16.04.2018 00:00,2276,39.18,53,57,2223
16.04.2018 01:00,2163,38.75,34,37,2129
16.04.2018 02:00,2135,38.28,33,34,2102
16.04.2018 03:00,2117,38.16,36,35,2081
16.04.2018 04:00,2101,38.36,39,35,2062
16.04.2018 05:00,2124,39.03,52,43,2072
16.04.2018 06:00,2258,40.97,56,45,2202
16.04.2018 07:00,2584,46.65,55,52,2529
16.04.2018 08:00,2966,56.1,51,45,2915
16.04.2018 09:00,3129,64.99,53,49,3076
16.04.2018 10:00,3166,58.97,40,39,3126
16.04.2018 11:00,3162,55.74,31,34,3131
16.04.2018 12:00,3066,52.97,29,31,3037
16.04.2018 13:00,2990,51.81,29,29,2961
16.04.2018 14:00,2967,49.99,28,30,2939
16.04.2018 15:00,2908,46.3,31,32,2877
16.04.2018 16:00,2845,45.79,30,33,2815
16.04.2018 17:00,2767,44.81,33,34,2734
16.04.2018 18:00,2801,45.74,35,36,2766
16.04.2018 19:00,2795,48.49,36,37,2759
16.04.2018 20:00,2760,52.84,38,39,2722
16.04.2018 21:00,2823,55,44,46,2779
16.04.2018 22:00,2761,48.08,46,47,2715
16.04.2018 23:00,2562,43.98,56,53,2506
17.04.2018 00:00,2365,41.55,64,55,2301
17.04.2018 01:00,2309,40.16,56,47,2253
17.04.2018 02:00,2263,39.71,50,44,2213
17.04.2018 03:00,2255,39.41,45,50,2210
17.04.2018 04:00,2282,39.13,50,58,2232
17.04.2018 05:00,2321,39.18,62,63,2259
17.04.2018 06:00,2474,39.76,72,76,2402
17.04.2018 07:00,2829,45.13,77,85,2752
17.04.2018 08:00,3127,54.88,91,92,3036
17.04.2018 09:00,3220,56,96,91,3124
17.04.2018 10:00,3264,51.93,86,88,3178
17.04.2018 11:00,3286,48.25,84,93,3202
17.04.2018 12:00,3264,46.05,104,110,3160
17.04.2018 13:00,3190,44.92,138,130,3052
17.04.2018 14:00,3138,42.75,176,166,2962
17.04.2018 15:00,3079,40.38,195,196,2884
17.04.2018 16:00,3015,39.97,216,223,2799
17.04.2018 17:00,2904,40.98,236,244,2668
17.04.2018 18:00,2871,43.65,238,243,2633
17.04.2018 19:00,2813,49.09,217,229,2596
17.04.2018 20:00,2851,50.08,218,236,2633
17.04.2018 21:00,2962,44.31,218,233,2744
17.04.2018 22:00,2885,42.67,246,243,2639
17.04.2018 23:00,2643,41.59,264,251,2379
18.04.2018 00:00,2354,39.83,275,275,2079
18.04.2018 01:00,2227,38.64,299,301,1928
18.04.2018 02:00,2204,37.8,303,307,1901
18.04.2018 03:00,2179,37.02,338,340,1841
18.04.2018 04:00,2183,36.54,375,382,1808
18.04.2018 05:00,2187,36.42,422,427,1765
18.04.2018 06:00,2265,38.16,457,453,1808
18.04.2018 07:00,2603,42.31,466,453,2137
18.04.2018 08:00,2891,51.74,499,454,2392
18.04.2018 09:00,3036,55.43,446,421,2590
18.04.2018 10:00,3124,47,375,386,2749
18.04.2018 11:00,3158,44.03,357,397,2801
18.04.2018 12:00,3027,42.28,357,379,2670
18.04.2018 13:00,2926,41.71,397,408,2529
18.04.2018 14:00,2889,40.89,444,452,2445
18.04.2018 15:00,2725,39.73,464,472,2261
18.04.2018 16:00,2694,39.66,483,480,2211
18.04.2018 17:00,2603,40.28,471,466,2132
18.04.2018 18:00,2609,41.01,425,434,2184
18.04.2018 19:00,2644,42.81,391,401,2253
18.04.2018 20:00,2733,43.26,348,356,2385
18.04.2018 21:00,2761,42.86,349,333,2412
18.04.2018 22:00,2661,42.18,326,323,2335
18.04.2018 23:00,2447,41.06,325,334,2122
19.04.2018 00:00,2256,38.08,330,330,1926
19.04.2018 01:00,2188,35.8,340,337,1848
19.04.2018 02:00,2135,34.06,321,319,1814
19.04.2018 03:00,2093,33.4,300,300,1793
19.04.2018 04:00,2111,33.7,276,275,1835
19.04.2018 05:00,2148,33.92,240,243,1908
19.04.2018 06:00,2258,36.46,200,204,2058
19.04.2018 07:00,2587,40.57,153,157,2434
19.04.2018 08:00,2940,49.3,111,113,2829
19.04.2018 09:00,3035,49.96,75,78,2960
19.04.2018 10:00,3006,46.19,51,53,2955
19.04.2018 11:00,3007,43,37,38,2970
19.04.2018 12:00,2994,41.73,32,34,2962
19.04.2018 13:00,2914,39.92,33,34,2881
19.04.2018 14:00,2851,39.66,36,38,2815
19.04.2018 15:00,2782,38.73,40,42,2742
19.04.2018 16:00,2736,38.63,46,50,2690
19.04.2018 17:00,2632,39.42,56,65,2576
19.04.2018 18:00,2645,41.21,59,76,2586
19.04.2018 19:00,2601,41.85,65,87,2536
19.04.2018 20:00,2576,42.4,77,105,2499
19.04.2018 21:00,2604,40.74,101,126,2503
19.04.2018 22:00,2599,39.56,118,154,2481
19.04.2018 23:00,2464,38.01,160,193,2304
20.04.2018 00:00,2322,34.63,218,237,2104
20.04.2018 01:00,2126,34.55,199,203,1927
20.04.2018 02:00,2049,32.2,235,241,1814
20.04.2018 03:00,2045,31.23,272,274,1773
20.04.2018 04:00,2105,31.38,315,306,1790
20.04.2018 05:00,2124,32.06,338,336,1786
20.04.2018 06:00,2252,35.18,363,353,1889
20.04.2018 07:00,2474,40.07,370,357,2104
20.04.2018 08:00,2754,47.95,352,338,2402
20.04.2018 09:00,2996,48.93,326,308,2670
20.04.2018 10:00,3041,45.92,304,293,2737
20.04.2018 11:00,3045,43.02,280,296,2765
20.04.2018 12:00,2984,41,293,334,2691
20.04.2018 13:00,2841,37.86,336,397,2505
20.04.2018 14:00,2676,36.85,384,472,2292
20.04.2018 15:00,2526,35.87,463,524,2063
20.04.2018 16:00,2419,35.03,547,563,1872
20.04.2018 17:00,2345,35.76,579,588,1766
20.04.2018 18:00,2455,37.19,596,601,1859
20.04.2018 19:00,2560,38.33,610,622,1950
20.04.2018 20:00,2491,38.21,695,656,1796
20.04.2018 21:00,2372,37.83,728,694,1644
20.04.2018 22:00,2360,37.24,763,713,1597
20.04.2018 23:00,2243,36.28,753,729,1490
21.04.2018 00:00,2095,31.07,753,763,1342
21.04.2018 01:00,2025,29.51,824,844,1201
21.04.2018 02:00,1955,28.05,848,870,1107
21.04.2018 03:00,1955,27.59,871,883,1084
21.04.2018 04:00,1983,27.08,870,879,1113
21.04.2018 05:00,2025,27.6,853,867,1172
21.04.2018 06:00,2073,29.51,811,844,1262
21.04.2018 07:00,2105,32.06,789,814,1316
21.04.2018 08:00,2243,34.1,758,782,1485
21.04.2018 09:00,2341,34.94,742,778,1599
21.04.2018 10:00,2395,33.93,781,797,1614
21.04.2018 11:00,2417,33.95,849,820,1568
21.04.2018 12:00,2374,33.11,835,846,1539
21.04.2018 13:00,2285,30.93,837,871,1448
21.04.2018 14:00,2211,29.28,845,896,1366
21.04.2018 15:00,2134,24.01,834,907,1300
21.04.2018 16:00,2125,24.96,834,899,1291
21.04.2018 17:00,2160,28.06,817,873,1343
21.04.2018 18:00,2209,30.96,767,813,1442
21.04.2018 19:00,2286,34.39,679,717,1607
21.04.2018 20:00,2355,36.09,568,606,1787
21.04.2018 21:00,2433,36.47,487,529,1946
21.04.2018 22:00,2398,36.34,448,487,1950
21.04.2018 23:00,2260,36.07,421,461,1839
22.04.2018 00:00,2121,35,399,442,1722
22.04.2018 01:00,2063,34.09,362,371,1701
22.04.2018 02:00,2024,31.31,335,343,1689
22.04.2018 03:00,2014,29.64,308,311,1706
22.04.2018 04:00,2002,30.91,278,278,1724
22.04.2018 05:00,2007,31.91,243,243,1764
22.04.2018 06:00,1982,33.15,185,190,1797
22.04.2018 07:00,1979,34.05,131,136,1848
22.04.2018 08:00,2143,35.79,88,93,2055
22.04.2018 09:00,2291,36.42,57,65,2234
22.04.2018 10:00,2348,36.94,36,49,2312
22.04.2018 11:00,2392,37,23,41,2369
22.04.2018 12:00,2407,36.97,25,40,2382
22.04.2018 13:00,2354,36.49,22,42,2332
22.04.2018 14:00,2302,36,17,46,2285
22.04.2018 15:00,2251,35.61,21,49,2230
22.04.2018 16:00,2248,35.83,28,55,2220
22.04.2018 17:00,2268,36.09,37,60,2231
22.04.2018 18:00,2349,36.62,54,66,2295
22.04.2018 19:00,2443,36.82,77,74,2366
22.04.2018 20:00,2431,36.87,94,88,2337
22.04.2018 21:00,2497,36.96,125,124,2372
22.04.2018 22:00,2479,36.14,163,182,2316
22.04.2018 23:00,2295,34.48,246,262,2049
23.04.2018 00:00,2114,33.1,325,352,1789
23.04.2018 01:00,1961,30.25,426,448,1535
23.04.2018 02:00,1927,24.99,518,534,1409
23.04.2018 03:00,1952,24.93,593,601,1359
23.04.2018 04:00,2009,24.87,653,653,1356
23.04.2018 05:00,2114,24.95,708,695,1406
23.04.2018 06:00,2310,34.27,692,703,1618
23.04.2018 07:00,2643,37.21,666,673,1977
23.04.2018 08:00,3008,39.04,610,631,2398
23.04.2018 09:00,3289,41.38,568,598,2721
23.04.2018 10:00,3316,39.93,534,579,2782
23.04.2018 11:00,3357,38.99,528,608,2829
23.04.2018 12:00,3268,37.99,624,652,2644
23.04.2018 13:00,3142,36.99,625,700,2517
23.04.2018 14:00,3020,36.76,696,742,2324
23.04.2018 15:00,2915,36.37,715,767,2200
23.04.2018 16:00,2788,36.18,745,782,2043
23.04.2018 17:00,2724,35.99,795,805,1929
23.04.2018 18:00,2705,36.26,791,823,1914
23.04.2018 19:00,2688,37.28,819,838,1869
23.04.2018 20:00,2673,37.79,818,843,1855
23.04.2018 21:00,2662,37.44,814,855,1848
23.04.2018 22:00,2665,37,824,878,1841
23.04.2018 23:00,2527,35.99,861,906,1666
24.04.2018 00:00,2395,27.57,882,919,1513
24.04.2018 01:00,2270,28.05,846,842,1424
24.04.2018 02:00,2191,27.01,811,825,1380
24.04.2018 03:00,2219,27.01,760,787,1459
24.04.2018 04:00,2340,24.12,712,738,1628
24.04.2018 05:00,2361,23.4,670,690,1691
24.04.2018 06:00,2424,30.1,648,672,1776
24.04.2018 07:00,2733,36.37,653,678,2080
24.04.2018 08:00,3079,38.08,663,697,2416
24.04.2018 09:00,3300,38.34,656,719,2644
24.04.2018 10:00,3304,37.55,734,733,2570
24.04.2018 11:00,3303,36.91,774,772,2529
24.04.2018 12:00,3170,36.74,885,843,2285
24.04.2018 13:00,3063,36.49,970,929,2093
24.04.2018 14:00,3048,36.23,1051,1013,1997
24.04.2018 15:00,2950,35.58,1118,1088,1832
24.04.2018 16:00,2904,35.38,1162,1132,1742
24.04.2018 17:00,2869,35.84,1188,1151,1681
24.04.2018 18:00,2932,36.37,1255,1157,1677
24.04.2018 19:00,2846,36.63,1239,1160,1607
24.04.2018 20:00,2819,37.02,1224,1145,1595
24.04.2018 21:00,2818,36.88,1190,1118,1628
24.04.2018 22:00,2890,36.53,1131,1088,1759
24.04.2018 23:00,2765,36.11,1057,1055,1708
25.04.2018 00:00,2497,26.77,1020,1014,1477
25.04.2018 01:00,2364,35.46,980,997,1384
25.04.2018 02:00,2326,34.14,921,908,1405
25.04.2018 03:00,2362,32.69,791,790,1571
25.04.2018 04:00,2476,32.34,666,664,1810
25.04.2018 05:00,2516,32.43,555,549,1961
25.04.2018 06:00,2637,34.99,454,466,2183
25.04.2018 07:00,2951,37.7,394,412,2557
25.04.2018 08:00,3278,39.78,323,376,2955
25.04.2018 09:00,3396,40.91,278,337,3118
25.04.2018 10:00,3441,40.04,243,294,3198
25.04.2018 11:00,3410,39.65,225,264,3185
25.04.2018 12:00,3375,39.14,217,258,3158
25.04.2018 13:00,3332,38.12,232,281,3100
25.04.2018 14:00,3261,37.76,264,326,2997
25.04.2018 15:00,3151,37.36,306,381,2845
25.04.2018 16:00,3043,36.92,365,449,2678
25.04.2018 17:00,2890,36.7,481,520,2409
25.04.2018 18:00,2848,36.84,512,545,2336
25.04.2018 19:00,2782,37.07,550,540,2232
25.04.2018 20:00,2808,38.22,549,517,2259
25.04.2018 21:00,2751,38.62,532,499,2219
25.04.2018 22:00,2661,37.83,503,494,2158
25.04.2018 23:00,2409,36.47,505,497,1904
26.04.2018 00:00,2342,33.33,489,503,1853
26.04.2018 01:00,2411,34.24,637,620,1774
26.04.2018 02:00,2345,30.08,637,601,1708
26.04.2018 03:00,2241,30.48,587,582,1654
26.04.2018 04:00,2287,32.38,576,560,1711
26.04.2018 05:00,2415,32.62,528,541,1887
26.04.2018 06:00,2559,34.5,508,526,2051
26.04.2018 07:00,2906,37.03,507,510,2399
26.04.2018 08:00,3240,39.77,476,497,2764
26.04.2018 09:00,3261,43.25,460,484,2801
26.04.2018 10:00,3204,39.06,442,468,2762
26.04.2018 11:00,3150,38.34,432,468,2718
26.04.2018 12:00,3166,38.05,422,474,2744
26.04.2018 13:00,3109,37.63,431,477,2678
26.04.2018 14:00,3104,37.36,432,474,2672
26.04.2018 15:00,3068,37.07,459,494,2609
26.04.2018 16:00,3012,36.75,532,536,2480
26.04.2018 17:00,2961,36.49,546,576,2415
26.04.2018 18:00,3147,36.12,519,586,2628
26.04.2018 19:00,3154,36.72,501,568,2653
26.04.2018 20:00,2992,37.54,452,530,2540
26.04.2018 21:00,2854,37.93,503,517,2351
26.04.2018 22:00,2813,38.17,503,539,2310
26.04.2018 23:00,2658,37.49,545,575,2113
27.04.2018 00:00,2461,35.74,590,601,1871
27.04.2018 01:00,2365,35.05,596,612,1769
27.04.2018 02:00,2322,33.07,599,616,1723
27.04.2018 03:00,2221,32.43,589,595,1632
27.04.2018 04:00,2205,33.4,574,562,1631
27.04.2018 05:00,2265,33.99,538,530,1727
27.04.2018 06:00,2405,35.55,525,519,1880
27.04.2018 07:00,2745,37.88,523,523,2222
27.04.2018 08:00,3123,39.94,529,540,2594
27.04.2018 09:00,3239,41.38,545,552,2694
27.04.2018 10:00,3206,41.04,547,554,2659
27.04.2018 11:00,3120,40.14,529,558,2591
27.04.2018 12:00,3042,38.89,528,578,2514
27.04.2018 13:00,3017,37.66,545,610,2472
27.04.2018 14:00,2895,36.48,556,635,2339
27.04.2018 15:00,2753,36.2,550,612,2203
27.04.2018 16:00,2691,36.27,510,561,2181
27.04.2018 17:00,2718,36.72,488,504,2230
27.04.2018 18:00,2744,37.4,391,423,2353
27.04.2018 19:00,2740,37.76,318,342,2422
27.04.2018 20:00,2684,37.81,268,274,2416
27.04.2018 21:00,2647,37.84,226,237,2421
27.04.2018 22:00,2650,37.94,208,224,2442
27.04.2018 23:00,2517,37.6,218,222,2299
28.04.2018 00:00,2406,36,211,225,2195
28.04.2018 01:00,2207,35.92,198,194,2009
28.04.2018 02:00,2105,34.32,172,172,1933
28.04.2018 03:00,2079,33.29,154,150,1925
28.04.2018 04:00,2082,33.17,137,135,1945
28.04.2018 05:00,2060,32.72,119,126,1941
28.04.2018 06:00,2087,32.55,108,104,1979
28.04.2018 07:00,2173,34.84,92,78,2081
28.04.2018 08:00,2343,36.02,56,59,2287
28.04.2018 09:00,2481,36.56,42,51,2439
28.04.2018 10:00,2566,37.18,37,49,2529
28.04.2018 11:00,2563,37.02,36,50,2527
28.04.2018 12:00,2546,36.74,36,56,2510
28.04.2018 13:00,2502,35.98,39,66,2463
28.04.2018 14:00,2439,35.52,41,78,2398
28.04.2018 15:00,2354,34.98,49,81,2305
28.04.2018 16:00,2301,34.76,69,79,2232
28.04.2018 17:00,2320,34.96,82,82,2238
28.04.2018 18:00,2383,36.23,84,79,2299
28.04.2018 19:00,2409,37.06,82,72,2327
28.04.2018 20:00,2382,42.17,93,68,2289
28.04.2018 21:00,2353,42.01,99,75,2254
28.04.2018 22:00,2362,37.93,89,83,2273
28.04.2018 23:00,2257,36.96,83,86,2174
29.04.2018 00:00,2111,35.96,79,80,2032
29.04.2018 01:00,2089,35.98,118,117,1971
29.04.2018 02:00,2073,34.87,122,111,1951
29.04.2018 03:00,2065,34.58,110,101,1955
29.04.2018 04:00,2041,34.01,97,91,1944
29.04.2018 05:00,2014,33.95,77,85,1937
29.04.2018 06:00,2000,33.6,70,72,1930
29.04.2018 07:00,2009,34.47,61,61,1948
29.04.2018 08:00,2101,34.82,53,53,2048
29.04.2018 09:00,2264,35.61,50,46,2214
29.04.2018 10:00,2351,35.97,40,48,2311
29.04.2018 11:00,2356,36.03,43,56,2313
29.04.2018 12:00,2360,35.97,49,65,2311
29.04.2018 13:00,2380,35.64,57,76,2323
29.04.2018 14:00,2367,35.32,63,85,2304
29.04.2018 15:00,2317,34.99,66,86,2251
29.04.2018 16:00,2281,34.45,62,80,2219
29.04.2018 17:00,2256,34.62,59,76,2197
29.04.2018 18:00,2326,35.23,66,69,2260
29.04.2018 19:00,2377,35.6,62,65,2315
29.04.2018 20:00,2389,35.33,72,69,2317
29.04.2018 21:00,2381,35.31,87,79,2294
29.04.2018 22:00,2387,35.74,92,95,2295
29.04.2018 23:00,2267,35.3,116,120,2151
30.04.2018 00:00,2075,33.39,147,145,1928
30.04.2018 01:00,1937,31.93,213,230,1724
30.04.2018 02:00,1814,30.36,287,298,1527
30.04.2018 03:00,1829,25.09,398,377,1431
30.04.2018 04:00,1941,21.21,442,462,1499
30.04.2018 05:00,2149,23.92,512,547,1637
30.04.2018 06:00,2273,31.01,577,621,1696
30.04.2018 07:00,2517,33.92,633,689,1884
30.04.2018 08:00,2720,34.46,687,754,2033
30.04.2018 09:00,2787,35.64,794,841,1993
30.04.2018 10:00,2733,35.01,899,936,1834
30.04.2018 11:00,2744,34.71,985,1022,1759
30.04.2018 12:00,2750,34.1,1057,1095,1693
30.04.2018 13:00,2631,33.95,1124,1157,1507
30.04.2018 14:00,2618,33.43,1188,1212,1430
30.04.2018 15:00,2572,32.97,1233,1238,1339
30.04.2018 16:00,2568,30.21,1247,1243,1321
30.04.2018 17:00,2518,30.09,1243,1212,1275
30.04.2018 18:00,2568,30.99,1204,1152,1364
30.04.2018 19:00,2541,30.99,1107,1053,1434
30.04.2018 20:00,2655,33.81,940,944,1715
30.04.2018 21:00,2679,34.43,782,792,1897
30.04.2018 22:00,2570,33.49,605,608,1965
30.04.2018 23:00,2470,33.09,449,439,2021
05.01.2018 00:00,1956,30.78,323,320,1633
05.01.2018 01:00,2284,18.91,259,253,2025
05.01.2018 02:00,2193,10.99,233,220,1960
05.01.2018 03:00,2131,8.42,230,237,1901
05.01.2018 04:00,2119,5.88,264,275,1855
05.01.2018 05:00,2098,4.5,298,315,1800
05.01.2018 06:00,2090,4.07,322,345,1768
05.01.2018 07:00,2128,4.91,364,362,1764
05.01.2018 08:00,2149,14.98,418,409,1731
05.01.2018 09:00,2268,24.34,473,490,1795
05.01.2018 10:00,2378,28.99,587,600,1791
05.01.2018 11:00,2395,31.03,684,714,1711
05.01.2018 12:00,2484,28.67,793,817,1691
05.01.2018 13:00,2516,25.48,892,912,1624
05.01.2018 14:00,2564,21.93,990,991,1574
05.01.2018 15:00,2527,21.91,1050,1043,1477
05.01.2018 16:00,2517,23.94,1063,1076,1454
05.01.2018 17:00,2626,26.24,1090,1088,1536
05.01.2018 18:00,2725,30.32,1086,1081,1639
05.01.2018 19:00,2735,31.01,1080,1074,1655
05.01.2018 20:00,2718,29.37,1044,1061,1674
05.01.2018 21:00,2674,28.85,1016,1036,1658
05.01.2018 22:00,2672,30.98,983,1015,1689
05.01.2018 23:00,2560,32.02,951,994,1609
05.02.2018 00:00,2384,27.93,954,972,1430
05.02.2018 01:00,2274,25.06,874,862,1400
05.02.2018 02:00,2303,21.26,824,813,1479
05.02.2018 03:00,2300,28.18,748,761,1552
05.02.2018 04:00,2307,27.68,693,703,1614
05.02.2018 05:00,2289,30.23,646,644,1643
05.02.2018 06:00,2333,36.03,565,568,1768
05.02.2018 07:00,2719,37.92,484,486,2235
05.02.2018 08:00,3089,39.81,405,411,2684
05.02.2018 09:00,3157,40.5,337,348,2820
05.02.2018 10:00,3108,40.25,277,306,2831
05.02.2018 11:00,3030,39.95,266,283,2764
05.02.2018 12:00,2943,39.02,258,285,2685
05.02.2018 13:00,2897,38.1,265,298,2632
05.02.2018 14:00,2850,37.62,265,305,2585
05.02.2018 15:00,2790,37.55,243,289,2547
05.02.2018 16:00,2776,37.54,238,266,2538
05.02.2018 17:00,2673,37.69,228,243,2445
05.02.2018 18:00,2665,37.99,209,233,2456
05.02.2018 19:00,2681,38.07,192,226,2489
05.02.2018 20:00,2713,38.09,190,233,2523
05.02.2018 21:00,2725,38.1,214,253,2511
05.02.2018 22:00,2755,38.05,246,275,2509
05.02.2018 23:00,2605,37.59,276,291,2329
05.03.2018 00:00,2372,36.03,293,298,2079
05.03.2018 01:00,2233,34.23,348,375,1885
05.03.2018 02:00,2166,32.12,340,375,1826
05.03.2018 03:00,2151,31.16,350,382,1801
05.03.2018 04:00,2141,30.53,356,398,1785
05.03.2018 05:00,2153,32.22,376,417,1777
05.03.2018 06:00,2265,35.13,393,421,1872
05.03.2018 07:00,2625,37.64,378,409,2247
05.03.2018 08:00,2989,38.73,354,386,2635
05.03.2018 09:00,3065,39.37,311,345,2754
05.03.2018 10:00,3125,38.9,270,298,2855
05.03.2018 11:00,3098,38.73,217,259,2881
05.03.2018 12:00,2933,38.48,185,229,2748
05.03.2018 13:00,2735,37.95,280,214,2455
05.03.2018 14:00,2687,37.37,296,239,2391
05.03.2018 15:00,2581,37.09,377,300,2204
05.03.2018 16:00,2595,36.46,422,386,2173
05.03.2018 17:00,2497,36.49,481,490,2016
05.03.2018 18:00,2541,37.49,498,536,2043
05.03.2018 19:00,2580,37.92,480,521,2100
05.03.2018 20:00,2642,37.94,440,493,2202
05.03.2018 21:00,2722,37.6,443,484,2279
05.03.2018 22:00,2760,37.36,434,499,2326
05.03.2018 23:00,2594,37.28,426,517,2168
05.04.2018 00:00,2362,35,432,529,1930
05.04.2018 01:00,2162,30,341,341,1821
05.04.2018 02:00,2133,26.07,324,324,1809
05.04.2018 03:00,2111,26.02,312,307,1799
05.04.2018 04:00,2148,28.54,297,287,1851
05.04.2018 05:00,2204,30.08,277,270,1927
05.04.2018 06:00,2300,36.12,238,240,2062
05.04.2018 07:00,2602,38,193,194,2409
05.04.2018 08:00,2875,46.61,147,149,2728
05.04.2018 09:00,2959,52.93,117,125,2842
05.04.2018 10:00,2896,55.47,110,122,2786
05.04.2018 11:00,2830,55.47,118,127,2712
05.04.2018 12:00,2808,56.55,119,133,2689
05.04.2018 13:00,2755,38.41,114,137,2641
05.04.2018 14:00,2715,37.87,112,142,2603
05.04.2018 15:00,2626,37.1,117,148,2509
05.04.2018 16:00,2502,36.28,119,151,2383
05.04.2018 17:00,2420,36.91,122,145,2298
05.04.2018 18:00,2443,37.73,110,128,2333
05.04.2018 19:00,2403,37.89,100,114,2303
05.04.2018 20:00,2408,37.86,100,114,2308
05.04.2018 21:00,2379,37.36,113,120,2266
05.04.2018 22:00,2398,37.19,132,134,2266
05.04.2018 23:00,2329,36.81,153,157,2176
05.05.2018 00:00,2175,33.96,164,170,2011
05.05.2018 01:00,2067,33.53,175,174,1892
05.05.2018 02:00,1935,30.07,172,170,1763
05.05.2018 03:00,1931,28.03,165,167,1766
05.05.2018 04:00,1997,25.98,156,156,1841
05.05.2018 05:00,2057,25.52,147,151,1910
05.05.2018 06:00,2025,27.02,123,131,1902
05.05.2018 07:00,2059,30.74,88,99,1971
05.05.2018 08:00,2171,34.9,62,73,2109
05.05.2018 09:00,2305,35.51,56,69,2249
05.05.2018 10:00,2398,35.65,56,77,2342
05.05.2018 11:00,2398,35.46,57,87,2341
05.05.2018 12:00,2333,34.97,71,102,2262
05.05.2018 13:00,2245,33.05,86,121,2159
05.05.2018 14:00,2200,31.81,104,144,2096
05.05.2018 15:00,2101,31.38,111,159,1990
05.05.2018 16:00,2064,31.1,126,165,1938
05.05.2018 17:00,2087,31.99,128,159,1959
05.05.2018 18:00,2144,32.99,120,141,2024
05.05.2018 19:00,2186,34.94,115,128,2071
05.05.2018 20:00,2187,35.05,124,131,2063
05.05.2018 21:00,2160,34.91,146,151,2014
05.05.2018 22:00,2198,34.08,176,177,2022
05.05.2018 23:00,2136,31.48,204,205,1932
05.06.2018 00:00,2387,20.8,203,209,2184
05.06.2018 01:00,1945,20.86,189,193,1756
05.06.2018 02:00,1894,21.64,173,172,1721
05.06.2018 03:00,1924,15.02,158,155,1766
05.06.2018 04:00,1936,5.06,147,144,1789
05.06.2018 05:00,1912,4.36,137,136,1775
05.06.2018 06:00,1879,4.22,118,115,1761
05.06.2018 07:00,1905,4.75,89,87,1816
05.06.2018 08:00,2008,14.99,63,66,1945
05.06.2018 09:00,2129,21.1,46,57,2083
05.06.2018 10:00,2216,26.68,46,63,2170
05.06.2018 11:00,2241,25.98,57,81,2184
05.06.2018 12:00,2238,21.3,69,101,2169
05.06.2018 13:00,2192,20.85,85,123,2107
05.06.2018 14:00,2141,18.26,97,143,2044
05.06.2018 15:00,2072,15.6,111,154,1961
05.06.2018 16:00,2042,14.16,117,152,1925
05.06.2018 17:00,2067,20.83,123,144,1944
05.06.2018 18:00,2122,25.09,110,129,2012
05.06.2018 19:00,2187,30.42,98,116,2089
05.06.2018 20:00,2228,33.06,97,116,2131
05.06.2018 21:00,2241,33.53,113,131,2128
05.06.2018 22:00,2256,33.45,133,147,2123
05.06.2018 23:00,2131,30.46,154,162,1977
05.07.2018 00:00,1996,20.88,160,164,1836
05.07.2018 01:00,1890,4.76,153,155,1737
05.07.2018 02:00,1903,4.55,144,157,1759
05.07.2018 03:00,1946,4.76,141,153,1805
05.07.2018 04:00,1964,4.42,139,156,1825
05.07.2018 05:00,2060,4.06,143,162,1917
05.07.2018 06:00,2141,26.45,134,150,2007
05.07.2018 07:00,2435,34.2,113,127,2322
05.07.2018 08:00,2707,36.71,88,102,2619
05.07.2018 09:00,2763,37.43,63,83,2700
05.07.2018 10:00,2739,37.15,48,78,2691
05.07.2018 11:00,2763,36.74,45,84,2718
05.07.2018 12:00,2758,33.87,51,94,2707
05.07.2018 13:00,2726,33.22,58,110,2668
05.07.2018 14:00,2731,32.73,72,127,2659
05.07.2018 15:00,2688,28.46,82,140,2606
05.07.2018 16:00,2666,20.89,97,147,2569
05.07.2018 17:00,2572,19.01,107,146,2465
05.07.2018 18:00,2530,31.06,87,136,2443
05.07.2018 19:00,2469,33.6,80,119,2389
05.07.2018 20:00,2460,34.01,87,112,2373
05.07.2018 21:00,2384,32.2,89,116,2295
05.07.2018 22:00,2397,32.37,98,122,2299
05.07.2018 23:00,2256,14.95,99,132,2157
05.08.2018 00:00,2073,4.26,97,129,1976
05.08.2018 01:00,1932,4.11,72,74,1860
05.08.2018 02:00,1895,6.93,69,69,1826
05.08.2018 03:00,1899,6.71,69,65,1830
05.08.2018 04:00,1914,8.65,68,61,1846
05.08.2018 05:00,1955,4.96,65,60,1890
05.08.2018 06:00,2034,26.3,60,56,1974
05.08.2018 07:00,2330,33.18,57,54,2273
05.08.2018 08:00,2616,36.44,53,55,2563
05.08.2018 09:00,2753,36.69,54,60,2699
05.08.2018 10:00,2743,35.62,58,69,2685
05.08.2018 11:00,2743,34.83,66,86,2677
05.08.2018 12:00,2761,34.13,81,112,2680
05.08.2018 13:00,2731,32.49,117,139,2614
05.08.2018 14:00,2663,29.25,149,167,2514
05.08.2018 15:00,2609,20.83,158,182,2451
05.08.2018 16:00,2570,20.71,168,187,2402
05.08.2018 17:00,2507,22.16,153,192,2354
05.08.2018 18:00,2493,27.13,171,197,2322
05.08.2018 19:00,2400,32.91,184,204,2216
05.08.2018 20:00,2387,31.97,213,224,2174
05.08.2018 21:00,2402,32.85,261,272,2141
05.08.2018 22:00,2388,33.13,319,335,2069
05.08.2018 23:00,2250,24.1,390,405,1860
05.09.2018 00:00,2029,4,448,448,1581
05.09.2018 01:00,1900,1.77,494,494,1406
05.09.2018 02:00,1844,1.59,530,524,1314
05.09.2018 03:00,1813,1.65,535,528,1278
05.09.2018 04:00,1817,1.75,525,516,1292
05.09.2018 05:00,1885,1.93,506,498,1379
05.09.2018 06:00,1967,3.63,467,459,1500
05.09.2018 07:00,2320,9.5,402,401,1918
05.09.2018 08:00,2746,33.54,328,339,2418
05.09.2018 09:00,2927,35.34,286,307,2641
05.09.2018 10:00,2927,34.53,266,312,2661
05.09.2018 11:00,2918,33.76,285,343,2633
05.09.2018 12:00,2792,32.63,345,402,2447
05.09.2018 13:00,2676,32.15,422,466,2254
05.09.2018 14:00,2683,28.89,501,521,2182
05.09.2018 15:00,2573,27.1,521,548,2052
05.09.2018 16:00,2524,23.77,544,554,1980
05.09.2018 17:00,2482,9.87,548,559,1934
05.09.2018 18:00,2468,10.07,541,562,1927
05.09.2018 19:00,2424,9.31,556,572,1868
05.09.2018 20:00,2466,10.28,551,587,1915
05.09.2018 21:00,2433,10.75,576,611,1857
05.09.2018 22:00,2392,22.4,616,646,1776
05.09.2018 23:00,2270,7.19,643,681,1627
05.10.2018 00:00,2083,3.75,666,683,1417
05.10.2018 01:00,1936,2.89,636,625,1300
05.10.2018 02:00,1811,2.24,596,605,1215
05.10.2018 03:00,1822,2.34,584,586,1238
05.10.2018 04:00,1847,2.42,566,572,1281
05.10.2018 05:00,1856,2.2,540,556,1316
05.10.2018 06:00,1828,2.99,493,513,1335
05.10.2018 07:00,1947,4.19,430,448,1517
05.10.2018 08:00,2175,15.09,377,387,1798
05.10.2018 09:00,2371,26.4,322,361,2049
05.10.2018 10:00,2450,26.93,327,367,2123
05.10.2018 11:00,2418,25.71,347,381,2071
05.10.2018 12:00,2348,26.19,363,409,1985
05.10.2018 13:00,2272,23.05,408,447,1864
05.10.2018 14:00,2270,20.88,479,497,1791
05.10.2018 15:00,2192,16.92,514,527,1678
05.10.2018 16:00,2215,16.98,503,539,1712
05.10.2018 17:00,2187,19.24,522,549,1665
05.10.2018 18:00,2224,22,507,537,1717
05.10.2018 19:00,2269,27.54,478,510,1791
05.10.2018 20:00,2349,25.08,458,479,1891
05.10.2018 21:00,2344,18.96,438,446,1906
05.10.2018 22:00,2258,16.84,445,420,1813
05.10.2018 23:00,2112,6.72,400,390,1712
05.11.2018 00:00,2026,4.08,329,349,1697
05.11.2018 01:00,1956,3.08,255,264,1701
05.11.2018 02:00,1859,2.69,232,223,1627
05.11.2018 03:00,1811,2.98,197,193,1614
05.11.2018 04:00,1792,3.17,187,170,1605
05.11.2018 05:00,1809,3.62,170,152,1639
05.11.2018 06:00,1799,17.26,163,128,1636
05.11.2018 07:00,1998,31.97,118,108,1880
05.11.2018 08:00,2250,37.57,104,96,2146
05.11.2018 09:00,2366,39.91,89,89,2277
05.11.2018 10:00,2512,40.95,91,89,2421
05.11.2018 11:00,2590,41.33,87,95,2503
05.11.2018 12:00,2602,40.48,81,105,2521
05.11.2018 13:00,2618,39.29,120,116,2498
05.11.2018 14:00,2616,38.07,131,130,2485
05.11.2018 15:00,2552,37.44,120,141,2432
05.11.2018 16:00,2506,37.13,140,148,2366
05.11.2018 17:00,2434,37.01,130,152,2304
05.11.2018 18:00,2425,35.83,114,135,2311
05.11.2018 19:00,2414,33.55,99,110,2315
05.11.2018 20:00,2346,33.03,85,94,2261
05.11.2018 21:00,2277,31.64,76,87,2201
05.11.2018 22:00,2277,32.41,71,89,2206
05.11.2018 23:00,2217,31.54,86,92,2131
05.12.2018 00:00,2049,30.05,94,93,1955
05.12.2018 01:00,1882,31.84,85,93,1797
05.12.2018 02:00,1830,30.02,96,99,1734
05.12.2018 03:00,1816,28.28,93,101,1723
05.12.2018 04:00,1814,28.25,89,94,1725
05.12.2018 05:00,1787,28.04,79,84,1708
05.12.2018 06:00,1719,27.99,59,65,1660
05.12.2018 07:00,1807,29.06,42,49,1765
05.12.2018 08:00,1949,32.04,26,38,1923
05.12.2018 09:00,2089,32.99,27,40,2062
05.12.2018 10:00,2225,36.71,20,47,2205
05.12.2018 11:00,2270,33.46,23,58,2247
05.12.2018 12:00,2292,32.41,31,68,2261
05.12.2018 13:00,2279,30.31,39,76,2240
05.12.2018 14:00,2261,30.01,47,83,2214
05.12.2018 15:00,2203,28.43,52,89,2151
05.12.2018 16:00,2163,28.07,61,96,2102
05.12.2018 17:00,2153,27.69,77,105,2076
05.12.2018 18:00,2184,31.38,78,100,2106
05.12.2018 19:00,2232,34.46,80,93,2152
05.12.2018 20:00,2195,33.2,77,89,2118
05.12.2018 21:00,2152,32.98,78,88,2074
05.12.2018 22:00,2149,33.18,83,89,2066
05.12.2018 23:00,2057,32.33,88,92,1969
13.05.2018 00:00,1897,19.5,92,89,1805
13.05.2018 01:00,1869,26.68,139,137,1730
13.05.2018 02:00,1809,20.89,146,149,1663
13.05.2018 03:00,1784,17.06,154,166,1630
13.05.2018 04:00,1801,14.92,168,189,1633
13.05.2018 05:00,1756,14.88,190,214,1566
13.05.2018 06:00,1658,13.77,201,220,1457
13.05.2018 07:00,1667,14.03,197,212,1470
13.05.2018 08:00,1819,15.37,187,206,1632
13.05.2018 09:00,2036,17.74,193,218,1843
13.05.2018 10:00,2202,24.9,220,251,1982
13.05.2018 11:00,2243,28.14,254,295,1989
13.05.2018 12:00,2226,22.8,289,341,1937
13.05.2018 13:00,2182,18.4,324,382,1858
13.05.2018 14:00,2165,13.51,371,416,1794
13.05.2018 15:00,2097,10.18,398,432,1699
13.05.2018 16:00,2077,9.89,404,435,1673
13.05.2018 17:00,2065,11.02,410,435,1655
13.05.2018 18:00,2096,17.33,416,434,1680
13.05.2018 19:00,2083,23.49,424,432,1659
13.05.2018 20:00,2142,26.97,422,437,1720
13.05.2018 21:00,2206,25.13,452,464,1754
13.05.2018 22:00,2207,24.07,507,510,1700
13.05.2018 23:00,2125,24.05,548,554,1577
14.05.2018 00:00,1881,19.42,558,569,1323
14.05.2018 01:00,1755,19.78,535,550,1220
14.05.2018 02:00,1759,16.28,532,549,1227
14.05.2018 03:00,1745,14.13,535,556,1210
14.05.2018 04:00,1822,14.87,542,568,1280
14.05.2018 05:00,1906,15.62,550,571,1356
14.05.2018 06:00,1924,26.26,508,528,1416
14.05.2018 07:00,2313,37.31,441,462,1872
14.05.2018 08:00,2665,54.06,327,370,2338
14.05.2018 09:00,2864,58.01,263,317,2601
14.05.2018 10:00,2893,55.83,215,289,2678
14.05.2018 11:00,2862,50.79,199,278,2663
14.05.2018 12:00,2821,42.43,196,279,2625
14.05.2018 13:00,2742,40.97,205,282,2537
14.05.2018 14:00,2748,40.07,205,280,2543
14.05.2018 15:00,2718,39.85,192,263,2526
14.05.2018 16:00,2764,37.84,177,241,2587
14.05.2018 17:00,2691,37.42,160,220,2531
14.05.2018 18:00,2681,36.74,143,205,2538
14.05.2018 19:00,2598,41.01,125,157,2473
14.05.2018 20:00,2592,43.1,128,154,2464
14.05.2018 21:00,2506,40.87,137,159,2369
14.05.2018 22:00,2460,40.71,138,166,2322
14.05.2018 23:00,2345,37.3,162,171,2183
15.05.2018 00:00,2142,32.25,177,172,1965
15.05.2018 01:00,2005,32.36,130,122,1875
15.05.2018 02:00,1944,30.24,126,119,1818
15.05.2018 03:00,1938,28.85,127,116,1811
15.05.2018 04:00,1919,28.02,136,127,1783
15.05.2018 05:00,1934,30.01,143,146,1791
15.05.2018 06:00,2031,32.58,147,149,1884
15.05.2018 07:00,2344,41.01,144,142,2200
15.05.2018 08:00,2690,76.04,120,125,2570
15.05.2018 09:00,2820,94.81,103,118,2717
15.05.2018 10:00,2818,93.51,105,130,2713
15.05.2018 11:00,2851,86.46,122,163,2729
15.05.2018 12:00,2802,85.66,140,190,2662
15.05.2018 13:00,2673,58.29,173,214,2500
15.05.2018 14:00,2704,50.3,190,229,2514
15.05.2018 15:00,2669,47.32,186,216,2483
15.05.2018 16:00,2668,40.5,204,193,2464
15.05.2018 17:00,2635,39.91,213,171,2422
15.05.2018 18:00,2654,41.07,157,156,2497
15.05.2018 19:00,2576,47.9,141,145,2435
15.05.2018 20:00,2528,50,146,144,2382
15.05.2018 21:00,2492,49.96,144,146,2348
15.05.2018 22:00,2463,47.08,141,150,2322
15.05.2018 23:00,2387,46.08,144,157,2243
16.05.2018 00:00,2185,32.35,142,161,2043
16.05.2018 01:00,2011,33.81,99,102,1912
16.05.2018 02:00,1899,32.35,104,108,1795
16.05.2018 03:00,1844,31.93,105,111,1739
16.05.2018 04:00,1833,31.22,111,117,1722
16.05.2018 05:00,1790,31.03,116,127,1674
16.05.2018 06:00,1855,34.06,114,119,1741
16.05.2018 07:00,2148,45.95,93,97,2055
16.05.2018 08:00,2491,103.25,66,74,2425
16.05.2018 09:00,2676,117.05,47,56,2629
16.05.2018 10:00,2683,177.22,37,51,2646
16.05.2018 11:00,2708,170.99,34,55,2674
16.05.2018 12:00,2720,151.81,35,60,2685
16.05.2018 13:00,2651,137.84,40,68,2611
16.05.2018 14:00,2619,137.48,45,74,2574
16.05.2018 15:00,2578,110.96,60,77,2518
16.05.2018 16:00,2522,38.09,93,81,2429
16.05.2018 17:00,2436,36.01,114,88,2322
16.05.2018 18:00,2435,40.21,131,92,2304
16.05.2018 19:00,2409,40.36,142,101,2267
16.05.2018 20:00,2418,42.03,165,115,2253
16.05.2018 21:00,2346,42,203,131,2143
16.05.2018 22:00,2317,39.31,206,154,2111
16.05.2018 23:00,2233,32.89,238,178,1995
17.05.2018 00:00,1654,20.64,227,187,1427
17.05.2018 01:00,1893,19.93,175,159,1718
17.05.2018 02:00,1858,10.06,166,152,1692
17.05.2018 03:00,1829,5.17,152,143,1677
17.05.2018 04:00,1798,5.12,142,135,1656
17.05.2018 05:00,1817,4.89,156,147,1661
17.05.2018 06:00,1828,24.87,176,160,1652
17.05.2018 07:00,2171,36.19,172,167,1999
17.05.2018 08:00,2529,44.32,168,169,2361
17.05.2018 09:00,2635,79.96,148,167,2487
17.05.2018 10:00,2665,86.83,151,172,2514
17.05.2018 11:00,2697,91.93,157,182,2540
17.05.2018 12:00,2744,50.77,173,192,2571
17.05.2018 13:00,2692,39.94,198,205,2494
17.05.2018 14:00,2713,35.86,215,222,2498
17.05.2018 15:00,2653,34.57,200,234,2453
17.05.2018 16:00,2591,33.39,199,239,2392
17.05.2018 17:00,2427,32.89,207,243,2220
17.05.2018 18:00,2569,35.21,216,243,2353
17.05.2018 19:00,2580,36.11,238,227,2342
17.05.2018 20:00,2547,36.59,204,214,2343
17.05.2018 21:00,2539,35.7,199,216,2340
17.05.2018 22:00,2507,35.18,213,232,2294
17.05.2018 23:00,2371,34.33,241,259,2130
18.05.2018 00:00,2143,28.95,271,280,1872
18.05.2018 01:00,1986,19.98,288,299,1698
18.05.2018 02:00,1958,15.34,311,317,1647
18.05.2018 03:00,1906,6,331,330,1575
18.05.2018 04:00,1904,5.96,326,337,1578
18.05.2018 05:00,1916,4.77,329,344,1587
18.05.2018 06:00,1963,32.22,325,335,1638
18.05.2018 07:00,2314,35.1,309,318,2005
18.05.2018 08:00,2688,50.72,299,303,2389
18.05.2018 09:00,2709,48.82,275,285,2434
18.05.2018 10:00,2724,42.97,257,272,2467
18.05.2018 11:00,2771,41.8,252,262,2519
18.05.2018 12:00,2758,39.4,238,250,2520
18.05.2018 13:00,2691,38.05,225,235,2466
18.05.2018 14:00,2619,37.2,205,225,2414
18.05.2018 15:00,2579,36.49,189,209,2390
18.05.2018 16:00,2493,35.26,176,191,2317
18.05.2018 17:00,2439,36.44,174,183,2265
18.05.2018 18:00,2431,41.58,158,169,2273
18.05.2018 19:00,2391,38.1,143,150,2248
18.05.2018 20:00,2314,37.83,136,139,2178
18.05.2018 21:00,2253,36.62,141,140,2112
18.05.2018 22:00,2201,36.24,159,157,2042
18.05.2018 23:00,2079,35.15,178,184,1901
19.05.2018 00:00,1909,33.73,182,181,1727
19.05.2018 01:00,1836,37.23,169,149,1667
19.05.2018 02:00,1752,35.18,161,130,1591
19.05.2018 03:00,1680,34.14,144,119,1536
19.05.2018 04:00,1674,33.97,132,115,1542
19.05.2018 05:00,1677,33.79,126,116,1551
19.05.2018 06:00,1659,33.84,109,103,1550
19.05.2018 07:00,1726,34.87,84,82,1642
19.05.2018 08:00,1862,35.23,71,69,1791
19.05.2018 09:00,2027,36.89,71,69,1956
19.05.2018 10:00,2111,38.07,73,78,2038
19.05.2018 11:00,2162,37.64,74,85,2088
19.05.2018 12:00,2133,35.54,65,92,2068
19.05.2018 13:00,2114,34.48,69,101,2045
19.05.2018 14:00,2054,33.85,78,110,1976
19.05.2018 15:00,2003,32.6,86,118,1917
19.05.2018 16:00,1965,32.22,92,123,1873
19.05.2018 17:00,1982,32.25,108,129,1874
19.05.2018 18:00,2019,34.84,105,115,1914
19.05.2018 19:00,2033,37.41,102,96,1931
19.05.2018 20:00,2032,36.75,95,88,1937
19.05.2018 21:00,1993,35.76,90,86,1903
19.05.2018 22:00,1991,35.93,91,88,1900
19.05.2018 23:00,1967,35.66,97,96,1870
20.05.2018 00:00,1817,31.7,105,101,1712
20.05.2018 01:00,1718,32.51,109,97,1609
20.05.2018 02:00,1676,27.71,110,103,1566
20.05.2018 03:00,1633,22.7,102,97,1531
20.05.2018 04:00,1642,22.61,84,83,1558
20.05.2018 05:00,1630,18.01,68,68,1562
20.05.2018 06:00,1596,17.06,45,43,1551
20.05.2018 07:00,1631,22.7,31,24,1600
20.05.2018 08:00,1716,27.56,18,20,1698
20.05.2018 09:00,1844,31.65,12,22,1832
20.05.2018 10:00,1973,32.5,13,31,1960
20.05.2018 11:00,1999,32.94,17,43,1982
20.05.2018 12:00,2008,32.31,26,59,1982
20.05.2018 13:00,2026,30.71,40,76,1986
20.05.2018 14:00,2004,26.69,62,97,1942
20.05.2018 15:00,1961,22.89,74,109,1887
20.05.2018 16:00,1951,19.26,82,116,1869
20.05.2018 17:00,2010,20.77,107,118,1903
20.05.2018 18:00,2106,25.9,119,114,1987
20.05.2018 19:00,2117,29.66,122,113,1995
20.05.2018 20:00,2158,27.93,122,121,2036
20.05.2018 21:00,2147,25.23,129,131,2018
20.05.2018 22:00,2056,25.8,143,143,1913
20.05.2018 23:00,1995,21.59,161,159,1834
21.05.2018 00:00,1904,15.27,171,166,1733
21.05.2018 01:00,1764,3.91,166,163,1598
21.05.2018 02:00,1725,3.04,158,161,1567
21.05.2018 03:00,1751,2.97,150,152,1601
21.05.2018 04:00,1755,3.1,142,141,1613
21.05.2018 05:00,1786,3.18,129,131,1657
21.05.2018 06:00,1866,19.4,121,120,1745
21.05.2018 07:00,2195,32.94,108,109,2087
21.05.2018 08:00,2556,35.78,102,104,2454
21.05.2018 09:00,2669,35.13,96,112,2573
21.05.2018 10:00,2722,36.16,109,132,2613
21.05.2018 11:00,2757,38.05,128,159,2629
21.05.2018 12:00,2741,38.09,154,184,2587
21.05.2018 13:00,2668,36.99,179,208,2489
21.05.2018 14:00,2670,35.79,196,227,2474
21.05.2018 15:00,2638,35.39,214,232,2424
21.05.2018 16:00,2595,35.03,210,225,2385
21.05.2018 17:00,2420,33.92,233,218,2187
21.05.2018 18:00,2361,34.32,244,211,2117
21.05.2018 19:00,2356,34.61,256,208,2100
21.05.2018 20:00,2372,34.91,257,213,2115
21.05.2018 21:00,2384,33.75,231,220,2153
21.05.2018 22:00,2345,33.46,246,237,2099
21.05.2018 23:00,2208,33.38,266,256,1942
22.05.2018 00:00,2399,27.58,285,268,2114
22.05.2018 01:00,1840,32.08,323,306,1517
22.05.2018 02:00,1759,30.27,337,310,1422
22.05.2018 03:00,1707,30.05,338,303,1369
22.05.2018 04:00,1785,28.83,314,291,1471
22.05.2018 05:00,1805,31.55,279,276,1526
22.05.2018 06:00,1882,35.14,229,237,1653
22.05.2018 07:00,2224,40.18,190,185,2034
22.05.2018 08:00,2566,67.13,130,135,2436
22.05.2018 09:00,2678,84.02,96,107,2582
22.05.2018 10:00,2732,79.98,87,103,2645
22.05.2018 11:00,2742,85.01,86,108,2656
22.05.2018 12:00,2705,68.1,87,112,2618
22.05.2018 13:00,2682,67.06,82,109,2600
22.05.2018 14:00,2673,67.04,79,103,2594
22.05.2018 15:00,2636,66.59,65,90,2571
22.05.2018 16:00,2615,58.52,59,80,2556
22.05.2018 17:00,2525,58.51,58,74,2467
22.05.2018 18:00,2497,58.5,55,68,2442
22.05.2018 19:00,2480,54.77,59,62,2421
22.05.2018 20:00,2445,59.66,58,61,2387
22.05.2018 21:00,2374,39.59,61,63,2313
22.05.2018 22:00,2302,47.36,69,71,2233
22.05.2018 23:00,2198,41.94,81,82,2117
23.05.2018 00:00,1580,36.04,97,90,1483
23.05.2018 01:00,1879,37.91,114,109,1765
23.05.2018 02:00,1807,36.42,109,102,1698
23.05.2018 03:00,1785,36.04,101,92,1684
23.05.2018 04:00,1789,34.53,92,84,1697
23.05.2018 05:00,1791,35.24,93,84,1698
23.05.2018 06:00,1908,37.7,79,69,1829
23.05.2018 07:00,2217,40.61,59,51,2158
23.05.2018 08:00,2532,78.1,42,41,2490
23.05.2018 09:00,2684,101.25,31,38,2653
23.05.2018 10:00,2668,86.22,30,45,2638
23.05.2018 11:00,2806,81.84,37,57,2769
23.05.2018 12:00,2845,84.76,44,70,2801
23.05.2018 13:00,2470,84.94,63,85,2407
23.05.2018 14:00,2688,84.83,80,107,2608
23.05.2018 15:00,2637,65.25,87,125,2550
23.05.2018 16:00,2607,68.14,103,146,2504
23.05.2018 17:00,2536,64.23,121,175,2415
23.05.2018 18:00,2524,55.04,137,180,2387
23.05.2018 19:00,2507,42.87,148,167,2359
23.05.2018 20:00,2523,45.72,145,159,2378
23.05.2018 21:00,2511,44.12,159,170,2352
23.05.2018 22:00,2446,40.91,176,190,2270
23.05.2018 23:00,2405,40.06,198,217,2207
24.05.2018 00:00,2203,35.37,212,228,1991
24.05.2018 01:00,1946,37,117,115,1829
24.05.2018 02:00,1890,34.13,136,135,1754
24.05.2018 03:00,1871,33.01,153,158,1718
24.05.2018 04:00,1867,31.79,166,180,1701
24.05.2018 05:00,1810,32.34,179,198,1631
24.05.2018 06:00,1917,36.44,178,192,1739
24.05.2018 07:00,2211,40.46,158,168,2053
24.05.2018 08:00,2520,61.19,140,145,2380
24.05.2018 09:00,2665,75.98,125,133,2540
24.05.2018 10:00,2647,68.51,124,139,2523
24.05.2018 11:00,2688,69.58,138,157,2550
24.05.2018 12:00,2691,69.58,146,185,2545
24.05.2018 13:00,2667,65.08,192,222,2475
24.05.2018 14:00,2611,61.81,223,262,2388
24.05.2018 15:00,2541,58.39,222,284,2319
24.05.2018 16:00,2532,51.75,251,289,2281
24.05.2018 17:00,2458,41.64,257,282,2201
24.05.2018 18:00,2423,41.7,269,263,2154
24.05.2018 19:00,2343,42.69,267,237,2076
24.05.2018 20:00,2359,43.98,254,215,2105
24.05.2018 21:00,2353,43.74,239,197,2114
24.05.2018 22:00,2247,41.97,236,190,2011
24.05.2018 23:00,2147,39.86,245,190,1902
25.05.2018 00:00,1913,35.18,247,179,1666
25.05.2018 01:00,1860,35.97,250,231,1610
25.05.2018 02:00,1811,34.17,226,216,1585
25.05.2018 03:00,1790,33.4,214,207,1576
25.05.2018 04:00,1818,32.09,211,205,1607
25.05.2018 05:00,1809,33.01,213,209,1596
25.05.2018 06:00,1881,37.44,203,200,1678
25.05.2018 07:00,2269,41.85,173,176,2096
25.05.2018 08:00,2646,47.37,153,156,2493
25.05.2018 09:00,2713,48.01,142,157,2571
25.05.2018 10:00,2694,47.95,163,183,2531
25.05.2018 11:00,2726,47.41,176,216,2550
25.05.2018 12:00,2667,44.81,197,245,2470
25.05.2018 13:00,2520,43.19,222,263,2298
25.05.2018 14:00,2456,43.05,237,275,2219
25.05.2018 15:00,2419,41.72,247,277,2172
25.05.2018 16:00,2415,40.47,248,270,2167
25.05.2018 17:00,2426,40.5,267,267,2159
25.05.2018 18:00,2437,41.46,248,256,2189
25.05.2018 19:00,2407,42.17,236,237,2171
25.05.2018 20:00,2358,41.86,223,219,2135
25.05.2018 21:00,2290,40.94,217,213,2073
25.05.2018 22:00,2243,40.82,229,231,2014
25.05.2018 23:00,2189,40.31,253,259,1936
26.05.2018 00:00,1964,38.91,262,260,1702
26.05.2018 01:00,1866,40.14,299,311,1567
26.05.2018 02:00,1773,38.66,292,315,1481
26.05.2018 03:00,1711,36,304,323,1407
26.05.2018 04:00,1719,34.97,314,324,1405
26.05.2018 05:00,1662,34.27,313,320,1349
26.05.2018 06:00,1584,33.81,279,287,1305
26.05.2018 07:00,1671,37.33,235,239,1436
26.05.2018 08:00,1831,39.62,186,203,1645
26.05.2018 09:00,2035,41.63,168,189,1867
26.05.2018 10:00,2193,41.47,163,197,2030
26.05.2018 11:00,2286,40.61,217,217,2069
26.05.2018 12:00,2266,40.04,201,225,2065
26.05.2018 13:00,2117,39.07,194,219,1923
26.05.2018 14:00,2107,37.98,196,211,1911
26.05.2018 15:00,2036,37.1,205,204,1831
26.05.2018 16:00,2046,36.8,191,200,1855
26.05.2018 17:00,2099,36.94,175,190,1924
26.05.2018 18:00,2131,39.08,161,179,1970
26.05.2018 19:00,2158,41.72,147,172,2011
26.05.2018 20:00,2128,42.29,153,172,1975
26.05.2018 21:00,2145,42.22,163,178,1982
26.05.2018 22:00,2118,41.99,173,192,1945
26.05.2018 23:00,2093,41.82,196,218,1897
27.05.2018 00:00,1574,39.12,214,244,1360
27.05.2018 01:00,1805,38.82,235,253,1570
27.05.2018 02:00,1707,36.3,264,273,1443
27.05.2018 03:00,1638,34.02,300,297,1338
27.05.2018 04:00,1628,33.06,340,322,1288
27.05.2018 05:00,1582,32.6,352,344,1230
27.05.2018 06:00,1563,32.01,353,352,1210
27.05.2018 07:00,1623,34.42,359,354,1264
27.05.2018 08:00,1719,36.52,360,360,1359
27.05.2018 09:00,1883,37.67,374,388,1509
27.05.2018 10:00,2040,38.86,412,432,1628
27.05.2018 11:00,2119,39.25,454,479,1665
27.05.2018 12:00,2178,38.98,493,520,1685
27.05.2018 13:00,2120,38.56,537,554,1583
27.05.2018 14:00,2077,37.94,583,588,1494
27.05.2018 15:00,2048,37.24,597,603,1451
27.05.2018 16:00,2019,37.63,602,606,1417
27.05.2018 17:00,2031,37.87,617,612,1414
27.05.2018 18:00,2068,38.91,610,611,1458
27.05.2018 19:00,2032,41.34,635,609,1397
27.05.2018 20:00,2120,42.3,638,603,1482
27.05.2018 21:00,2133,42.11,646,609,1487
27.05.2018 22:00,2103,41.98,629,629,1474
27.05.2018 23:00,2067,41.27,651,653,1416
28.05.2018 00:00,1903,37.69,668,662,1235
28.05.2018 01:00,1847,37.09,698,713,1149
28.05.2018 02:00,1786,33.66,690,701,1096
28.05.2018 03:00,1733,28.86,680,682,1053
28.05.2018 04:00,1714,28.24,649,653,1065
28.05.2018 05:00,1705,29.21,621,623,1084
28.05.2018 06:00,1786,37.45,547,554,1239
28.05.2018 07:00,2216,43.04,448,472,1768
28.05.2018 08:00,2648,49.29,386,395,2262
28.05.2018 09:00,2793,51.27,327,346,2466
28.05.2018 10:00,2830,50.91,303,321,2527
28.05.2018 11:00,2890,49.93,282,309,2608
28.05.2018 12:00,2884,48.3,269,312,2615
28.05.2018 13:00,2879,46.23,289,322,2590
28.05.2018 14:00,2875,47.01,293,335,2582
28.05.2018 15:00,2830,47.54,293,350,2537
28.05.2018 16:00,2781,48.81,341,363,2440
28.05.2018 17:00,2673,49.95,365,370,2308
28.05.2018 18:00,2632,52.01,375,364,2257
28.05.2018 19:00,2567,51.46,369,348,2198
28.05.2018 20:00,2521,53.34,381,336,2140
28.05.2018 21:00,2513,48.78,400,349,2113
28.05.2018 22:00,2440,45.35,412,381,2028
28.05.2018 23:00,2349,42.96,431,417,1918
29.05.2018 00:00,2097,38.76,436,433,1661
29.05.2018 01:00,1955,36.16,421,433,1534
29.05.2018 02:00,1885,34.08,411,429,1474
29.05.2018 03:00,1804,35.53,404,414,1400
29.05.2018 04:00,1803,35.22,399,402,1404
29.05.2018 05:00,1784,33.29,395,392,1389
29.05.2018 06:00,1848,38.55,353,360,1495
29.05.2018 07:00,2199,42.89,307,308,1892
29.05.2018 08:00,2634,52.26,253,261,2381
29.05.2018 09:00,2832,59.58,216,231,2616
29.05.2018 10:00,2887,53.1,209,224,2678
29.05.2018 11:00,2891,53.56,186,227,2705
29.05.2018 12:00,2921,46.99,191,243,2730
29.05.2018 13:00,2843,44.58,203,265,2640
29.05.2018 14:00,2820,43.96,227,286,2593
29.05.2018 15:00,2785,43.2,249,293,2536
29.05.2018 16:00,2735,42.67,262,289,2473
29.05.2018 17:00,2617,42.32,270,282,2347
29.05.2018 18:00,2611,43.64,270,273,2341
29.05.2018 19:00,2539,45.13,286,263,2253
29.05.2018 20:00,2539,46.1,265,258,2274
29.05.2018 21:00,2492,44,269,268,2223
29.05.2018 22:00,2441,43.35,282,295,2159
29.05.2018 23:00,2342,42.55,310,327,2032
30.05.2018 00:00,2415,38.17,349,350,2066
30.05.2018 01:00,1960,38.13,374,368,1586
30.05.2018 02:00,1868,36.22,400,402,1468
30.05.2018 03:00,1836,35,416,430,1420
30.05.2018 04:00,1823,33.4,422,445,1401
30.05.2018 05:00,1770,33.97,448,457,1322
30.05.2018 06:00,1846,39.06,432,433,1414
30.05.2018 07:00,2234,44.26,378,383,1856
30.05.2018 08:00,2646,51.94,317,337,2329
30.05.2018 09:00,2833,56.89,305,334,2528
30.05.2018 10:00,2848,53.15,348,365,2500
30.05.2018 11:00,2797,49.91,375,407,2422
30.05.2018 12:00,2749,47.97,427,437,2322
30.05.2018 13:00,2686,44.9,464,450,2222
30.05.2018 14:00,2688,44.91,456,449,2232
30.05.2018 15:00,2683,44.74,457,435,2226
30.05.2018 16:00,2692,44.98,415,422,2277
30.05.2018 17:00,2638,45.56,398,418,2240
30.05.2018 18:00,2610,48.73,416,413,2194
30.05.2018 19:00,2588,55.83,411,410,2177
30.05.2018 20:00,2556,58.21,415,412,2141
30.05.2018 21:00,2574,52.92,433,440,2141
30.05.2018 22:00,2506,49.48,448,484,2058
30.05.2018 23:00,2420,45.08,491,529,1929
31.05.2018 00:00,2740,42.43,507,552,2233
31.05.2018 01:00,2061,42.02,520,533,1541
31.05.2018 02:00,1954,39.66,540,553,1414
31.05.2018 03:00,1913,38.65,576,581,1337
31.05.2018 04:00,1896,38.15,623,611,1273
31.05.2018 05:00,1813,37.91,611,639,1202
31.05.2018 06:00,1854,39.31,641,633,1213
31.05.2018 07:00,2119,42.64,633,609,1486
31.05.2018 08:00,2495,48.78,586,583,1909
31.05.2018 09:00,2678,49.27,572,565,2106
31.05.2018 10:00,2716,45.81,557,554,2159
31.05.2018 11:00,2766,45.66,529,541,2237
31.05.2018 12:00,2802,45.45,516,528,2286
31.05.2018 13:00,2784,44.76,486,514,2298
31.05.2018 14:00,2751,44.82,446,504,2305
31.05.2018 15:00,2742,44.83,452,498,2290
31.05.2018 16:00,2717,44.12,475,498,2242
31.05.2018 17:00,2590,43.77,532,500,2058
31.05.2018 18:00,2503,44.48,478,498,2025
31.05.2018 19:00,2506,47.33,484,497,2022
31.05.2018 20:00,2508,49.6,475,495,2033
31.05.2018 21:00,2524,48.74,479,495,2045
31.05.2018 22:00,2443,45.76,472,503,1971
31.05.2018 23:00,2370,44.12,481,510,1889
06.01.2018 00:00,2134,41.28,470,497,1664
06.01.2018 01:00,1942,41.33,438,445,1504
06.01.2018 02:00,1830,38.89,406,420,1424
06.01.2018 03:00,1824,38.82,372,393,1452
06.01.2018 04:00,1813,38.45,349,369,1464
06.01.2018 05:00,1736,38.01,315,340,1421
06.01.2018 06:00,1844,41.18,268,281,1576
06.01.2018 07:00,2219,47.82,204,211,2015
06.01.2018 08:00,2593,62.04,143,156,2450
06.01.2018 09:00,2723,68.15,110,123,2613
06.01.2018 10:00,2722,76.06,76,107,2646
06.01.2018 11:00,2750,74.97,63,99,2687
06.01.2018 12:00,2747,75.07,64,97,2683
06.01.2018 13:00,2689,73.71,56,97,2633
06.01.2018 14:00,2627,70.05,54,97,2573
06.01.2018 15:00,2575,58.56,52,94,2523
06.01.2018 16:00,2505,53,48,91,2457
06.01.2018 17:00,2470,58,64,88,2406
06.01.2018 18:00,2425,67.68,67,85,2358
06.01.2018 19:00,2366,46.77,70,82,2296
06.01.2018 20:00,2291,53.94,73,86,2218
06.01.2018 21:00,2237,53.18,77,85,2160
06.01.2018 22:00,2160,45.68,82,86,2078
06.01.2018 23:00,2122,45.39,93,97,2029
06.02.2018 00:00,1587,43.95,99,103,1488
06.02.2018 01:00,1817,42.16,79,91,1738
06.02.2018 02:00,1739,40.42,74,85,1665
06.02.2018 03:00,1702,39.14,73,79,1629
06.02.2018 04:00,1695,38.5,67,74,1628
06.02.2018 05:00,1622,38.5,56,72,1566
06.02.2018 06:00,1621,38.78,47,56,1574
06.02.2018 07:00,1697,40.45,32,41,1665
06.02.2018 08:00,1879,42.17,25,34,1854
06.02.2018 09:00,2052,43.99,17,33,2035
06.02.2018 10:00,2177,45.71,15,37,2162
06.02.2018 11:00,2246,45.22,16,42,2230
06.02.2018 12:00,2269,45.06,19,47,2250
06.02.2018 13:00,2222,44,38,57,2184
06.02.2018 14:00,2115,43.9,44,73,2071
06.02.2018 15:00,2063,43.83,69,92,1994
06.02.2018 16:00,2073,43.15,95,115,1978
06.02.2018 17:00,2114,42.67,135,146,1979
06.02.2018 18:00,2160,43.43,143,157,2017
06.02.2018 19:00,2198,45.63,145,150,2053
06.02.2018 20:00,2117,49.83,151,144,1966
06.02.2018 21:00,2058,49.81,164,150,1894
06.02.2018 22:00,2007,49.69,170,163,1837
06.02.2018 23:00,1982,45.87,182,174,1800
06.03.2018 00:00,1479,42.27,180,177,1299
06.03.2018 01:00,1732,43.39,174,172,1558
06.03.2018 02:00,1665,41.59,155,156,1510
06.03.2018 03:00,1624,40.04,141,144,1483
06.03.2018 04:00,1615,39.33,137,138,1478
06.03.2018 05:00,1538,38.43,132,131,1406
06.03.2018 06:00,1507,39.25,114,108,1393
06.03.2018 07:00,1543,40.18,77,75,1466
06.03.2018 08:00,1707,41.39,55,56,1652
06.03.2018 09:00,1894,43.08,43,53,1851
06.03.2018 10:00,2068,43.57,48,65,2020
06.03.2018 11:00,2138,44.03,63,86,2075
06.03.2018 12:00,2142,43.89,86,114,2056
06.03.2018 13:00,2152,43.89,119,146,2033
06.03.2018 14:00,2099,43.46,157,184,1942
06.03.2018 15:00,2052,41.62,189,218,1863
06.03.2018 16:00,2038,40.97,220,253,1818
06.03.2018 17:00,2077,41.32,255,279,1822
06.03.2018 18:00,2115,42.58,273,285,1842
06.03.2018 19:00,2114,43.57,274,281,1840
06.03.2018 20:00,2166,44.5,280,278,1886
06.03.2018 21:00,2257,45.09,292,299,1965
06.03.2018 22:00,2247,45.27,326,346,1921
06.03.2018 23:00,2203,44.94,379,402,1824
06.04.2018 00:00,1996,40.66,444,446,1552
06.04.2018 01:00,1854,38.62,500,500,1354
06.04.2018 02:00,1863,36.13,534,547,1329
06.04.2018 03:00,1845,32.4,564,570,1281
06.04.2018 04:00,1835,31.44,570,577,1265
06.04.2018 05:00,1818,30.85,561,573,1257
06.04.2018 06:00,1939,37.41,543,553,1396
06.04.2018 07:00,2221,44.71,503,508,1718
06.04.2018 08:00,2553,46.11,454,464,2099
06.04.2018 09:00,2228,45.66,427,436,1801
06.04.2018 10:00,2799,45.77,464,424,2335
06.04.2018 11:00,2840,45.81,414,423,2426
06.04.2018 12:00,2864,45.6,404,435,2460
06.04.2018 13:00,2869,45.58,440,463,2429
06.04.2018 14:00,2930,45.3,460,497,2470
06.04.2018 15:00,2951,45.19,470,498,2481
06.04.2018 16:00,2940,45.06,470,467,2470
06.04.2018 17:00,2887,44.77,427,434,2460
06.04.2018 18:00,2852,45.52,351,387,2501
06.04.2018 19:00,2743,46.07,308,343,2435
06.04.2018 20:00,2659,45.99,276,315,2383
06.04.2018 21:00,2602,45.63,256,293,2346
06.04.2018 22:00,2494,45.39,252,294,2242
06.04.2018 23:00,2392,45.27,266,300,2126
06.05.2018 00:00,2175,43.07,286,296,1889
06.05.2018 01:00,1979,42.66,298,315,1681
06.05.2018 02:00,1893,41.01,330,338,1563
06.05.2018 03:00,1841,39.44,366,369,1475
06.05.2018 04:00,1807,39.35,410,416,1397
06.05.2018 05:00,1692,39.05,473,460,1219
06.05.2018 06:00,1766,41.63,508,471,1258
06.05.2018 07:00,2157,45.83,518,474,1639
06.05.2018 08:00,2505,46.81,462,456,2043
06.05.2018 09:00,2686,46.87,382,381,2304
06.05.2018 10:00,2774,46.93,308,290,2466
06.05.2018 11:00,2844,47.1,253,221,2591
06.05.2018 12:00,2844,47.34,169,184,2675
06.05.2018 13:00,2811,47.22,146,174,2665
06.05.2018 14:00,2771,46.78,121,173,2650
06.05.2018 15:00,2700,46.44,127,175,2573
06.05.2018 16:00,2677,46.68,131,181,2546
06.05.2018 17:00,2590,46.51,149,195,2441
06.05.2018 18:00,2595,52.34,145,206,2450
06.05.2018 19:00,2527,58.04,167,218,2360
06.05.2018 20:00,2503,61.8,177,222,2326
06.05.2018 21:00,2470,56.09,176,217,2294
06.05.2018 22:00,2376,51.62,174,209,2202
06.05.2018 23:00,2271,49.02,190,228,2081
06.06.2018 00:00,2073,44.93,204,230,1869
06.06.2018 01:00,1837,44.99,211,207,1626
06.06.2018 02:00,1731,42.09,224,197,1507
06.06.2018 03:00,1674,41.12,230,190,1444
06.06.2018 04:00,1652,41.62,225,182,1427
06.06.2018 05:00,1601,41.64,221,170,1380
06.06.2018 06:00,1581,44.54,188,140,1393
06.06.2018 07:00,1728,46.84,159,110,1569
06.06.2018 08:00,1870,47.44,140,95,1730
06.06.2018 09:00,2110,63.44,134,96,1976
06.06.2018 10:00,2264,56.54,130,104,2134
06.06.2018 11:00,2376,49.75,121,115,2255
06.06.2018 12:00,2420,48.79,120,125,2300
06.06.2018 13:00,2387,47.83,129,137,2258
06.06.2018 14:00,2328,47.14,134,149,2194
06.06.2018 15:00,2187,47.16,128,159,2059
06.06.2018 16:00,2154,47.51,143,166,2011
06.06.2018 17:00,2186,47.93,165,173,2021
06.06.2018 18:00,2241,50.93,159,167,2082
06.06.2018 19:00,2251,59.78,143,155,2108
06.06.2018 20:00,2303,61.17,135,146,2168
06.06.2018 21:00,2246,57.66,139,151,2107
06.06.2018 22:00,2145,48.64,158,173,1987
06.06.2018 23:00,2024,47.36,189,207,1835
06.07.2018 00:00,1536,45.02,222,231,1314
06.07.2018 01:00,1783,44.04,279,267,1504
06.07.2018 02:00,1739,41.76,276,264,1463
06.07.2018 03:00,1727,41.03,263,253,1464
06.07.2018 04:00,1717,40.75,242,233,1475
06.07.2018 05:00,1677,40.36,210,206,1467
06.07.2018 06:00,1787,43.29,161,159,1626
06.07.2018 07:00,2126,47.21,114,119,2012
06.07.2018 08:00,2515,55.63,88,94,2427
06.07.2018 09:00,2671,60.95,82,99,2589
06.07.2018 10:00,2704,57.97,102,126,2602
06.07.2018 11:00,2748,50.61,129,164,2619
06.07.2018 12:00,2753,48.63,167,208,2586
06.07.2018 13:00,2628,47.98,207,247,2421
06.07.2018 14:00,2577,47.78,264,283,2313
06.07.2018 15:00,2617,47.85,301,305,2316
06.07.2018 16:00,2652,48.63,302,312,2350
06.07.2018 17:00,2620,52.92,306,311,2314
06.07.2018 18:00,2576,56.55,296,293,2280
06.07.2018 19:00,2521,57.59,258,263,2263
06.07.2018 20:00,2528,61.14,232,235,2296
06.07.2018 21:00,2520,56.95,222,231,2298
06.07.2018 22:00,2443,51.7,230,250,2213
06.07.2018 23:00,2259,49.75,260,281,1999
06.08.2018 00:00,2031,46.82,285,288,1746
06.08.2018 01:00,1831,46.02,268,262,1563
06.08.2018 02:00,1732,43.4,243,241,1489
06.08.2018 03:00,1711,42.82,215,209,1496
06.08.2018 04:00,1684,43.98,180,171,1504
06.08.2018 05:00,1669,44.01,138,133,1531
06.08.2018 06:00,1785,46.3,103,86,1682
06.08.2018 07:00,2132,48.93,56,48,2076
06.08.2018 08:00,2544,55.72,30,30,2514
06.08.2018 09:00,2695,63.52,13,25,2682
06.08.2018 10:00,2747,56.91,8,30,2739
06.08.2018 11:00,2796,55.46,11,36,2785
06.08.2018 12:00,2790,53.05,20,48,2770
06.08.2018 13:00,2698,49.54,32,66,2666
06.08.2018 14:00,2618,49.55,56,87,2562
06.08.2018 15:00,2523,49.09,79,101,2444
06.08.2018 16:00,2443,48.32,101,114,2342
06.08.2018 17:00,2418,48.45,118,131,2300
06.08.2018 18:00,2404,49.25,127,137,2277
06.08.2018 19:00,2327,53.35,133,135,2194
06.08.2018 20:00,2309,53.66,140,135,2169
06.08.2018 21:00,2298,51.82,131,138,2167
06.08.2018 22:00,2234,48.48,133,145,2101
06.08.2018 23:00,2217,49.16,142,153,2075
06.09.2018 00:00,1663,47.28,140,159,1523
06.09.2018 01:00,1925,46.18,117,117,1808
06.09.2018 02:00,1823,43.93,118,110,1705
06.09.2018 03:00,1756,42.63,113,109,1643
06.09.2018 04:00,1700,42.01,113,110,1587
06.09.2018 05:00,1635,40.87,126,118,1509
06.09.2018 06:00,1573,41.94,121,115,1452
06.09.2018 07:00,1636,45.17,105,100,1531
06.09.2018 08:00,1835,46.76,90,90,1745
06.09.2018 09:00,2040,47.2,84,92,1956
06.09.2018 10:00,2184,47.69,89,106,2095
06.09.2018 11:00,2275,47.73,104,123,2171
06.09.2018 12:00,2270,47.61,115,139,2155
06.09.2018 13:00,2232,47.45,123,154,2109
06.09.2018 14:00,2175,47.35,135,166,2040
06.09.2018 15:00,2149,47.03,143,168,2006
06.09.2018 16:00,2155,47,148,167,2007
06.09.2018 17:00,2112,46.98,150,167,1962
06.09.2018 18:00,2137,47.22,147,161,1990
06.09.2018 19:00,2176,48.48,144,154,2032
06.09.2018 20:00,2129,48.96,150,150,1979
06.09.2018 21:00,2072,48.91,155,152,1917
06.09.2018 22:00,2017,48.03,157,161,1860
06.09.2018 23:00,1951,47.46,162,170,1789
06.10.2018 00:00,1823,45.17,160,165,1663
06.10.2018 01:00,1684,45.46,122,119,1562
06.10.2018 02:00,1622,43.95,112,106,1510
06.10.2018 03:00,1622,43.31,106,103,1516
06.10.2018 04:00,1599,42.19,102,101,1497
06.10.2018 05:00,1511,42.08,92,95,1419
06.10.2018 06:00,1471,42.92,75,77,1396
06.10.2018 07:00,1519,44.2,50,54,1469
06.10.2018 08:00,1643,45.5,35,41,1608
06.10.2018 09:00,1817,46.41,25,37,1792
06.10.2018 10:00,1981,46.91,24,43,1957
06.10.2018 11:00,2080,47.49,28,54,2052
06.10.2018 12:00,2126,47.5,39,65,2087
06.10.2018 13:00,2134,47.34,55,86,2079
06.10.2018 14:00,2134,47.01,78,116,2056
06.10.2018 15:00,2086,46.04,98,135,1988
06.10.2018 16:00,1967,45.47,116,143,1851
06.10.2018 17:00,1832,45.96,154,149,1678
06.10.2018 18:00,1942,46.9,168,140,1774
06.10.2018 19:00,2104,47.63,171,125,1933
06.10.2018 20:00,2136,48.65,154,114,1982
06.10.2018 21:00,2154,48.86,117,107,2037
06.10.2018 22:00,2151,48.71,100,98,2051
06.10.2018 23:00,2073,48.53,101,94,1972
06.11.2018 00:00,1481,46.65,107,97,1374
06.11.2018 01:00,1804,45.4,163,174,1641
06.11.2018 02:00,1780,42.72,199,197,1581
06.11.2018 03:00,1760,42.27,202,213,1558
06.11.2018 04:00,1759,41.44,213,225,1546
06.11.2018 05:00,1730,41.45,228,243,1502
06.11.2018 06:00,1822,44.03,252,252,1570
06.11.2018 07:00,2201,50.62,254,258,1947
06.11.2018 08:00,2547,62,267,275,2280
06.11.2018 09:00,2696,64.79,304,309,2392
06.11.2018 10:00,2697,64.02,356,363,2341
06.11.2018 11:00,2777,63.59,448,431,2329
06.11.2018 12:00,2798,65.02,493,500,2305
06.11.2018 13:00,2774,64.08,558,566,2216
06.11.2018 14:00,2779,63.01,646,634,2133
06.11.2018 15:00,2708,60.23,715,704,1993
06.11.2018 16:00,2636,55.99,804,774,1832
06.11.2018 17:00,2566,54.08,817,830,1749
06.11.2018 18:00,2547,49.71,869,850,1678
06.11.2018 19:00,2459,48.84,877,851,1582
06.11.2018 20:00,2478,48.54,869,830,1609
06.11.2018 21:00,2491,47.8,820,776,1671
06.11.2018 22:00,2373,47.59,754,708,1619
06.11.2018 23:00,2233,47.53,694,652,1539
06.12.2018 00:00,1698,45.06,624,598,1074
06.12.2018 01:00,1873,41.93,605,587,1268
06.12.2018 02:00,1881,40.45,537,532,1344
06.12.2018 03:00,1860,39.04,489,478,1371
06.12.2018 04:00,1860,39.95,410,422,1450
06.12.2018 05:00,1824,39.1,359,370,1465
06.12.2018 06:00,1909,41.92,305,313,1604
06.12.2018 07:00,2194,46.72,262,261,1932
06.12.2018 08:00,2494,61.13,230,221,2264
06.12.2018 09:00,2622,64.44,198,191,2424
06.12.2018 10:00,2686,63.72,174,169,2512
06.12.2018 11:00,2749,69.48,160,154,2589
06.12.2018 12:00,2786,79.78,139,142,2647
06.12.2018 13:00,2725,83.04,125,135,2600
06.12.2018 14:00,2698,83.05,123,137,2575
06.12.2018 15:00,2715,69.41,123,136,2592
06.12.2018 16:00,2678,70.36,115,131,2563
06.12.2018 17:00,2558,63.72,117,128,2441
06.12.2018 18:00,2530,58.74,118,113,2412
06.12.2018 19:00,2492,56.31,114,98,2378
06.12.2018 20:00,2430,56.2,99,90,2331
06.12.2018 21:00,2404,54.08,88,86,2316
06.12.2018 22:00,2367,50.15,95,88,2272
06.12.2018 23:00,2275,50.29,93,97,2182
13.06.2018 00:00,2092,46.27,105,104,1987
13.06.2018 01:00,1893,46.18,96,84,1797
13.06.2018 02:00,1808,44.09,90,78,1718
13.06.2018 03:00,1788,42.39,81,73,1707
13.06.2018 04:00,1784,41.97,79,71,1705
13.06.2018 05:00,1772,41.56,84,71,1688
13.06.2018 06:00,1866,46.16,90,64,1776
13.06.2018 07:00,2221,47.13,66,55,2155
13.06.2018 08:00,2553,60.06,57,54,2496
13.06.2018 09:00,2688,68.36,58,58,2630
13.06.2018 10:00,2733,71.56,57,71,2676
13.06.2018 11:00,2754,70.26,78,89,2676
13.06.2018 12:00,2741,69.1,108,112,2633
13.06.2018 13:00,2715,65.07,129,140,2586
13.06.2018 14:00,2723,59.63,154,172,2569
13.06.2018 15:00,2695,55.4,166,187,2529
13.06.2018 16:00,2706,52.41,177,182,2529
13.06.2018 17:00,2614,49.27,189,172,2425
13.06.2018 18:00,2615,49.35,144,159,2471
13.06.2018 19:00,2537,52.12,140,148,2397
13.06.2018 20:00,2448,53.06,137,139,2311
13.06.2018 21:00,2363,52.91,145,140,2218
13.06.2018 22:00,2293,52.97,163,155,2130
13.06.2018 23:00,2202,51.24,186,178,2016
14.06.2018 00:00,2038,46.91,216,199,1822
14.06.2018 01:00,1967,47.25,246,244,1721
14.06.2018 02:00,1902,45.54,269,253,1633
14.06.2018 03:00,1859,43.65,253,242,1606
14.06.2018 04:00,1793,42.98,242,219,1551
14.06.2018 05:00,1746,43.08,215,199,1531
14.06.2018 06:00,1883,44.9,177,179,1706
14.06.2018 07:00,2231,46.4,161,166,2070
14.06.2018 08:00,2562,52.49,156,165,2406
14.06.2018 09:00,2713,56.74,159,166,2554
14.06.2018 10:00,2786,53.62,164,172,2622
14.06.2018 11:00,2797,65.04,189,189,2608
14.06.2018 12:00,2755,47.52,226,236,2529
14.06.2018 13:00,2694,47.46,274,299,2420
14.06.2018 14:00,2677,47.25,342,363,2335
14.06.2018 15:00,2647,47.08,422,413,2225
14.06.2018 16:00,2598,46.74,467,447,2131
14.06.2018 17:00,2528,45.92,502,482,2026
14.06.2018 18:00,2496,46.75,531,488,1965
14.06.2018 19:00,2451,50.67,523,473,1928
14.06.2018 20:00,2425,51.98,521,457,1904
14.06.2018 21:00,2398,47.2,514,464,1884
14.06.2018 22:00,2381,46.9,536,503,1845
14.06.2018 23:00,2423,46.37,544,554,1879
15.06.2018 00:00,2194,41.19,588,579,1606
15.06.2018 01:00,2054,40.06,587,590,1467
15.06.2018 02:00,1980,38.75,570,566,1410
15.06.2018 03:00,1978,37.8,515,520,1463
15.06.2018 04:00,1953,36.77,446,453,1507
15.06.2018 05:00,1920,37.73,384,383,1536
15.06.2018 06:00,1954,41.92,314,318,1640
15.06.2018 07:00,2263,48.03,254,262,2009
15.06.2018 08:00,2601,59.92,222,232,2379
15.06.2018 09:00,2784,63.42,202,228,2582
15.06.2018 10:00,2781,61.07,192,236,2589
15.06.2018 11:00,2760,57.62,206,247,2554
15.06.2018 12:00,2719,56.73,214,255,2505
15.06.2018 13:00,2664,53.71,214,259,2450
15.06.2018 14:00,2599,49.24,221,262,2378
15.06.2018 15:00,2538,47.76,208,254,2330
15.06.2018 16:00,2433,47.91,200,240,2233
15.06.2018 17:00,2354,48.06,172,223,2182
15.06.2018 18:00,2385,48.74,152,189,2233
15.06.2018 19:00,2306,52.68,125,146,2181
15.06.2018 20:00,2226,55,99,120,2127
15.06.2018 21:00,2166,54.75,94,116,2072
15.06.2018 22:00,2096,52.64,109,133,1987
15.06.2018 23:00,2078,48.03,120,153,1958
16.06.2018 00:00,1958,45.56,135,157,1823
16.06.2018 01:00,1796,43.92,122,122,1674
16.06.2018 02:00,1658,41.65,112,108,1546
16.06.2018 03:00,1594,41.01,97,95,1497
16.06.2018 04:00,1575,40.71,85,81,1490
16.06.2018 05:00,1560,40.29,73,68,1487
16.06.2018 06:00,1591,41.28,54,50,1537
16.06.2018 07:00,1700,42.04,37,37,1663
16.06.2018 08:00,1857,43.72,21,29,1836
16.06.2018 09:00,2017,45.83,16,30,2001
16.06.2018 10:00,2147,46.4,21,36,2126
16.06.2018 11:00,2220,46.61,31,52,2189
16.06.2018 12:00,2231,46.23,48,63,2183
16.06.2018 13:00,2211,45.4,77,86,2134
16.06.2018 14:00,2188,44.87,109,119,2079
16.06.2018 15:00,2142,44.51,129,145,2013
16.06.2018 16:00,2113,44.47,142,168,1971
16.06.2018 17:00,2061,44.72,169,194,1892
16.06.2018 18:00,2067,45.53,203,205,1864
16.06.2018 19:00,2042,46.02,208,206,1834
16.06.2018 20:00,2037,46.8,230,214,1807
16.06.2018 21:00,2079,46.08,215,231,1864
16.06.2018 22:00,2015,45.66,266,252,1749
16.06.2018 23:00,1929,46.1,277,275,1652
17.06.2018 00:00,1800,44.24,312,285,1488
17.06.2018 01:00,1733,43.87,363,369,1370
17.06.2018 02:00,1649,42.09,385,377,1264
17.06.2018 03:00,1576,40.42,376,368,1200
17.06.2018 04:00,1524,40.02,357,349,1167
17.06.2018 05:00,1517,39.6,326,327,1191
17.06.2018 06:00,1554,39.64,292,291,1262
17.06.2018 07:00,1648,40.55,239,249,1409
17.06.2018 08:00,1806,41.48,228,219,1578
17.06.2018 09:00,2023,43.63,200,210,1823
17.06.2018 10:00,2168,44.77,199,215,1969
17.06.2018 11:00,2199,45.42,216,239,1983
17.06.2018 12:00,2271,45.7,244,283,2027
17.06.2018 13:00,2236,45.45,294,340,1942
17.06.2018 14:00,2132,44.88,395,413,1737
17.06.2018 15:00,2060,44.24,452,487,1608
17.06.2018 16:00,2009,44.04,508,538,1501
17.06.2018 17:00,2114,44.06,560,566,1554
17.06.2018 18:00,2189,44.26,503,531,1686
17.06.2018 19:00,2155,44.17,442,470,1713
17.06.2018 20:00,2152,45.03,441,422,1711
17.06.2018 21:00,2155,45.62,407,391,1748
17.06.2018 22:00,2140,45.85,406,377,1734
17.06.2018 23:00,2154,45.81,374,378,1780
18.06.2018 00:00,1959,44.4,376,380,1583
18.06.2018 01:00,1824,43.46,381,396,1443
18.06.2018 02:00,1738,40.5,388,400,1350
18.06.2018 03:00,1718,39.01,375,383,1343
18.06.2018 04:00,1702,37.69,355,356,1347
18.06.2018 05:00,1715,36.82,338,335,1377
18.06.2018 06:00,1783,40.85,327,320,1456
18.06.2018 07:00,2191,44.68,317,322,1874
18.06.2018 08:00,2543,54.05,328,345,2215
18.06.2018 09:00,2663,50.81,363,390,2300
18.06.2018 10:00,2688,46.91,399,443,2289
18.06.2018 11:00,2779,45.99,450,489,2329
18.06.2018 12:00,2810,45.59,507,535,2303
18.06.2018 13:00,2769,44.98,549,580,2220
18.06.2018 14:00,2780,45.02,600,620,2180
18.06.2018 15:00,2719,44.84,615,639,2104
18.06.2018 16:00,2715,44.98,600,635,2115
18.06.2018 17:00,2720,44.58,598,621,2122
18.06.2018 18:00,2654,45.54,570,597,2084
18.06.2018 19:00,2650,48.78,525,573,2125
18.06.2018 20:00,2556,49.87,526,544,2030
18.06.2018 21:00,2452,49.59,501,525,1951
18.06.2018 22:00,2373,44.9,515,536,1858
18.06.2018 23:00,2354,44.2,557,573,1797
19.06.2018 00:00,2171,41.59,617,629,1554
19.06.2018 01:00,1985,39.65,631,655,1354
19.06.2018 02:00,1897,37.01,667,700,1230
19.06.2018 03:00,1880,34.03,718,736,1162
19.06.2018 04:00,1828,26.82,739,757,1089
19.06.2018 05:00,1778,26.98,769,773,1009
19.06.2018 06:00,1903,35.02,802,789,1101
19.06.2018 07:00,2154,41.74,835,818,1319
19.06.2018 08:00,2583,44.48,861,863,1722
19.06.2018 09:00,2683,44.59,904,905,1779
19.06.2018 10:00,2697,44.38,953,948,1744
19.06.2018 11:00,2785,44.2,982,992,1803
19.06.2018 12:00,2789,43.96,1026,1025,1763
19.06.2018 13:00,2747,43.87,1050,1053,1697
19.06.2018 14:00,2725,43.78,1056,1076,1669
19.06.2018 15:00,2709,43.6,1079,1088,1630
19.06.2018 16:00,2672,43.15,1097,1093,1575
19.06.2018 17:00,2544,42.6,1094,1086,1450
19.06.2018 18:00,2510,43.33,1067,1042,1443
19.06.2018 19:00,2429,43.97,1008,974,1421
19.06.2018 20:00,2371,44.49,941,889,1430
19.06.2018 21:00,2330,49.76,834,798,1496
19.06.2018 22:00,2245,49.76,760,717,1485
19.06.2018 23:00,2201,43.06,714,659,1487
20.06.2018 00:00,2050,41.09,697,623,1353
20.06.2018 01:00,2029,41.04,744,725,1285
20.06.2018 02:00,1948,38.4,691,679,1257
20.06.2018 03:00,1871,38.07,652,633,1219
20.06.2018 04:00,1872,38.03,602,581,1270
20.06.2018 05:00,1911,37.12,542,525,1369
20.06.2018 06:00,1997,40.94,474,471,1523
20.06.2018 07:00,2345,46.24,418,430,1927
20.06.2018 08:00,2617,55.7,386,405,2231
20.06.2018 09:00,2733,52.15,375,393,2358
20.06.2018 10:00,2742,49.53,366,388,2376
20.06.2018 11:00,2805,45.6,385,402,2420
20.06.2018 12:00,2810,44.97,483,487,2327
20.06.2018 13:00,2817,44.34,643,639,2174
20.06.2018 14:00,2855,43.68,803,802,2052
20.06.2018 15:00,2797,43.37,921,940,1876
20.06.2018 16:00,2772,42.15,990,1058,1782
20.06.2018 17:00,2704,41.95,1117,1146,1587
20.06.2018 18:00,2723,43.12,1154,1181,1569
20.06.2018 19:00,2659,43.76,1176,1176,1483
20.06.2018 20:00,2661,43.56,1158,1147,1503
20.06.2018 21:00,2634,43.06,1095,1092,1539
20.06.2018 22:00,2495,42.65,966,1028,1529
20.06.2018 23:00,2453,42.32,926,969,1527
21.06.2018 00:00,2249,41.56,924,939,1325
21.06.2018 01:00,2034,38.79,833,813,1201
21.06.2018 02:00,2013,38,804,783,1209
21.06.2018 03:00,1922,35.04,818,779,1104
21.06.2018 04:00,1862,37.09,796,775,1066
21.06.2018 05:00,1715,35.01,776,763,939
21.06.2018 06:00,1727,39.37,771,734,956
21.06.2018 07:00,2084,43.44,743,711,1341
21.06.2018 08:00,2593,50.24,689,677,1904
21.06.2018 09:00,2853,54.85,651,657,2202
21.06.2018 10:00,2901,45.26,642,640,2259
21.06.2018 11:00,2899,44.44,616,631,2283
21.06.2018 12:00,2920,44.17,618,651,2302
21.06.2018 13:00,2859,43.76,672,688,2187
21.06.2018 14:00,2860,43.39,685,725,2175
21.06.2018 15:00,2772,43.05,702,766,2070
21.06.2018 16:00,2659,42.6,797,815,1862
21.06.2018 17:00,2499,41.92,876,853,1623
21.06.2018 18:00,2437,41.9,916,880,1521
21.06.2018 19:00,2294,41.86,919,896,1375
21.06.2018 20:00,2264,41.96,931,906,1333
21.06.2018 21:00,2182,41.82,911,902,1271
21.06.2018 22:00,2104,40.37,887,899,1217
21.06.2018 23:00,2023,38.79,868,896,1155
22.06.2018 00:00,1942,22.02,844,881,1098
22.06.2018 01:00,1843,15.86,837,815,1006
22.06.2018 02:00,1742,15.21,771,772,971
22.06.2018 03:00,1703,13.09,713,711,990
22.06.2018 04:00,1712,4.56,643,630,1069
22.06.2018 05:00,1625,4.34,580,555,1045
22.06.2018 06:00,1623,10.38,533,507,1090
22.06.2018 07:00,1728,32.35,508,490,1220
22.06.2018 08:00,1883,41.11,506,497,1377
22.06.2018 09:00,2017,42.49,523,535,1494
22.06.2018 10:00,2108,42.72,532,581,1576
22.06.2018 11:00,1996,42.44,617,646,1379
22.06.2018 12:00,1956,40.56,663,705,1293
22.06.2018 13:00,1990,38.7,717,751,1273
22.06.2018 14:00,1867,35.7,765,779,1102
22.06.2018 15:00,1831,33.24,752,767,1079
22.06.2018 16:00,1874,35.08,708,727,1166
22.06.2018 17:00,1883,33.47,670,682,1213
22.06.2018 18:00,1828,37.08,668,605,1160
22.06.2018 19:00,1778,40.61,568,515,1210
22.06.2018 20:00,1815,40.25,439,425,1376
22.06.2018 21:00,1829,36.52,333,355,1496
22.06.2018 22:00,1782,35.75,303,313,1479
22.06.2018 23:00,1723,35.97,331,302,1392
23.06.2018 00:00,1643,33.27,324,297,1319
23.06.2018 01:00,1556,24.04,338,308,1218
23.06.2018 02:00,1519,18.42,322,289,1197
23.06.2018 03:00,1527,17.99,289,274,1238
23.06.2018 04:00,1556,15.45,237,262,1319
23.06.2018 05:00,1503,11.05,225,252,1278
23.06.2018 06:00,1433,13.01,185,217,1248
23.06.2018 07:00,1480,17.04,163,173,1317
23.06.2018 08:00,1579,36.05,146,146,1433
23.06.2018 09:00,1697,40.15,130,147,1567
23.06.2018 10:00,1749,42.03,166,172,1583
23.06.2018 11:00,1827,42.83,198,212,1629
23.06.2018 12:00,1917,42.64,233,261,1684
23.06.2018 13:00,1882,42.19,269,320,1613
23.06.2018 14:00,1840,41.95,308,383,1532
23.06.2018 15:00,1810,41.33,382,414,1428
23.06.2018 16:00,1823,41.01,394,423,1429
23.06.2018 17:00,1848,40.39,389,425,1459
23.06.2018 18:00,1895,41.76,357,381,1538
23.06.2018 19:00,1870,41.95,309,320,1561
23.06.2018 20:00,1817,42.52,264,258,1553
23.06.2018 21:00,1792,42.67,217,214,1575
23.06.2018 22:00,1762,42.6,186,191,1576
23.06.2018 23:00,1797,42.26,168,182,1629
24.06.2018 00:00,1691,39.44,181,175,1510
24.06.2018 01:00,1602,39.66,185,174,1417
24.06.2018 02:00,1548,38.01,171,171,1377
24.06.2018 03:00,1532,36.61,161,163,1371
24.06.2018 04:00,1518,35.78,156,163,1362
24.06.2018 05:00,1482,35.45,165,164,1317
24.06.2018 06:00,1446,35.59,144,143,1302
24.06.2018 07:00,1468,39.14,105,108,1363
24.06.2018 08:00,1562,40.72,71,79,1491
24.06.2018 09:00,1743,43.08,48,63,1695
24.06.2018 10:00,1908,43.33,46,64,1862
24.06.2018 11:00,2005,43.96,51,74,1954
24.06.2018 12:00,2036,44.35,57,86,1979
24.06.2018 13:00,2034,44.28,72,102,1962
24.06.2018 14:00,2014,44.14,96,125,1918
24.06.2018 15:00,1993,44.24,117,140,1876
24.06.2018 16:00,1939,43.9,130,145,1809
24.06.2018 17:00,1950,43.91,130,142,1820
24.06.2018 18:00,1979,44.06,124,129,1855
24.06.2018 19:00,1986,44.32,122,113,1864
24.06.2018 20:00,2030,44.95,120,100,1910
24.06.2018 21:00,2024,44.91,105,97,1919
24.06.2018 22:00,1965,45.56,100,108,1865
24.06.2018 23:00,1948,45.52,114,127,1834
25.06.2018 00:00,1834,43.29,130,137,1704
25.06.2018 01:00,1685,42.56,124,122,1561
25.06.2018 02:00,1625,40.97,133,131,1492
25.06.2018 03:00,1570,39.68,142,133,1428
25.06.2018 04:00,1538,39.32,145,135,1393
25.06.2018 05:00,1499,36.98,152,142,1347
25.06.2018 06:00,1611,43.04,131,128,1480
25.06.2018 07:00,2055,46.32,95,98,1960
25.06.2018 08:00,2405,57.22,68,78,2337
25.06.2018 09:00,2585,65.61,64,71,2521
25.06.2018 10:00,2632,69.64,71,83,2561
25.06.2018 11:00,2661,71.9,84,99,2577
25.06.2018 12:00,2701,72.06,103,117,2598
25.06.2018 13:00,2651,76.72,120,132,2531
25.06.2018 14:00,2651,72.02,125,150,2526
25.06.2018 15:00,2615,69.42,142,164,2473
25.06.2018 16:00,2632,46.34,149,176,2483
25.06.2018 17:00,2544,45.49,149,185,2395
25.06.2018 18:00,2512,46.49,136,175,2376
25.06.2018 19:00,2495,47.75,122,154,2373
25.06.2018 20:00,2474,49.95,113,133,2361
25.06.2018 21:00,2397,50.6,97,112,2300
25.06.2018 22:00,2295,48.87,85,98,2210
25.06.2018 23:00,2250,46.7,82,97,2168
26.06.2018 00:00,2098,43.99,81,99,2017
26.06.2018 01:00,1920,44.09,68,75,1852
26.06.2018 02:00,1862,42.26,75,80,1787
26.06.2018 03:00,1845,41.28,85,85,1760
26.06.2018 04:00,1851,41.56,94,95,1757
26.06.2018 05:00,1825,41.15,113,113,1712
26.06.2018 06:00,1889,43.34,115,110,1774
26.06.2018 07:00,2172,47.56,102,96,2070
26.06.2018 08:00,2535,56.96,92,89,2443
26.06.2018 09:00,2713,60.4,103,101,2610
26.06.2018 10:00,2764,58.89,109,126,2655
26.06.2018 11:00,2770,68.14,103,147,2667
26.06.2018 12:00,2791,69.46,110,152,2681
26.06.2018 13:00,2808,69.41,110,151,2698
26.06.2018 14:00,2807,69.3,126,152,2681
26.06.2018 15:00,2768,49.94,123,146,2645
26.06.2018 16:00,2713,50.13,146,139,2567
26.06.2018 17:00,2632,47.83,151,140,2481
26.06.2018 18:00,2617,49.99,133,126,2484
26.06.2018 19:00,2570,52.09,117,107,2453
26.06.2018 20:00,2507,54.88,106,88,2401
26.06.2018 21:00,2438,53.4,95,81,2343
26.06.2018 22:00,2344,50.94,94,84,2250
26.06.2018 23:00,2273,49.41,99,95,2174
27.06.2018 00:00,2029,44.42,105,98,1924
27.06.2018 01:00,1875,43.96,112,112,1763
27.06.2018 02:00,1840,41.94,120,112,1720
27.06.2018 03:00,1837,41.62,113,103,1724
27.06.2018 04:00,1846,41.48,96,92,1750
27.06.2018 05:00,1789,40.33,81,81,1708
27.06.2018 06:00,1872,43.82,65,61,1807
27.06.2018 07:00,2191,49.56,45,41,2146
27.06.2018 08:00,2532,58.17,27,31,2505
27.06.2018 09:00,2694,69.14,18,30,2676
27.06.2018 10:00,2719,71.85,16,34,2703
27.06.2018 11:00,2776,71.49,18,40,2758
27.06.2018 12:00,2763,80.81,25,47,2738
27.06.2018 13:00,2735,80.61,32,56,2703
27.06.2018 14:00,2721,76.05,40,65,2681
27.06.2018 15:00,2694,71.78,50,72,2644
27.06.2018 16:00,2682,63.09,54,78,2628
27.06.2018 17:00,2590,53.17,61,84,2529
27.06.2018 18:00,2521,58.54,67,81,2454
27.06.2018 19:00,2485,51.96,67,74,2418
27.06.2018 20:00,2478,55.01,65,70,2413
27.06.2018 21:00,2409,52.6,71,70,2338
27.06.2018 22:00,2313,50.02,68,73,2245
27.06.2018 23:00,2247,47.7,76,80,2171
28.06.2018 00:00,2063,45.34,85,88,1978
28.06.2018 01:00,1927,44.7,89,90,1838
28.06.2018 02:00,1837,41.67,83,83,1754
28.06.2018 03:00,1811,41.63,72,71,1739
28.06.2018 04:00,1804,41.03,62,59,1742
28.06.2018 05:00,1751,40,53,51,1698
28.06.2018 06:00,1834,44.01,40,40,1794
28.06.2018 07:00,2165,47.13,29,31,2136
28.06.2018 08:00,2495,52.96,19,27,2476
28.06.2018 09:00,2657,58.5,14,28,2643
28.06.2018 10:00,2723,52.34,18,38,2705
28.06.2018 11:00,2796,50.25,26,49,2770
28.06.2018 12:00,2808,49.75,42,66,2766
28.06.2018 13:00,2773,49.34,76,94,2697
28.06.2018 14:00,2726,49.21,114,133,2612
28.06.2018 15:00,2645,48.52,155,172,2490
28.06.2018 16:00,2668,47.59,202,213,2466
28.06.2018 17:00,2620,46.68,245,257,2375
28.06.2018 18:00,2549,47.95,281,282,2268
28.06.2018 19:00,2495,48.94,296,296,2199
28.06.2018 20:00,2494,49.98,316,310,2178
28.06.2018 21:00,2443,47.75,327,334,2116
28.06.2018 22:00,2365,45.78,349,362,2016
28.06.2018 23:00,2346,45.71,377,396,1969
29.06.2018 00:00,2113,41.46,396,415,1717
29.06.2018 01:00,1931,39,414,441,1517
29.06.2018 02:00,1897,37.89,424,448,1473
29.06.2018 03:00,1865,36.02,454,452,1411
29.06.2018 04:00,1788,33.98,480,478,1308
29.06.2018 05:00,1793,33.96,512,516,1281
29.06.2018 06:00,1936,38.15,539,538,1397
29.06.2018 07:00,2148,45.15,534,552,1614
29.06.2018 08:00,2468,51.13,555,565,1913
29.06.2018 09:00,2681,54.53,546,529,2135
29.06.2018 10:00,2833,50.81,484,458,2349
29.06.2018 11:00,2914,49.45,388,386,2526
29.06.2018 12:00,2793,49.09,298,339,2495
29.06.2018 13:00,2674,48.21,258,311,2416
29.06.2018 14:00,2549,47.74,241,293,2308
29.06.2018 15:00,2475,47.08,234,292,2241
29.06.2018 16:00,2411,46.43,238,300,2173
29.06.2018 17:00,2342,46.17,245,313,2097
29.06.2018 18:00,2338,46.18,243,299,2095
29.06.2018 19:00,2265,47.72,238,276,2027
29.06.2018 20:00,2222,49.75,230,261,1992
29.06.2018 21:00,2204,49.73,220,241,1984
29.06.2018 22:00,2140,48.66,198,218,1942
29.06.2018 23:00,2097,46.98,183,199,1914
30.06.2018 00:00,1982,43.28,158,166,1824
30.06.2018 01:00,1851,45.04,134,127,1717
30.06.2018 02:00,1767,43.05,117,103,1650
30.06.2018 03:00,1764,43.23,100,90,1664
30.06.2018 04:00,1762,40.21,88,87,1674
30.06.2018 05:00,1714,40.65,92,96,1622
30.06.2018 06:00,1716,43.17,92,97,1624
30.06.2018 07:00,1776,44.78,89,96,1687
30.06.2018 08:00,1856,46.03,93,106,1763
30.06.2018 09:00,2000,47.7,103,118,1897
30.06.2018 10:00,2115,47.62,118,137,1997
30.06.2018 11:00,2188,48.22,139,161,2049
30.06.2018 12:00,2223,47.92,147,175,2076
30.06.2018 13:00,2169,47.5,152,179,2017
30.06.2018 14:00,2092,46.34,151,184,1941
30.06.2018 15:00,2020,45.82,168,190,1852
30.06.2018 16:00,1973,45.44,189,205,1784
30.06.2018 17:00,1970,45.42,212,232,1758
30.06.2018 18:00,2009,46.37,232,244,1777
30.06.2018 19:00,2058,47.62,239,241,1819
30.06.2018 20:00,1990,48.54,279,244,1711
30.06.2018 21:00,1985,48.16,267,247,1718
30.06.2018 22:00,1982,47.51,267,248,1715
30.06.2018 23:00,1924,47.38,279,261,1645
07.01.2018 00:00,1858,45.45,273,256,1585
07.01.2018 01:00,1833,46.08,235,213,1598
07.01.2018 02:00,1839,44.49,201,194,1638
07.01.2018 03:00,1777,43.12,184,195,1593
07.01.2018 04:00,1699,42.36,192,206,1507
07.01.2018 05:00,1557,42.06,210,221,1347
07.01.2018 06:00,1572,42.33,219,228,1353
07.01.2018 07:00,1632,44.16,214,231,1418
07.01.2018 08:00,1740,45.02,233,255,1507
07.01.2018 09:00,1851,45.42,262,291,1589
07.01.2018 10:00,1908,45.57,314,336,1594
07.01.2018 11:00,1923,45.97,385,383,1538
07.01.2018 12:00,1944,46.03,407,391,1537
07.01.2018 13:00,2016,46.02,395,376,1621
07.01.2018 14:00,2064,45.82,392,358,1672
07.01.2018 15:00,1982,45.61,331,340,1651
07.01.2018 16:00,1956,46,320,324,1636
07.01.2018 17:00,2020,45.92,314,315,1706
07.01.2018 18:00,2112,46.25,286,294,1826
07.01.2018 19:00,2160,46.79,265,267,1895
07.01.2018 20:00,2174,48.37,234,247,1940
07.01.2018 21:00,2170,48.91,217,226,1953
07.01.2018 22:00,2118,47.04,199,211,1919
07.01.2018 23:00,2067,48.04,206,213,1861
07.02.2018 00:00,1998,46.53,216,213,1782
07.02.2018 01:00,1873,47.7,202,176,1671
07.02.2018 02:00,1819,46.21,236,186,1583
07.02.2018 03:00,1770,45.91,248,204,1522
07.02.2018 04:00,1767,45.39,257,218,1510
07.02.2018 05:00,1691,44.28,274,225,1417
07.02.2018 06:00,1698,46,251,211,1447
07.02.2018 07:00,2061,49.49,206,187,1855
07.02.2018 08:00,2491,50.96,189,177,2302
07.02.2018 09:00,2647,54.02,198,189,2449
07.02.2018 10:00,2654,52.14,231,213,2423
07.02.2018 11:00,2706,50.82,246,236,2460
07.02.2018 12:00,2736,50.79,276,250,2460
07.02.2018 13:00,2640,50.95,285,264,2355
07.02.2018 14:00,2653,50.9,288,277,2365
07.02.2018 15:00,2674,50.94,263,287,2411
07.02.2018 16:00,2690,50.62,264,307,2426
07.02.2018 17:00,2560,50.46,295,337,2265
07.02.2018 18:00,2502,51.99,324,346,2178
07.02.2018 19:00,2400,55.24,351,351,2049
07.02.2018 20:00,2434,58.73,362,349,2072
07.02.2018 21:00,2441,57.6,344,334,2097
07.02.2018 22:00,2366,53.27,319,328,2047
07.02.2018 23:00,2275,51.32,318,334,1957
07.03.2018 00:00,2088,48.94,314,326,1774
07.03.2018 01:00,1900,48.53,284,277,1616
07.03.2018 02:00,1823,46.9,250,252,1573
07.03.2018 03:00,1815,45.18,229,236,1586
07.03.2018 04:00,1812,44.77,222,220,1590
07.03.2018 05:00,1785,44.56,209,203,1576
07.03.2018 06:00,1832,46.79,171,166,1661
07.03.2018 07:00,2151,50.21,122,127,2029
07.03.2018 08:00,2544,56.93,93,104,2451
07.03.2018 09:00,2728,60.4,95,108,2633
07.03.2018 10:00,2780,55.95,111,137,2669
07.03.2018 11:00,2801,53.45,139,180,2662
07.03.2018 12:00,2723,51.92,177,220,2546
07.03.2018 13:00,2695,52.58,220,250,2475
07.03.2018 14:00,2700,53.89,252,281,2448
07.03.2018 15:00,2625,53.51,269,305,2356
07.03.2018 16:00,2595,52.71,282,322,2313
07.03.2018 17:00,2538,50.96,314,332,2224
07.03.2018 18:00,2499,52.99,293,309,2206
07.03.2018 19:00,2518,54.94,256,270,2262
07.03.2018 20:00,2483,60.19,214,229,2269
07.03.2018 21:00,2449,61.52,188,194,2261
07.03.2018 22:00,2340,58.57,175,183,2165
07.03.2018 23:00,2296,53.59,184,191,2112
07.04.2018 00:00,2116,50.28,191,201,1925
07.04.2018 01:00,1931,47.99,223,236,1708
07.04.2018 02:00,1882,46.24,266,270,1616
07.04.2018 03:00,1817,45.8,289,284,1528
07.04.2018 04:00,1802,46.02,287,297,1515
07.04.2018 05:00,1723,45.44,292,300,1431
07.04.2018 06:00,1723,47.79,252,257,1471
07.04.2018 07:00,2077,51.16,178,183,1899
07.04.2018 08:00,2501,57.44,112,122,2389
07.04.2018 09:00,2712,61.14,74,98,2638
07.04.2018 10:00,2743,58.06,87,101,2656
07.04.2018 11:00,2789,57.92,91,116,2698
07.04.2018 12:00,2778,57.29,113,140,2665
07.04.2018 13:00,2744,54.03,140,173,2604
07.04.2018 14:00,2757,53.64,170,210,2587
07.04.2018 15:00,2756,53.67,189,227,2567
07.04.2018 16:00,2729,53.94,196,231,2533
07.04.2018 17:00,2661,53.97,195,228,2466
07.04.2018 18:00,2627,54.95,204,212,2423
07.04.2018 19:00,2536,57.97,188,191,2348
07.04.2018 20:00,2472,59.91,170,172,2302
07.04.2018 21:00,2401,58.49,155,161,2246
07.04.2018 22:00,2326,56.62,153,161,2173
07.04.2018 23:00,2263,54.16,149,168,2114
07.05.2018 00:00,2064,50.93,168,170,1896
07.05.2018 01:00,1884,50.34,159,156,1725
07.05.2018 02:00,1844,48.55,171,167,1673
07.05.2018 03:00,1800,47.54,173,175,1627
07.05.2018 04:00,1810,47.14,167,172,1643
07.05.2018 05:00,1793,47.34,166,166,1627
07.05.2018 06:00,1828,49.35,145,142,1683
07.05.2018 07:00,2084,53.17,119,116,1965
07.05.2018 08:00,2417,56.43,98,102,2319
07.05.2018 09:00,2588,61.21,92,101,2496
07.05.2018 10:00,2651,60.94,101,109,2550
07.05.2018 11:00,2750,62.41,109,121,2641
07.05.2018 12:00,2790,64.07,125,137,2665
07.05.2018 13:00,2737,63.88,136,155,2601
07.05.2018 14:00,2708,63.57,158,174,2550
07.05.2018 15:00,2665,59.04,174,191,2491
07.05.2018 16:00,2634,57.56,191,207,2443
07.05.2018 17:00,2549,53.97,212,229,2337
07.05.2018 18:00,2493,52.97,226,235,2267
07.05.2018 19:00,2432,54.83,221,233,2211
07.05.2018 20:00,2389,55.41,212,229,2177
07.05.2018 21:00,2328,55.1,201,219,2127
07.05.2018 22:00,2231,53.79,189,206,2042
07.05.2018 23:00,2204,52.05,174,205,2030
07.06.2018 00:00,2070,50.21,190,204,1880
07.06.2018 01:00,1893,49.58,157,146,1736
07.06.2018 02:00,1819,47.89,160,157,1659
07.06.2018 03:00,1785,46.86,165,158,1620
07.06.2018 04:00,1780,44.09,151,151,1629
07.06.2018 05:00,1758,43.39,137,137,1621
07.06.2018 06:00,1802,47.32,107,104,1695
07.06.2018 07:00,2084,50.07,80,73,2004
07.06.2018 08:00,2448,53.69,60,58,2388
07.06.2018 09:00,2616,55.92,61,58,2555
07.06.2018 10:00,2676,55.96,69,65,2607
07.06.2018 11:00,2707,55.94,80,78,2627
07.06.2018 12:00,2722,55.85,84,98,2638
07.06.2018 13:00,2719,55.4,94,126,2625
07.06.2018 14:00,2664,54.73,118,153,2546
07.06.2018 15:00,2594,53.5,145,180,2449
07.06.2018 16:00,2491,52.39,173,206,2318
07.06.2018 17:00,2403,50.66,196,241,2207
07.06.2018 18:00,2354,50.58,220,257,2134
07.06.2018 19:00,2305,50.26,238,265,2067
07.06.2018 20:00,2232,50.42,248,270,1984
07.06.2018 21:00,2155,50.17,263,284,1892
07.06.2018 22:00,2086,49.6,276,320,1810
07.06.2018 23:00,2042,48.89,322,365,1720
07.07.2018 00:00,1906,47.8,345,378,1561
07.07.2018 01:00,1737,48.18,306,280,1431
07.07.2018 02:00,1736,46.65,279,270,1457
07.07.2018 03:00,1721,44.07,249,247,1472
07.07.2018 04:00,1679,40.1,205,220,1474
07.07.2018 05:00,1643,40.05,185,200,1458
07.07.2018 06:00,1659,45.03,157,176,1502
07.07.2018 07:00,1746,47.39,129,157,1617
07.07.2018 08:00,1847,47.54,120,148,1727
07.07.2018 09:00,1982,48,122,149,1860
07.07.2018 10:00,2071,49.1,126,159,1945
07.07.2018 11:00,2165,49.51,142,181,2023
07.07.2018 12:00,2223,49.34,154,209,2069
07.07.2018 13:00,2202,49.09,171,237,2031
07.07.2018 14:00,2201,48.64,183,264,2018
07.07.2018 15:00,2164,48.33,217,279,1947
07.07.2018 16:00,2166,48.04,204,285,1962
07.07.2018 17:00,2127,47.84,191,299,1936
07.07.2018 18:00,2098,48.29,191,283,1907
07.07.2018 19:00,2111,48.82,177,253,1934
07.07.2018 20:00,2025,48.7,200,228,1825
07.07.2018 21:00,1964,48.43,174,202,1790
07.07.2018 22:00,1961,48.11,137,184,1824
07.07.2018 23:00,1951,48.08,135,174,1816
07.08.2018 00:00,1843,48.25,129,148,1714
07.08.2018 01:00,1763,48.03,138,135,1625
07.08.2018 02:00,1719,46.09,128,120,1591
07.08.2018 03:00,1685,45.06,111,104,1574
07.08.2018 04:00,1633,45.02,91,84,1542
07.08.2018 05:00,1578,45.07,75,70,1503
07.08.2018 06:00,1537,47.11,53,54,1484
07.08.2018 07:00,1593,48.41,35,41,1558
07.08.2018 08:00,1683,48.56,25,34,1658
07.08.2018 09:00,1823,49.24,18,32,1805
07.08.2018 10:00,1934,49.4,16,34,1918
07.08.2018 11:00,2025,50.1,19,40,2006
07.08.2018 12:00,2067,50.27,24,51,2043
07.08.2018 13:00,2070,50.23,43,68,2027
07.08.2018 14:00,2054,50.02,70,94,1984
07.08.2018 15:00,2034,49.79,99,125,1935
07.08.2018 16:00,2004,49.57,140,162,1864
07.08.2018 17:00,2008,49.69,190,205,1818
07.08.2018 18:00,2088,49.93,210,216,1878
07.08.2018 19:00,2107,50.23,204,206,1903
07.08.2018 20:00,2106,50.43,198,190,1908
07.08.2018 21:00,2107,50.51,180,173,1927
07.08.2018 22:00,2029,50.27,163,163,1866
07.08.2018 23:00,1978,50.83,162,169,1816
07.09.2018 00:00,1851,49.94,175,188,1676
07.09.2018 01:00,1753,48.93,203,204,1550
07.09.2018 02:00,1729,47.51,188,196,1541
07.09.2018 03:00,1706,46.94,191,195,1515
07.09.2018 04:00,1678,45.76,195,199,1483
07.09.2018 05:00,1605,45,207,206,1398
07.09.2018 06:00,1676,47.37,208,203,1468
07.09.2018 07:00,1986,50.14,195,204,1791
07.09.2018 08:00,2333,53.52,201,212,2132
07.09.2018 09:00,2475,53.86,216,214,2259
07.09.2018 10:00,2548,53.37,219,215,2329
07.09.2018 11:00,2623,53.74,200,211,2423
07.09.2018 12:00,2655,54.21,192,206,2463
07.09.2018 13:00,2683,53.47,179,200,2504
07.09.2018 14:00,2684,53.37,178,199,2506
07.09.2018 15:00,2633,53.56,171,200,2462
07.09.2018 16:00,2543,53.19,182,200,2361
07.09.2018 17:00,2369,52.52,177,205,2192
07.09.2018 18:00,2347,52.39,170,191,2177
07.09.2018 19:00,2319,52.61,158,169,2161
07.09.2018 20:00,2337,53.06,152,155,2185
07.09.2018 21:00,2304,52.73,142,149,2162
07.09.2018 22:00,2285,51.94,147,158,2138
07.09.2018 23:00,2212,51.86,168,182,2044
07.10.2018 00:00,2071,49.73,193,199,1878
07.10.2018 01:00,1930,48.37,209,217,1721
07.10.2018 02:00,1884,47.68,237,247,1647
07.10.2018 03:00,1835,46.65,254,264,1581
07.10.2018 04:00,1796,45.7,260,262,1536
07.10.2018 05:00,1776,45.03,248,253,1528
07.10.2018 06:00,1849,48.19,229,233,1620
07.10.2018 07:00,2125,50.61,206,215,1919
07.10.2018 08:00,2466,55.46,196,205,2270
07.10.2018 09:00,2654,58.34,187,211,2467
07.10.2018 10:00,2668,58.9,186,228,2482
07.10.2018 11:00,2688,58.41,203,249,2485
07.10.2018 12:00,2700,58.26,218,258,2482
07.10.2018 13:00,2727,57.32,234,257,2493
07.10.2018 14:00,2732,57.02,228,249,2504
07.10.2018 15:00,2693,55.97,198,231,2495
07.10.2018 16:00,2597,55.15,196,210,2401
07.10.2018 17:00,2562,54.37,199,189,2363
07.10.2018 18:00,2549,56,193,168,2356
07.10.2018 19:00,2411,57.05,180,151,2231
07.10.2018 20:00,2366,57.38,178,136,2188
07.10.2018 21:00,2326,56.08,163,125,2163
07.10.2018 22:00,2244,54.75,151,123,2093
07.10.2018 23:00,2190,54.65,139,135,2051
07.11.2018 00:00,1975,50.69,156,151,1819
07.11.2018 01:00,1865,49.48,214,236,1651
07.11.2018 02:00,1789,49.04,235,258,1554
07.11.2018 03:00,1757,48.15,255,280,1502
07.11.2018 04:00,1716,47.99,267,293,1449
07.11.2018 05:00,1684,47.27,279,304,1405
07.11.2018 06:00,1694,48.36,274,291,1420
07.11.2018 07:00,1960,51.41,245,264,1715
07.11.2018 08:00,2320,55.62,222,242,2098
07.11.2018 09:00,2457,57.51,238,248,2219
07.11.2018 10:00,2424,57.75,256,276,2168
07.11.2018 11:00,2533,56.94,282,310,2251
07.11.2018 12:00,2563,56.69,303,318,2260
07.11.2018 13:00,2573,55.99,299,301,2274
07.11.2018 14:00,2544,54.99,284,278,2260
07.11.2018 15:00,2534,54.29,265,255,2269
07.11.2018 16:00,2498,53.67,240,239,2258
07.11.2018 17:00,2473,52.66,221,232,2252
07.11.2018 18:00,2530,55.23,205,213,2325
07.11.2018 19:00,2480,56.91,183,188,2297
07.11.2018 20:00,2430,57.08,159,161,2271
07.11.2018 21:00,2338,55.83,139,146,2199
07.11.2018 22:00,2237,55.12,129,144,2108
07.11.2018 23:00,2222,54.32,127,153,2095
07.12.2018 00:00,2092,51.58,133,156,1959
07.12.2018 01:00,1888,50.34,107,121,1781
07.12.2018 02:00,1789,49.5,109,125,1680
07.12.2018 03:00,1758,49.09,115,136,1643
07.12.2018 04:00,1747,49.03,129,146,1618
07.12.2018 05:00,1691,48.63,142,160,1549
07.12.2018 06:00,1751,49.6,146,164,1605
07.12.2018 07:00,1947,51.05,152,162,1795
07.12.2018 08:00,2277,55.81,156,162,2121
07.12.2018 09:00,2454,58.9,151,171,2303
07.12.2018 10:00,2492,56.97,164,188,2328
07.12.2018 11:00,2552,58.31,185,207,2367
07.12.2018 12:00,2573,58.3,202,216,2371
07.12.2018 13:00,2556,56.51,216,217,2340
07.12.2018 14:00,2609,54.92,199,218,2410
07.12.2018 15:00,2606,54.45,203,217,2403
07.12.2018 16:00,2542,54.22,188,207,2354
07.12.2018 17:00,2424,53.46,178,203,2246
07.12.2018 18:00,2411,55.44,179,190,2232
07.12.2018 19:00,2354,56.32,179,175,2175
07.12.2018 20:00,2304,57.23,168,168,2136
07.12.2018 21:00,2310,55.7,166,160,2144
07.12.2018 22:00,2239,54.57,157,154,2082
07.12.2018 23:00,2171,54.85,155,153,2016
13.07.2018 00:00,2029,51.16,150,156,1879
13.07.2018 01:00,1937,51.33,142,132,1795
13.07.2018 02:00,1851,50.29,145,131,1706
13.07.2018 03:00,1821,49.84,130,135,1691
13.07.2018 04:00,1800,49.07,129,136,1671
13.07.2018 05:00,1757,48.43,136,141,1621
13.07.2018 06:00,1815,49.92,129,132,1686
13.07.2018 07:00,2017,52.44,107,113,1910
13.07.2018 08:00,2332,56.11,89,100,2243
13.07.2018 09:00,2506,57.98,72,98,2434
13.07.2018 10:00,2595,56.53,72,105,2523
13.07.2018 11:00,2651,55,84,111,2567
13.07.2018 12:00,2612,54.21,79,115,2533
13.07.2018 13:00,2533,54.21,88,121,2445
13.07.2018 14:00,2427,54.1,103,131,2324
13.07.2018 15:00,2367,54.06,118,139,2249
13.07.2018 16:00,2367,53.6,129,142,2238
13.07.2018 17:00,2354,52.8,125,138,2229
13.07.2018 18:00,2337,53.93,119,131,2218
13.07.2018 19:00,2262,55.71,101,125,2161
13.07.2018 20:00,2153,56.57,104,120,2049
13.07.2018 21:00,2076,55.02,118,131,1958
13.07.2018 22:00,2004,54.4,151,161,1853
13.07.2018 23:00,1986,54.34,195,201,1791
14.07.2018 00:00,1849,51.92,217,223,1632
14.07.2018 01:00,1708,52.17,232,224,1476
14.07.2018 02:00,1626,50.77,247,235,1379
14.07.2018 03:00,1591,49.78,240,234,1351
14.07.2018 04:00,1550,48.91,242,228,1308
14.07.2018 05:00,1479,47.2,235,222,1244
14.07.2018 06:00,1451,48.23,207,204,1244
14.07.2018 07:00,1503,49.66,184,180,1319
14.07.2018 08:00,1632,50.37,167,164,1465
14.07.2018 09:00,1820,52.51,151,156,1669
14.07.2018 10:00,1979,52.71,139,155,1840
14.07.2018 11:00,2048,52.66,150,160,1898
14.07.2018 12:00,2084,52.63,165,177,1919
14.07.2018 13:00,2032,52.04,178,196,1854
14.07.2018 14:00,1963,51.67,191,214,1772
14.07.2018 15:00,1940,51.38,198,225,1742
14.07.2018 16:00,1906,51.08,210,231,1696
14.07.2018 17:00,1908,51.2,214,236,1694
14.07.2018 18:00,1969,51.69,212,224,1757
14.07.2018 19:00,1983,53.45,198,204,1785
14.07.2018 20:00,1941,54.32,187,184,1754
14.07.2018 21:00,1891,55,167,174,1724
14.07.2018 22:00,1856,54.22,163,178,1693
14.07.2018 23:00,1863,55.01,173,197,1690
15.07.2018 00:00,1725,52.4,187,217,1538
15.07.2018 01:00,1648,51.05,192,211,1456
15.07.2018 02:00,1568,49.22,220,231,1348
15.07.2018 03:00,1518,48.03,234,241,1284
15.07.2018 04:00,1474,46.85,236,239,1238
15.07.2018 05:00,1429,46.05,226,233,1203
15.07.2018 06:00,1413,48.02,200,205,1213
15.07.2018 07:00,1474,48.93,161,167,1313
15.07.2018 08:00,1617,49.73,135,147,1482
15.07.2018 09:00,1756,50.85,117,133,1639
15.07.2018 10:00,1856,51.62,97,123,1759
15.07.2018 11:00,1919,52.34,82,118,1837
15.07.2018 12:00,1963,52.37,81,118,1882
15.07.2018 13:00,1977,52.37,85,122,1892
15.07.2018 14:00,1961,51.94,92,127,1869
15.07.2018 15:00,1949,51.81,102,133,1847
15.07.2018 16:00,1942,51.65,107,140,1835
15.07.2018 17:00,1970,52.03,107,144,1863
15.07.2018 18:00,1965,52.47,111,141,1854
15.07.2018 19:00,1964,53.1,116,133,1848
15.07.2018 20:00,1979,54.25,113,127,1866
15.07.2018 21:00,1961,54.61,124,124,1837
15.07.2018 22:00,1911,54.87,130,125,1781
15.07.2018 23:00,1919,55.03,137,133,1782
16.07.2018 00:00,1765,53.26,139,133,1626
16.07.2018 01:00,1614,51.11,135,138,1479
16.07.2018 02:00,1534,49.01,134,131,1400
16.07.2018 03:00,1521,47.9,136,134,1385
16.07.2018 04:00,1522,47.72,143,142,1379
16.07.2018 05:00,1488,47.54,156,153,1332
16.07.2018 06:00,1524,49.86,147,141,1377
16.07.2018 07:00,1729,53.05,126,114,1603
16.07.2018 08:00,2076,56.42,100,91,1976
16.07.2018 09:00,2325,57.97,84,82,2241
16.07.2018 10:00,2397,58.75,70,83,2327
16.07.2018 11:00,2432,57.43,65,89,2367
16.07.2018 12:00,2425,57.74,79,96,2346
16.07.2018 13:00,2397,56.11,81,105,2316
16.07.2018 14:00,2398,54.94,82,116,2316
16.07.2018 15:00,2367,55.46,78,121,2289
16.07.2018 16:00,2342,55.41,85,121,2257
16.07.2018 17:00,2294,55.91,95,127,2199
16.07.2018 18:00,2270,57.36,94,128,2176
16.07.2018 19:00,2257,57.92,94,125,2163
16.07.2018 20:00,2242,58.3,100,122,2142
16.07.2018 21:00,2195,57.8,102,115,2093
16.07.2018 22:00,2125,55.55,97,111,2028
16.07.2018 23:00,2108,54.49,99,115,2009
17.07.2018 00:00,1905,51.84,104,117,1801
17.07.2018 01:00,1748,50.27,93,102,1655
17.07.2018 02:00,1672,49.1,107,115,1565
17.07.2018 03:00,1645,48.03,127,137,1518
17.07.2018 04:00,1615,47.77,150,164,1465
17.07.2018 05:00,1598,45.05,180,192,1418
17.07.2018 06:00,1597,48.27,185,195,1412
17.07.2018 07:00,1742,52.43,164,171,1578
17.07.2018 08:00,2035,56.07,144,148,1891
17.07.2018 09:00,2322,58.91,128,132,2194
17.07.2018 10:00,2387,57.97,101,124,2286
17.07.2018 11:00,2449,56.05,95,125,2354
17.07.2018 12:00,2468,56,101,134,2367
17.07.2018 13:00,2421,53.98,122,153,2299
17.07.2018 14:00,2391,53.67,128,172,2263
17.07.2018 15:00,2356,53.63,137,176,2219
17.07.2018 16:00,2252,53.77,135,171,2117
17.07.2018 17:00,2239,53.67,142,170,2097
17.07.2018 18:00,2231,53.92,149,169,2082
17.07.2018 19:00,2188,56.18,147,172,2041
17.07.2018 20:00,2181,57.57,165,177,2016
17.07.2018 21:00,2174,55.57,162,181,2012
17.07.2018 22:00,2163,53.88,171,187,1992
17.07.2018 23:00,2078,53.41,188,195,1890
18.07.2018 00:00,1883,51.32,197,202,1686
18.07.2018 01:00,1756,49.88,216,204,1540
18.07.2018 02:00,1655,48.06,212,207,1443
18.07.2018 03:00,1634,47.9,217,213,1417
18.07.2018 04:00,1662,46.28,216,218,1446
18.07.2018 05:00,1696,42.06,204,215,1492
18.07.2018 06:00,1690,47.88,195,206,1495
18.07.2018 07:00,1865,50.14,153,187,1712
18.07.2018 08:00,2152,53.47,138,174,2014
18.07.2018 09:00,2304,55.63,119,148,2185
18.07.2018 10:00,2434,54.12,104,127,2330
18.07.2018 11:00,2513,53.68,103,113,2410
18.07.2018 12:00,2481,53.69,99,116,2382
18.07.2018 13:00,2474,53.59,107,124,2367
18.07.2018 14:00,2421,53.62,107,133,2314
18.07.2018 15:00,2340,53.43,123,136,2217
18.07.2018 16:00,2310,53.37,142,138,2168
18.07.2018 17:00,2298,53.23,157,144,2141
18.07.2018 18:00,2276,53.68,167,146,2109
18.07.2018 19:00,2219,54.18,167,148,2052
18.07.2018 20:00,2165,56.58,171,155,1994
18.07.2018 21:00,2063,55.51,222,178,1841
18.07.2018 22:00,2016,53.72,268,214,1748
18.07.2018 23:00,1981,52.73,304,257,1677
19.07.2018 00:00,1784,49.88,311,295,1473
19.07.2018 01:00,1637,50.25,345,339,1292
19.07.2018 02:00,1583,49.05,364,365,1219
19.07.2018 03:00,1578,47.47,360,378,1218
19.07.2018 04:00,1598,42.03,358,379,1240
19.07.2018 05:00,1585,41.39,371,371,1214
19.07.2018 06:00,1574,46.21,353,343,1221
19.07.2018 07:00,1716,51.05,308,303,1408
19.07.2018 08:00,2009,54.09,277,270,1732
19.07.2018 09:00,2207,56.59,234,240,1973
19.07.2018 10:00,2304,55.95,212,219,2092
19.07.2018 11:00,2344,54.08,194,202,2150
19.07.2018 12:00,2335,54.04,189,198,2146
19.07.2018 13:00,2310,53.89,192,204,2118
19.07.2018 14:00,2289,52.99,192,213,2097
19.07.2018 15:00,2217,53.01,198,226,2019
19.07.2018 16:00,2208,53.8,205,239,2003
19.07.2018 17:00,2208,53.63,212,252,1996
19.07.2018 18:00,2210,55.26,208,252,2002
19.07.2018 19:00,2191,56.6,202,245,1989
19.07.2018 20:00,2158,57.96,203,233,1955
19.07.2018 21:00,2112,56.57,196,226,1916
19.07.2018 22:00,2049,55.05,204,230,1845
19.07.2018 23:00,2002,54.35,228,245,1774
20.07.2018 00:00,1809,51.9,243,261,1566
20.07.2018 01:00,1692,51.52,246,251,1446
20.07.2018 02:00,1620,50.23,258,263,1362
20.07.2018 03:00,1577,49.64,262,264,1315
20.07.2018 04:00,1556,48.12,252,252,1304
20.07.2018 05:00,1523,46.42,243,236,1280
20.07.2018 06:00,1543,49.18,212,203,1331
20.07.2018 07:00,1743,52.47,164,160,1579
20.07.2018 08:00,2074,56.23,129,132,1945
20.07.2018 09:00,2223,57.46,112,124,2111
20.07.2018 10:00,2288,57.98,111,129,2177
20.07.2018 11:00,2348,57.06,120,139,2228
20.07.2018 12:00,2370,56.69,128,153,2242
20.07.2018 13:00,2371,55.1,131,168,2240
20.07.2018 14:00,2327,55.02,149,183,2178
20.07.2018 15:00,2302,54.49,146,196,2156
20.07.2018 16:00,2229,55.06,154,211,2075
20.07.2018 17:00,2183,56.07,170,222,2013
20.07.2018 18:00,2188,57.91,186,229,2002
20.07.2018 19:00,2124,58.5,205,228,1919
20.07.2018 20:00,2019,57.93,229,219,1790
20.07.2018 21:00,1943,56.61,224,209,1719
20.07.2018 22:00,1889,55.38,231,217,1658
20.07.2018 23:00,1837,54.67,254,247,1583
21.07.2018 00:00,1679,52.57,279,277,1400
21.07.2018 01:00,1528,51.99,301,309,1227
21.07.2018 02:00,1434,50.4,327,328,1107
21.07.2018 03:00,1390,49.18,335,329,1055
21.07.2018 04:00,1397,49.03,317,314,1080
21.07.2018 05:00,1388,48.07,301,291,1087
21.07.2018 06:00,1340,49.01,254,245,1086
21.07.2018 07:00,1392,50.53,194,186,1198
21.07.2018 08:00,1583,52.01,147,144,1436
21.07.2018 09:00,1778,53.81,131,140,1647
21.07.2018 10:00,1928,55.04,140,160,1788
21.07.2018 11:00,1969,55.09,163,188,1806
21.07.2018 12:00,2000,55.18,194,219,1806
21.07.2018 13:00,1989,54.72,222,250,1767
21.07.2018 14:00,1980,53.78,252,277,1728
21.07.2018 15:00,1903,53.26,266,296,1637
21.07.2018 16:00,1872,52.88,295,311,1577
21.07.2018 17:00,1886,52.73,301,319,1585
21.07.2018 18:00,1920,53.43,292,295,1628
21.07.2018 19:00,1917,54.79,280,262,1637
21.07.2018 20:00,1902,55.13,271,238,1631
21.07.2018 21:00,1889,54.96,236,231,1653
21.07.2018 22:00,1861,54.68,238,235,1623
21.07.2018 23:00,1877,54.49,229,240,1648
22.07.2018 00:00,1766,52.44,218,235,1548
22.07.2018 01:00,1651,52.72,193,204,1458
22.07.2018 02:00,1555,51.14,183,195,1372
22.07.2018 03:00,1512,50.29,179,190,1333
22.07.2018 04:00,1480,49.89,179,183,1301
22.07.2018 05:00,1436,48.28,171,175,1265
22.07.2018 06:00,1367,48.96,153,154,1214
22.07.2018 07:00,1401,50.11,131,131,1270
22.07.2018 08:00,1562,51.44,122,119,1440
22.07.2018 09:00,1699,52.46,129,133,1570
22.07.2018 10:00,1823,52.88,157,169,1666
22.07.2018 11:00,1924,53.47,204,213,1720
22.07.2018 12:00,1955,53.71,242,259,1713
22.07.2018 13:00,1955,53.16,235,306,1720
22.07.2018 14:00,1970,52.96,275,350,1695
22.07.2018 15:00,1930,52.67,302,353,1628
22.07.2018 16:00,1878,52.5,272,338,1606
22.07.2018 17:00,1859,52.62,266,318,1593
22.07.2018 18:00,1912,52.76,240,281,1672
22.07.2018 19:00,1902,53.14,207,237,1695
22.07.2018 20:00,1903,55.14,173,199,1730
22.07.2018 21:00,1924,56.19,149,183,1775
22.07.2018 22:00,1930,56.85,145,181,1785
22.07.2018 23:00,1919,56.24,142,181,1777
23.07.2018 00:00,1776,53.38,142,170,1634
23.07.2018 01:00,1665,51.81,143,149,1522
23.07.2018 02:00,1583,50.2,139,154,1444
23.07.2018 03:00,1524,47.95,134,152,1390
23.07.2018 04:00,1465,47.1,133,147,1332
23.07.2018 05:00,1437,45.78,131,141,1306
23.07.2018 06:00,1489,50.23,122,131,1367
23.07.2018 07:00,1670,53.61,111,120,1559
23.07.2018 08:00,2000,57.54,105,121,1895
23.07.2018 09:00,2192,59.94,113,135,2079
23.07.2018 10:00,2316,59.05,135,159,2181
23.07.2018 11:00,2352,58.58,153,189,2199
23.07.2018 12:00,2380,59.4,181,218,2199
23.07.2018 13:00,2371,58.68,211,246,2160
23.07.2018 14:00,2369,56.86,244,273,2125
23.07.2018 15:00,2319,56.61,256,279,2063
23.07.2018 16:00,2301,56.56,242,278,2059
23.07.2018 17:00,2245,56.64,243,277,2002
23.07.2018 18:00,2207,57.91,218,251,1989
23.07.2018 19:00,2174,58.8,190,215,1984
23.07.2018 20:00,2118,59.97,161,179,1957
23.07.2018 21:00,2092,58.66,142,158,1950
23.07.2018 22:00,2103,57.6,145,162,1958
23.07.2018 23:00,2099,56.1,167,185,1932
24.07.2018 00:00,1932,53.95,192,211,1740
24.07.2018 01:00,1744,52.56,186,191,1558
24.07.2018 02:00,1642,50.35,198,204,1444
24.07.2018 03:00,1563,49.57,197,199,1366
24.07.2018 04:00,1531,49.08,184,183,1347
24.07.2018 05:00,1484,48.17,163,165,1321
24.07.2018 06:00,1482,50.87,132,133,1350
24.07.2018 07:00,1733,53.97,98,96,1635
24.07.2018 08:00,2045,60.63,68,73,1977
24.07.2018 09:00,2278,62.9,57,66,2221
24.07.2018 10:00,2343,61.32,53,71,2290
24.07.2018 11:00,2419,59.57,59,82,2360
24.07.2018 12:00,2414,58.46,69,93,2345
24.07.2018 13:00,2368,57.44,76,104,2292
24.07.2018 14:00,2363,56.72,86,115,2277
24.07.2018 15:00,2337,57.03,96,118,2241
24.07.2018 16:00,2308,57.67,99,116,2209
24.07.2018 17:00,2282,58.19,101,116,2181
24.07.2018 18:00,2282,61.86,93,108,2189
24.07.2018 19:00,2255,62.63,83,99,2172
24.07.2018 20:00,2215,63.94,73,90,2142
24.07.2018 21:00,2150,62.68,72,87,2078
24.07.2018 22:00,2093,62.36,78,92,2015
24.07.2018 23:00,2084,57.74,82,99,2002
25.07.2018 00:00,1928,54.47,83,98,1845
25.07.2018 01:00,1745,53.64,53,58,1692
25.07.2018 02:00,1666,51.57,50,54,1616
25.07.2018 03:00,1621,50.42,46,49,1575
25.07.2018 04:00,1606,50.31,42,45,1564
25.07.2018 05:00,1589,50.02,38,42,1551
25.07.2018 06:00,1588,51.44,33,35,1555
25.07.2018 07:00,1778,54.43,23,29,1755
25.07.2018 08:00,2051,62.96,15,24,2036
25.07.2018 09:00,2255,65,9,22,2246
25.07.2018 10:00,2369,66.67,9,27,2360
25.07.2018 11:00,2418,65.04,11,36,2407
25.07.2018 12:00,2451,70.05,17,45,2434
25.07.2018 13:00,2430,70.9,30,58,2400
25.07.2018 14:00,2386,70.22,47,72,2339
25.07.2018 15:00,2315,63.83,66,88,2249
25.07.2018 16:00,2295,62.11,84,104,2211
25.07.2018 17:00,2259,59.91,107,114,2152
25.07.2018 18:00,2272,62.18,112,113,2160
25.07.2018 19:00,2211,65.8,123,106,2088
25.07.2018 20:00,2181,66.9,101,98,2080
25.07.2018 21:00,2132,65.45,92,98,2040
25.07.2018 22:00,2086,64.37,106,110,1980
25.07.2018 23:00,2068,60.54,125,125,1943
26.07.2018 00:00,1901,54.43,127,134,1774
26.07.2018 01:00,1756,51.67,146,135,1610
26.07.2018 02:00,1675,50.24,140,133,1535
26.07.2018 03:00,1673,49.07,144,141,1529
26.07.2018 04:00,1667,48.3,152,148,1515
26.07.2018 05:00,1617,47.49,145,153,1472
26.07.2018 06:00,1583,50.14,131,135,1452
26.07.2018 07:00,1729,53.57,107,98,1622
26.07.2018 08:00,2011,60.77,78,71,1933
26.07.2018 09:00,2220,65.66,74,61,2146
26.07.2018 10:00,2303,62.96,52,60,2251
26.07.2018 11:00,2377,61.47,61,64,2316
26.07.2018 12:00,2403,62.05,55,68,2348
26.07.2018 13:00,2388,60.77,56,75,2332
26.07.2018 14:00,2359,60.76,68,85,2291
26.07.2018 15:00,2310,59.68,77,100,2233
26.07.2018 16:00,2268,58.02,95,116,2173
26.07.2018 17:00,2210,56.81,128,139,2082
26.07.2018 18:00,2212,59,146,153,2066
26.07.2018 19:00,2201,61,146,153,2055
26.07.2018 20:00,2175,61.95,153,152,2022
26.07.2018 21:00,2123,60.61,129,138,1994
26.07.2018 22:00,2088,59.8,122,125,1966
26.07.2018 23:00,2049,54.32,122,122,1927
27.07.2018 00:00,1851,52.07,114,113,1737
27.07.2018 01:00,1739,52.06,115,123,1624
27.07.2018 02:00,1674,50.26,137,127,1537
27.07.2018 03:00,1625,48.11,141,136,1484
27.07.2018 04:00,1594,47.76,148,143,1446
27.07.2018 05:00,1575,46.43,151,157,1424
27.07.2018 06:00,1574,50.86,149,158,1425
27.07.2018 07:00,1734,53.35,142,146,1592
27.07.2018 08:00,2063,60.91,125,140,1938
27.07.2018 09:00,2289,64.78,136,158,2153
27.07.2018 10:00,2387,64.23,170,199,2217
27.07.2018 11:00,2419,65.73,235,251,2184
27.07.2018 12:00,2373,65.3,301,303,2072
27.07.2018 13:00,2348,56.39,354,350,1994
27.07.2018 14:00,2305,54.39,365,390,1940
27.07.2018 15:00,2267,54.07,383,412,1884
27.07.2018 16:00,2195,54.25,409,417,1786
27.07.2018 17:00,2156,54.42,454,410,1702
27.07.2018 18:00,2138,58.02,471,403,1667
27.07.2018 19:00,2075,60.09,453,394,1622
27.07.2018 20:00,2051,61.21,430,371,1621
27.07.2018 21:00,2070,58.46,409,354,1661
27.07.2018 22:00,2110,55.83,373,351,1737
27.07.2018 23:00,2030,53.03,333,355,1697
28.07.2018 00:00,1887,50.85,343,351,1544
28.07.2018 01:00,1737,50.67,356,364,1381
28.07.2018 02:00,1623,49.04,377,375,1246
28.07.2018 03:00,1554,45.05,394,388,1160
28.07.2018 04:00,1579,43.09,401,396,1178
28.07.2018 05:00,1580,42.24,400,397,1180
28.07.2018 06:00,1490,44.46,385,371,1105
28.07.2018 07:00,1545,47.05,337,333,1208
28.07.2018 08:00,1716,49.85,308,306,1408
28.07.2018 09:00,1879,52.08,309,304,1570
28.07.2018 10:00,2013,53.08,305,321,1708
28.07.2018 11:00,2064,53.6,321,344,1743
28.07.2018 12:00,2067,53.56,339,368,1728
28.07.2018 13:00,2012,52.64,374,375,1638
28.07.2018 14:00,1981,51.35,385,377,1596
28.07.2018 15:00,1984,50.91,354,361,1630
28.07.2018 16:00,1986,50.62,351,339,1635
28.07.2018 17:00,1960,50.84,336,327,1624
28.07.2018 18:00,1942,50.88,344,314,1598
28.07.2018 19:00,1898,51.46,330,295,1568
28.07.2018 20:00,1944,52.88,307,278,1637
28.07.2018 21:00,1963,52.84,285,263,1678
28.07.2018 22:00,1927,53.09,261,249,1666
28.07.2018 23:00,1920,53.45,227,233,1693
29.07.2018 00:00,1873,50.59,188,205,1685
29.07.2018 01:00,1798,50.02,183,199,1615
29.07.2018 02:00,1713,46.74,142,162,1571
29.07.2018 03:00,1621,45.04,113,137,1508
29.07.2018 04:00,1558,44.05,107,125,1451
29.07.2018 05:00,1538,43.9,103,130,1435
29.07.2018 06:00,1480,44.02,131,133,1349
29.07.2018 07:00,1520,46.83,139,145,1381
29.07.2018 08:00,1644,48.08,145,160,1499
29.07.2018 09:00,1804,50.2,147,169,1657
29.07.2018 10:00,1960,51.15,142,178,1818
29.07.2018 11:00,2038,51.38,146,182,1892
29.07.2018 12:00,2077,51.25,141,178,1936
29.07.2018 13:00,2076,51.14,131,164,1945
29.07.2018 14:00,2015,51.12,113,150,1902
29.07.2018 15:00,1959,51.21,109,136,1850
29.07.2018 16:00,1932,51.39,101,120,1831
29.07.2018 17:00,1958,51.39,99,104,1859
29.07.2018 18:00,2032,52.41,82,89,1950
29.07.2018 19:00,2048,52.84,76,75,1972
29.07.2018 20:00,2011,55.76,69,66,1942
29.07.2018 21:00,1970,57.43,65,61,1905
29.07.2018 22:00,1938,58.37,63,60,1875
29.07.2018 23:00,1922,56.79,57,69,1865
30.07.2018 00:00,1798,53.03,59,67,1739
30.07.2018 01:00,1646,51.52,31,33,1615
30.07.2018 02:00,1572,48.12,33,37,1539
30.07.2018 03:00,1527,45.67,39,43,1488
30.07.2018 04:00,1535,45.35,41,51,1494
30.07.2018 05:00,1572,45.06,53,62,1519
30.07.2018 06:00,1545,50.03,63,74,1482
30.07.2018 07:00,1735,52.56,67,82,1668
30.07.2018 08:00,2009,59.21,72,91,1937
30.07.2018 09:00,2223,62.49,81,90,2142
30.07.2018 10:00,2353,71.04,78,89,2275
30.07.2018 11:00,2446,70.79,72,91,2374
30.07.2018 12:00,2444,74.94,70,89,2374
30.07.2018 13:00,2446,80.04,63,88,2383
30.07.2018 14:00,2473,61.27,57,89,2416
30.07.2018 15:00,2444,61.23,60,88,2384
30.07.2018 16:00,2383,58.08,62,83,2321
30.07.2018 17:00,2306,57.32,65,78,2241
30.07.2018 18:00,2296,62.96,56,71,2240
30.07.2018 19:00,2252,64.35,61,64,2191
30.07.2018 20:00,2215,66.22,64,61,2151
30.07.2018 21:00,2137,63.58,69,64,2068
30.07.2018 22:00,2123,62.34,76,74,2047
30.07.2018 23:00,2070,60.37,80,87,1990
31.07.2018 00:00,1894,53.03,78,91,1816
31.07.2018 01:00,1768,51.44,73,87,1695
31.07.2018 02:00,1687,50.27,80,82,1607
31.07.2018 03:00,1621,50.19,88,81,1533
31.07.2018 04:00,1644,49.68,82,83,1562
31.07.2018 05:00,1640,47.9,83,90,1557
31.07.2018 06:00,1656,50.63,83,94,1573
31.07.2018 07:00,1873,53.08,79,93,1794
31.07.2018 08:00,2152,62.48,76,92,2076
31.07.2018 09:00,2362,67.39,77,99,2285
31.07.2018 10:00,2420,67.52,86,115,2334
31.07.2018 11:00,2482,63.55,98,137,2384
31.07.2018 12:00,2489,62.22,118,158,2371
31.07.2018 13:00,2462,58.05,139,180,2323
31.07.2018 14:00,2456,55.8,157,202,2299
31.07.2018 15:00,2410,54.17,185,222,2225
31.07.2018 16:00,2363,54.41,219,240,2144
31.07.2018 17:00,2317,55.35,238,257,2079
31.07.2018 18:00,2315,62.51,259,255,2056
31.07.2018 19:00,2305,65.06,244,243,2061
31.07.2018 20:00,2295,65.96,227,226,2068
31.07.2018 21:00,2223,65.32,216,210,2007
31.07.2018 22:00,2143,65.32,209,191,1934
31.07.2018 23:00,2074,63.68,188,166,1886
08.01.2018 00:00,1945,52.93,154,125,1791
08.01.2018 01:00,1850,50.33,135,275,1715
08.01.2018 02:00,1752,49.64,89,192,1663
08.01.2018 03:00,1710,49.07,68,137,1642
08.01.2018 04:00,1714,48.64,56,108,1658
08.01.2018 05:00,1736,47.94,50,96,1686
08.01.2018 06:00,1701,49.92,37,82,1664
08.01.2018 07:00,1871,53.3,26,66,1845
08.01.2018 08:00,2158,60.27,23,62,2135
08.01.2018 09:00,2358,62.01,28,63,2330
08.01.2018 10:00,2430,63.53,31,85,2399
08.01.2018 11:00,2470,61.92,49,115,2421
08.01.2018 12:00,2550,60.55,44,143,2506
08.01.2018 13:00,2567,59.65,71,170,2496
08.01.2018 14:00,2569,59.23,74,202,2495
08.01.2018 15:00,2559,59.41,66,217,2493
08.01.2018 16:00,2485,59.42,64,215,2421
08.01.2018 17:00,2416,59.67,78,225,2338
08.01.2018 18:00,2382,64.58,90,215,2292
08.01.2018 19:00,2274,66.6,103,195,2171
08.01.2018 20:00,2241,67.49,101,180,2140
08.01.2018 21:00,2181,64,103,177,2078
08.01.2018 22:00,2173,63.59,94,187,2079
08.01.2018 23:00,2149,61.43,94,206,2055
08.02.2018 00:00,1987,53.77,98,211,1889
08.02.2018 01:00,1806,51.46,83,95,1723
08.02.2018 02:00,1712,50.04,89,92,1623
08.02.2018 03:00,1640,49.58,91,88,1549
08.02.2018 04:00,1606,49.26,92,85,1514
08.02.2018 05:00,1606,48.57,88,83,1518
08.02.2018 06:00,1605,50.08,77,72,1528
08.02.2018 07:00,1780,53.47,56,56,1724
08.02.2018 08:00,2060,62.21,45,46,2015
08.02.2018 09:00,2302,66.25,39,46,2263
08.02.2018 10:00,2387,67.32,38,54,2349
08.02.2018 11:00,2447,67.32,40,66,2407
08.02.2018 12:00,2462,66.58,51,83,2411
08.02.2018 13:00,2480,65.72,70,104,2410
08.02.2018 14:00,2440,64.4,103,130,2337
08.02.2018 15:00,2389,62.58,126,148,2263
08.02.2018 16:00,2325,61.94,143,161,2182
08.02.2018 17:00,2255,63.07,156,174,2099
08.02.2018 18:00,2281,66.42,152,173,2129
08.02.2018 19:00,2282,67.98,153,169,2129
08.02.2018 20:00,2281,69.41,143,167,2138
08.02.2018 21:00,2224,67.72,150,169,2074
08.02.2018 22:00,2103,65.49,164,179,1939
08.02.2018 23:00,2016,63.62,177,189,1839
08.03.2018 00:00,1854,53.93,184,182,1670
08.03.2018 01:00,1703,52.37,158,154,1545
08.03.2018 02:00,1603,51.14,140,136,1463
08.03.2018 03:00,1563,50.29,125,122,1438
08.03.2018 04:00,1555,49.54,120,114,1435
08.03.2018 05:00,1560,49.66,111,110,1449
08.03.2018 06:00,1588,50.29,97,98,1491
08.03.2018 07:00,1781,57.29,71,80,1710
08.03.2018 08:00,2089,68.09,57,68,2032
08.03.2018 09:00,2284,71.7,53,67,2231
08.03.2018 10:00,2399,71.99,63,81,2336
08.03.2018 11:00,2453,72.19,80,104,2373
08.03.2018 12:00,2460,71.72,108,135,2352
08.03.2018 13:00,2430,67.55,138,170,2292
08.03.2018 14:00,2414,64.47,172,207,2242
08.03.2018 15:00,2378,61.86,197,226,2181
08.03.2018 16:00,2338,62.59,206,237,2132
08.03.2018 17:00,2293,67.55,201,240,2092
08.03.2018 18:00,2310,68.07,204,221,2106
08.03.2018 19:00,2269,68.82,184,194,2085
08.03.2018 20:00,2230,73.68,164,173,2066
08.03.2018 21:00,2123,70.35,164,167,1959
08.03.2018 22:00,2114,70.01,171,174,1943
08.03.2018 23:00,2026,63.78,174,184,1852
08.04.2018 00:00,1878,53.88,179,194,1699
08.04.2018 01:00,1711,53.72,151,153,1560
08.04.2018 02:00,1602,51.51,143,146,1459
08.04.2018 03:00,1537,49.94,142,147,1395
08.04.2018 04:00,1538,49.5,150,151,1388
08.04.2018 05:00,1548,48.75,158,158,1390
08.04.2018 06:00,1458,48.73,155,150,1303
08.04.2018 07:00,1444,49.96,154,143,1290
08.04.2018 08:00,1572,51.63,152,144,1420
08.04.2018 09:00,1769,54.89,164,161,1605
08.04.2018 10:00,1876,56.46,197,197,1679
08.04.2018 11:00,1910,53.79,249,245,1661
08.04.2018 12:00,1951,52.95,289,287,1662
08.04.2018 13:00,2001,52.37,324,323,1677
08.04.2018 14:00,1933,51.47,366,359,1567
08.04.2018 15:00,1871,51.24,369,372,1502
08.04.2018 16:00,1825,51.08,366,379,1459
08.04.2018 17:00,1868,51.1,392,385,1476
08.04.2018 18:00,1901,51.58,393,372,1508
08.04.2018 19:00,1905,52.76,372,357,1533
08.04.2018 20:00,1885,56.26,346,346,1539
08.04.2018 21:00,1969,54.47,344,348,1625
08.04.2018 22:00,2074,53.09,375,370,1699
08.04.2018 23:00,1956,52.09,425,408,1531
08.05.2018 00:00,1821,49.6,444,455,1377
08.05.2018 01:00,1697,50.61,442,446,1255
08.05.2018 02:00,1611,49.88,457,487,1154
08.05.2018 03:00,1530,49.41,500,528,1030
08.05.2018 04:00,1544,47.86,537,562,1007
08.05.2018 05:00,1542,46.07,568,591,974
08.05.2018 06:00,1522,45.07,596,618,926
08.05.2018 07:00,1553,45.68,627,652,926
08.05.2018 08:00,1691,47.44,657,701,1034
08.05.2018 09:00,1769,49.44,714,764,1055
08.05.2018 10:00,1800,49.78,757,833,1043
08.05.2018 11:00,1896,49.69,813,896,1083
08.05.2018 12:00,1942,49.72,884,951,1058
08.05.2018 13:00,1965,49.46,962,1005,1003
08.05.2018 14:00,1974,49.36,1007,1055,967
08.05.2018 15:00,1941,49.19,1014,1089,927
08.05.2018 16:00,1917,48.05,1049,1107,868
08.05.2018 17:00,1938,48.19,1069,1119,869
08.05.2018 18:00,1989,49.89,1059,1103,930
08.05.2018 19:00,2017,51.33,1048,1064,969
08.05.2018 20:00,2026,52.39,982,1002,1044
08.05.2018 21:00,2042,52.91,879,917,1163
08.05.2018 22:00,2139,53.42,812,830,1327
08.05.2018 23:00,2111,52.97,724,762,1387
08.06.2018 00:00,1933,51.51,673,713,1260
08.06.2018 01:00,1762,50.05,630,656,1132
08.06.2018 02:00,1681,47.99,613,620,1068
08.06.2018 03:00,1620,47.02,614,603,1006
08.06.2018 04:00,1641,46.02,580,598,1061
08.06.2018 05:00,1665,45.08,595,593,1070
08.06.2018 06:00,1690,47.1,582,584,1108
08.06.2018 07:00,2030,52.91,557,569,1473
08.06.2018 08:00,2324,63.38,546,565,1778
08.06.2018 09:00,2464,68.01,534,568,1930
08.06.2018 10:00,2499,68.34,533,562,1966
08.06.2018 11:00,2551,65.94,511,545,2040
08.06.2018 12:00,2651,64.45,489,527,2162
08.06.2018 13:00,2641,62.36,475,508,2166
08.06.2018 14:00,2610,59.72,459,493,2151
08.06.2018 15:00,2578,60.42,435,473,2143
08.06.2018 16:00,2537,63.06,405,451,2132
08.06.2018 17:00,2445,66.99,369,417,2076
08.06.2018 18:00,2461,71.71,326,355,2135
08.06.2018 19:00,2401,74.58,273,284,2128
08.06.2018 20:00,2298,78.08,216,225,2082
08.06.2018 21:00,2219,77.29,175,187,2044
08.06.2018 22:00,2194,74.82,160,163,2034
08.06.2018 23:00,2057,69.89,149,149,1908
08.07.2018 00:00,1887,55.63,170,138,1717
08.07.2018 01:00,1805,53.29,213,215,1592
08.07.2018 02:00,1738,52.06,210,207,1528
08.07.2018 03:00,1706,51.01,188,180,1518
08.07.2018 04:00,1657,49.75,142,141,1515
08.07.2018 05:00,1636,49.53,104,104,1532
08.07.2018 06:00,1717,51.51,73,70,1644
08.07.2018 07:00,1987,56.6,48,47,1939
08.07.2018 08:00,2344,68.85,31,34,2313
08.07.2018 09:00,2504,72.52,25,32,2479
08.07.2018 10:00,2567,72.42,25,39,2542
08.07.2018 11:00,2601,70.7,36,52,2565
08.07.2018 12:00,2633,69.61,51,66,2582
08.07.2018 13:00,2621,68.56,63,85,2558
08.07.2018 14:00,2605,67.36,81,108,2524
08.07.2018 15:00,2552,67.73,125,134,2427
08.07.2018 16:00,2506,68.63,153,160,2353
08.07.2018 17:00,2409,69.12,186,181,2223
08.07.2018 18:00,2394,72.59,215,191,2179
08.07.2018 19:00,2338,76,213,195,2125
08.07.2018 20:00,2342,78.04,216,210,2126
08.07.2018 21:00,2290,73.06,250,255,2040
08.07.2018 22:00,2203,66.02,324,334,1879
08.07.2018 23:00,2080,56.06,408,425,1672
08.08.2018 00:00,1878,51.97,454,475,1424
08.08.2018 01:00,1790,49.35,511,1052,1279
08.08.2018 02:00,1765,47.55,521,1062,1244
08.08.2018 03:00,1651,46.61,528,1073,1123
08.08.2018 04:00,1668,43.9,539,1090,1129
08.08.2018 05:00,1751,43.9,546,1105,1205
08.08.2018 06:00,1758,47.8,556,1111,1202
08.08.2018 07:00,1942,51.15,559,1092,1383
08.08.2018 08:00,2378,57.3,532,1056,1846
08.08.2018 09:00,2659,63.5,552,1070,2107
08.08.2018 10:00,2680,65.04,552,1152,2128
08.08.2018 11:00,2645,59.12,606,1284,2039
08.08.2018 12:00,2609,55.79,691,1421,1918
08.08.2018 13:00,2638,52.62,780,1538,1858
08.08.2018 14:00,2734,52.23,822,1623,1912
08.08.2018 15:00,2794,51.55,817,1639,1977
08.08.2018 16:00,2806,52.13,758,1586,2048
08.08.2018 17:00,2760,54.56,696,1509,2064
08.08.2018 18:00,2746,62.96,604,1331,2142
08.08.2018 19:00,2685,64.63,511,1116,2174
08.08.2018 20:00,2623,66.23,437,951,2186
08.08.2018 21:00,2451,66.06,374,838,2077
08.08.2018 22:00,2431,62.78,340,752,2091
08.08.2018 23:00,2237,52.24,374,701,1863
08.09.2018 00:00,2188,50.07,351,644,1837
08.09.2018 01:00,2024,49.36,345,314,1679
08.09.2018 02:00,1855,46.33,301,282,1554
08.09.2018 03:00,1829,45.04,262,249,1567
08.09.2018 04:00,1849,43.99,219,216,1630
08.09.2018 05:00,1845,44,187,182,1658
08.09.2018 06:00,1869,46.61,158,144,1711
08.09.2018 07:00,2071,51.21,123,107,1948
08.09.2018 08:00,2386,62.79,92,76,2294
08.09.2018 09:00,2594,65.08,61,64,2533
08.09.2018 10:00,2677,64.88,49,60,2628
08.09.2018 11:00,2715,66.26,46,62,2669
08.09.2018 12:00,2710,66.18,45,70,2665
08.09.2018 13:00,2698,64.31,58,80,2640
08.09.2018 14:00,2675,61.48,69,93,2606
08.09.2018 15:00,2638,58.98,76,101,2562
08.09.2018 16:00,2616,57.41,76,107,2540
08.09.2018 17:00,2534,55.73,77,111,2457
08.09.2018 18:00,2487,57.93,71,106,2416
08.09.2018 19:00,2464,58.76,75,99,2389
08.09.2018 20:00,2390,56.9,85,93,2305
08.09.2018 21:00,2255,52.36,115,99,2140
08.09.2018 22:00,2153,51.41,176,121,1977
08.09.2018 23:00,1913,49.54,291,174,1622
08.10.2018 00:00,1666,47.29,373,260,1293
08.10.2018 01:00,1767,44.84,533,541,1234
08.10.2018 02:00,1907,42.22,615,636,1292
08.10.2018 03:00,1987,41.1,690,701,1297
08.10.2018 04:00,1945,40.68,760,735,1185
08.10.2018 05:00,1907,38.81,740,745,1167
08.10.2018 06:00,1929,39.93,765,777,1164
08.10.2018 07:00,1995,47.79,843,846,1152
08.10.2018 08:00,2245,49.69,945,948,1300
08.10.2018 09:00,2452,51.43,1029,1032,1423
08.10.2018 10:00,2542,51.58,1096,1102,1446
08.10.2018 11:00,2662,51.08,1166,1167,1496
08.10.2018 12:00,2701,50.6,1202,1215,1499
08.10.2018 13:00,2622,48.66,1224,1249,1398
08.10.2018 14:00,2555,47.58,1237,1265,1318
08.10.2018 15:00,2536,46.87,1230,1251,1306
08.10.2018 16:00,2455,46.18,1188,1214,1267
08.10.2018 17:00,2426,48.04,1122,1164,1304
08.10.2018 18:00,2359,51.69,1081,1080,1278
08.10.2018 19:00,2260,50.98,960,974,1300
08.10.2018 20:00,2185,51.1,830,848,1355
08.10.2018 21:00,2214,50.39,723,740,1491
08.10.2018 22:00,2203,51.09,638,658,1565
08.10.2018 23:00,2108,49.76,574,597,1534
08.11.2018 00:00,1930,48.25,514,544,1416
08.11.2018 01:00,1727,48.24,435,432,1292
08.11.2018 02:00,1622,45.8,407,397,1215
08.11.2018 03:00,1551,44.02,378,358,1173
08.11.2018 04:00,1503,41.39,336,320,1167
08.11.2018 05:00,1519,40.64,295,288,1224
08.11.2018 06:00,1449,41.01,257,258,1192
08.11.2018 07:00,1477,41.52,249,236,1228
08.11.2018 08:00,1629,44.22,257,236,1372
08.11.2018 09:00,1833,47.97,276,260,1557
08.11.2018 10:00,1954,48.48,336,317,1618
08.11.2018 11:00,2021,48.46,380,382,1641
08.11.2018 12:00,1947,48.56,427,428,1520
08.11.2018 13:00,2023,48.76,450,466,1573
08.11.2018 14:00,2080,48.43,504,509,1576
08.11.2018 15:00,2018,47.97,484,529,1534
08.11.2018 16:00,1862,47.08,505,521,1357
08.11.2018 17:00,1882,48.07,507,499,1375
08.11.2018 18:00,2045,48.74,454,445,1591
08.11.2018 19:00,2091,49.6,371,386,1720
08.11.2018 20:00,2105,50.78,375,342,1730
08.11.2018 21:00,2056,50.98,399,353,1657
08.11.2018 22:00,1954,51.17,439,413,1515
08.11.2018 23:00,1830,50.2,495,496,1335
08.12.2018 00:00,1715,49.38,565,560,1150
08.12.2018 01:00,1750,47.06,797,786,953
08.12.2018 02:00,1683,44.5,891,889,792
08.12.2018 03:00,1621,42.8,946,957,675
08.12.2018 04:00,1598,42.05,982,992,616
08.12.2018 05:00,1627,40.99,1005,1013,622
08.12.2018 06:00,1606,40.93,1030,1012,576
08.12.2018 07:00,1632,41.47,1010,1005,622
08.12.2018 08:00,1698,40.97,1011,1004,687
08.12.2018 09:00,1796,42.11,1013,1020,783
08.12.2018 10:00,1913,43.89,1030,1042,883
08.12.2018 11:00,1989,44.54,1309,1045,680
08.12.2018 12:00,2035,45.02,1274,1039,761
08.12.2018 13:00,2045,45.02,1245,1024,800
08.12.2018 14:00,1979,44.43,1244,1000,735
08.12.2018 15:00,2049,44.41,1149,953,900
08.12.2018 16:00,2021,45.09,1110,884,911
08.12.2018 17:00,2035,45.87,1024,804,1011
08.12.2018 18:00,2128,47.45,853,689,1275
08.12.2018 19:00,2219,49.58,677,548,1542
08.12.2018 20:00,2182,50.67,526,413,1656
08.12.2018 21:00,2164,51.8,388,315,1776
08.12.2018 22:00,2171,54.96,302,247,1869
08.12.2018 23:00,2026,50.43,181,199,1845
13.08.2018 00:00,1899,49.45,151,169,1748
13.08.2018 01:00,1803,49.06,130,196,1673
13.08.2018 02:00,1713,47.08,118,187,1595
13.08.2018 03:00,1687,44.97,136,184,1551
13.08.2018 04:00,1688,44.18,146,193,1542
13.08.2018 05:00,1783,44.06,139,218,1644
13.08.2018 06:00,1891,47.26,135,240,1756
13.08.2018 07:00,2147,53.69,140,262,2007
13.08.2018 08:00,2504,60.79,153,292,2351
13.08.2018 09:00,2716,63.04,150,304,2566
13.08.2018 10:00,2743,63.76,152,306,2591
13.08.2018 11:00,2793,64.49,159,311,2634
13.08.2018 12:00,2818,64.93,147,298,2671
13.08.2018 13:00,2765,63.44,151,283,2614
13.08.2018 14:00,2732,64.81,121,275,2611
13.08.2018 15:00,2700,64.32,132,265,2568
13.08.2018 16:00,2684,60.84,109,210,2575
13.08.2018 17:00,2615,59.56,132,213,2483
13.08.2018 18:00,2578,60.14,147,220,2431
13.08.2018 19:00,2531,59.91,167,196,2364
13.08.2018 20:00,2458,62.09,198,224,2260
13.08.2018 21:00,2461,59.26,220,260,2241
13.08.2018 22:00,2424,59.99,252,286,2172
13.08.2018 23:00,2196,55.34,274,306,1922
14.08.2018 00:00,2022,49.94,273,302,1749
14.08.2018 01:00,1970,49.41,294,334,1676
14.08.2018 02:00,1893,47.88,322,370,1571
14.08.2018 03:00,1842,46.88,345,387,1497
14.08.2018 04:00,1840,45.7,365,400,1475
14.08.2018 05:00,1890,45.77,382,418,1508
14.08.2018 06:00,1959,48.22,368,421,1591
14.08.2018 07:00,2165,53.47,357,404,1808
14.08.2018 08:00,2463,61.71,345,381,2118
14.08.2018 09:00,2664,64.07,334,357,2330
14.08.2018 10:00,2718,64.39,303,327,2415
14.08.2018 11:00,2734,64.93,269,297,2465
14.08.2018 12:00,2761,65.09,229,260,2532
14.08.2018 13:00,2732,65.7,193,225,2539
14.08.2018 14:00,2742,63.71,174,207,2568
14.08.2018 15:00,2719,62.9,153,194,2566
14.08.2018 16:00,2719,61.93,162,196,2557
14.08.2018 17:00,2628,60.02,180,210,2448
14.08.2018 18:00,2613,58.52,181,220,2432
14.08.2018 19:00,2532,59.89,203,226,2329
14.08.2018 20:00,2416,63.53,237,237,2179
14.08.2018 21:00,2393,61.92,254,254,2139
14.08.2018 22:00,2411,61.97,256,278,2155
14.08.2018 23:00,2264,57.05,278,303,1986
15.08.2018 00:00,2096,50.99,301,324,1795
15.08.2018 01:00,1939,49.41,268,262,1671
15.08.2018 02:00,1861,48.39,266,264,1595
15.08.2018 03:00,1851,47.85,256,259,1595
15.08.2018 04:00,1822,46.55,251,249,1571
15.08.2018 05:00,1811,45.52,237,240,1574
15.08.2018 06:00,1913,47.19,222,230,1691
15.08.2018 07:00,2152,51.07,219,220,1933
15.08.2018 08:00,2453,55.25,219,220,2234
15.08.2018 09:00,2595,59.68,224,221,2371
15.08.2018 10:00,2625,59.27,208,223,2417
15.08.2018 11:00,2747,59.62,198,225,2549
15.08.2018 12:00,2758,61.3,196,222,2562
15.08.2018 13:00,2734,60.62,185,218,2549
15.08.2018 14:00,2735,58.43,180,213,2555
15.08.2018 15:00,2672,58,172,205,2500
15.08.2018 16:00,2635,56.97,153,192,2482
15.08.2018 17:00,2540,53.96,156,179,2384
15.08.2018 18:00,2532,54.63,148,152,2384
15.08.2018 19:00,2491,57.98,109,119,2382
15.08.2018 20:00,2461,56.73,93,95,2368
15.08.2018 21:00,2436,60.4,101,94,2335
15.08.2018 22:00,2405,61.86,110,105,2295
15.08.2018 23:00,2229,53.21,136,118,2093
16.08.2018 00:00,2036,50.57,140,125,1896
16.08.2018 01:00,1903,49.41,163,163,1740
16.08.2018 02:00,1833,47.97,167,164,1666
16.08.2018 03:00,1852,47.39,167,162,1685
16.08.2018 04:00,1886,46.82,157,162,1729
16.08.2018 05:00,1872,46.51,146,165,1726
16.08.2018 06:00,1954,48.5,151,172,1803
16.08.2018 07:00,2237,52.86,161,182,2076
16.08.2018 08:00,2580,59.6,162,190,2418
16.08.2018 09:00,2800,62.1,194,216,2606
16.08.2018 10:00,2873,59.82,249,268,2624
16.08.2018 11:00,2914,55.01,294,337,2620
16.08.2018 12:00,2888,53.03,369,414,2519
16.08.2018 13:00,2802,51.02,412,483,2390
16.08.2018 14:00,2792,50.72,468,547,2324
16.08.2018 15:00,2694,50.46,497,560,2197
16.08.2018 16:00,2596,50.8,466,541,2130
16.08.2018 17:00,2568,51.88,501,514,2067
16.08.2018 18:00,2580,60.94,483,490,2097
16.08.2018 19:00,2523,63.79,467,454,2056
16.08.2018 20:00,2542,64.11,448,433,2094
16.08.2018 21:00,2516,64.4,457,448,2059
16.08.2018 22:00,2474,50.71,484,482,1990
16.08.2018 23:00,2316,50.23,502,510,1814
17.08.2018 00:00,2153,48.11,492,503,1661
17.08.2018 01:00,2029,46.89,440,443,1589
17.08.2018 02:00,1969,45.39,408,415,1561
17.08.2018 03:00,1925,44.89,370,382,1555
17.08.2018 04:00,1907,44.72,334,347,1573
17.08.2018 05:00,1924,44.98,300,309,1624
17.08.2018 06:00,1946,46.57,261,265,1685
17.08.2018 07:00,2185,52.61,217,215,1968
17.08.2018 08:00,2542,61.37,164,167,2378
17.08.2018 09:00,2604,62.9,127,143,2477
17.08.2018 10:00,2695,64.39,135,142,2560
17.08.2018 11:00,2731,63.05,130,153,2601
17.08.2018 12:00,2718,62.82,145,169,2573
17.08.2018 13:00,2667,60.47,165,190,2502
17.08.2018 14:00,2630,57.85,184,216,2446
17.08.2018 15:00,2549,53.92,195,230,2354
17.08.2018 16:00,2421,53.01,198,232,2223
17.08.2018 17:00,2298,55.84,203,226,2095
17.08.2018 18:00,2357,61.49,190,200,2167
17.08.2018 19:00,2383,62.91,171,167,2212
17.08.2018 20:00,2269,63.05,133,136,2136
17.08.2018 21:00,2186,63.02,105,113,2081
17.08.2018 22:00,2183,62.69,91,95,2092
17.08.2018 23:00,2033,49.74,87,87,1946
18.08.2018 00:00,1859,48.67,91,86,1768
18.08.2018 01:00,1785,49.09,115,109,1670
18.08.2018 02:00,1717,48.44,130,119,1587
18.08.2018 03:00,1688,47.73,130,129,1558
18.08.2018 04:00,1625,46.41,133,133,1492
18.08.2018 05:00,1602,46.16,131,136,1471
18.08.2018 06:00,1606,45.92,132,128,1474
18.08.2018 07:00,1627,47.64,118,114,1509
18.08.2018 08:00,1728,48.66,114,105,1614
18.08.2018 09:00,1967,49.99,121,120,1846
18.08.2018 10:00,2064,50.36,161,169,1903
18.08.2018 11:00,2087,50.15,220,240,1867
18.08.2018 12:00,2100,49.48,300,319,1800
18.08.2018 13:00,2080,47.42,380,403,1700
18.08.2018 14:00,2029,46.06,465,484,1564
18.08.2018 15:00,1960,45.57,514,539,1446
18.08.2018 16:00,1925,46.03,536,574,1389
18.08.2018 17:00,1998,46.85,561,604,1437
18.08.2018 18:00,2095,48,583,603,1512
18.08.2018 19:00,2066,48.16,594,585,1472
18.08.2018 20:00,2045,48.11,588,571,1457
18.08.2018 21:00,2035,47.67,619,580,1416
18.08.2018 22:00,2000,48.04,666,607,1334
18.08.2018 23:00,1842,46.41,677,638,1165
19.08.2018 00:00,1699,43.64,692,660,1007
19.08.2018 01:00,1688,44.18,752,734,936
19.08.2018 02:00,1682,42.89,725,714,957
19.08.2018 03:00,1661,42.66,692,686,969
19.08.2018 04:00,1650,42.69,655,652,995
19.08.2018 05:00,1637,42.48,624,616,1013
19.08.2018 06:00,1658,42.9,586,583,1072
19.08.2018 07:00,1672,44.21,547,551,1125
19.08.2018 08:00,1785,45,519,520,1266
19.08.2018 09:00,1908,46.06,491,498,1417
19.08.2018 10:00,2038,47.02,457,476,1581
19.08.2018 11:00,2117,46.02,431,456,1686
19.08.2018 12:00,2176,45.89,421,440,1755
19.08.2018 13:00,2222,44.7,395,428,1827
19.08.2018 14:00,2224,44.24,375,418,1849
19.08.2018 15:00,2199,42.65,370,403,1829
19.08.2018 16:00,2125,42.58,318,381,1807
19.08.2018 17:00,2179,44.32,330,357,1849
19.08.2018 18:00,2230,47.09,311,320,1919
19.08.2018 19:00,2271,49.61,288,273,1983
19.08.2018 20:00,2246,49.99,255,230,1991
19.08.2018 21:00,2258,50.07,239,207,2019
19.08.2018 22:00,2232,50.17,253,199,1979
19.08.2018 23:00,2040,49.5,267,197,1773
20.08.2018 00:00,1848,48.02,281,195,1567
20.08.2018 01:00,1818,46.59,458,460,1360
20.08.2018 02:00,1804,46.06,539,532,1265
20.08.2018 03:00,1762,44.15,570,581,1192
20.08.2018 04:00,1724,43.8,596,608,1128
20.08.2018 05:00,1810,43.6,616,618,1194
20.08.2018 06:00,1984,46.76,591,599,1393
20.08.2018 07:00,2297,50.76,564,566,1733
20.08.2018 08:00,2595,54.25,516,524,2079
20.08.2018 09:00,2725,59.95,511,506,2214
20.08.2018 10:00,2746,59.96,517,499,2229
20.08.2018 11:00,2734,59.94,521,505,2213
20.08.2018 12:00,2684,58.87,560,531,2124
20.08.2018 13:00,2611,57.09,588,564,2023
20.08.2018 14:00,2576,54.99,632,599,1944
20.08.2018 15:00,2482,52.86,637,624,1845
20.08.2018 16:00,2437,52.79,668,634,1769
20.08.2018 17:00,2336,52.76,665,640,1671
20.08.2018 18:00,2336,53.83,676,611,1660
20.08.2018 19:00,2253,54.65,597,561,1656
20.08.2018 20:00,2293,54.56,543,507,1750
20.08.2018 21:00,2323,54.05,489,461,1834
20.08.2018 22:00,2283,53.02,447,442,1836
20.08.2018 23:00,2105,50.58,435,439,1670
21.08.2018 00:00,1894,48.19,417,436,1477
21.08.2018 01:00,1783,48.92,398,409,1385
21.08.2018 02:00,1743,48.24,360,365,1383
21.08.2018 03:00,1731,48.08,322,324,1409
21.08.2018 04:00,1778,48.03,289,288,1489
21.08.2018 05:00,1868,47.95,261,256,1607
21.08.2018 06:00,1983,48.91,215,212,1768
21.08.2018 07:00,2243,52.85,162,163,2081
21.08.2018 08:00,2590,62.56,117,122,2473
21.08.2018 09:00,2706,67.94,91,94,2615
21.08.2018 10:00,2761,73.3,94,79,2667
21.08.2018 11:00,2728,71.68,59,71,2669
21.08.2018 12:00,2746,71.01,58,70,2688
21.08.2018 13:00,2692,68.91,59,77,2633
21.08.2018 14:00,2658,67.7,71,88,2587
21.08.2018 15:00,2603,67.92,77,97,2526
21.08.2018 16:00,2549,66.03,83,103,2466
21.08.2018 17:00,2494,67.34,111,109,2383
21.08.2018 18:00,2509,65.43,101,99,2408
21.08.2018 19:00,2453,64.83,85,81,2368
21.08.2018 20:00,2435,65.24,73,66,2362
21.08.2018 21:00,2398,73.4,62,57,2336
21.08.2018 22:00,2385,64.69,59,54,2326
21.08.2018 23:00,2236,56.78,60,58,2176
22.08.2018 00:00,2053,50.71,65,61,1988
22.08.2018 01:00,1949,51.05,61,62,1888
22.08.2018 02:00,1909,49.6,66,65,1843
22.08.2018 03:00,1904,49.27,80,74,1824
22.08.2018 04:00,1867,48.47,94,89,1773
22.08.2018 05:00,1820,48.67,108,109,1712
22.08.2018 06:00,1879,49.1,141,137,1738
22.08.2018 07:00,2124,58.49,176,173,1948
22.08.2018 08:00,2462,68.32,210,197,2252
22.08.2018 09:00,2596,72.2,236,214,2360
22.08.2018 10:00,2666,72.14,245,246,2421
22.08.2018 11:00,2709,68.99,300,293,2409
22.08.2018 12:00,2668,67.89,337,355,2331
22.08.2018 13:00,2633,60.93,390,405,2243
22.08.2018 14:00,2650,57.39,422,441,2228
22.08.2018 15:00,2625,57.1,435,457,2190
22.08.2018 16:00,2589,59.89,429,459,2160
22.08.2018 17:00,2479,56.88,421,461,2058
22.08.2018 18:00,2500,64.14,435,463,2065
22.08.2018 19:00,2479,64.7,447,467,2032
22.08.2018 20:00,2499,58.61,460,482,2039
22.08.2018 21:00,2501,54.35,466,515,2035
22.08.2018 22:00,2466,53.83,493,554,1973
22.08.2018 23:00,2282,49.82,529,584,1753
23.08.2018 00:00,2056,48.06,537,580,1519
23.08.2018 01:00,2001,48.38,534,559,1467
23.08.2018 02:00,1921,47.43,532,550,1389
23.08.2018 03:00,1790,47.3,514,520,1276
23.08.2018 04:00,1740,47.77,492,481,1248
23.08.2018 05:00,1831,47.37,466,439,1365
23.08.2018 06:00,1918,49.31,407,386,1511
23.08.2018 07:00,2184,54.09,342,326,1842
23.08.2018 08:00,2556,62.44,280,260,2276
23.08.2018 09:00,2758,66.42,221,212,2537
23.08.2018 10:00,2831,70.19,190,194,2641
23.08.2018 11:00,2811,68.45,183,194,2628
23.08.2018 12:00,2818,64.96,215,220,2603
23.08.2018 13:00,2737,60.05,249,259,2488
23.08.2018 14:00,2636,56.12,284,300,2352
23.08.2018 15:00,2608,57.41,321,322,2287
23.08.2018 16:00,2573,62.43,336,332,2237
23.08.2018 17:00,2494,66.68,331,331,2163
23.08.2018 18:00,2510,69.91,305,313,2205
23.08.2018 19:00,2440,71.11,285,288,2155
23.08.2018 20:00,2494,72.2,285,285,2209
23.08.2018 21:00,2490,71.24,297,293,2193
23.08.2018 22:00,2408,67.85,301,307,2107
23.08.2018 23:00,2204,59.86,304,324,1900
24.08.2018 00:00,1971,50.31,314,324,1657
24.08.2018 01:00,1874,50.42,334,334,1540
24.08.2018 02:00,1828,50.21,348,345,1480
24.08.2018 03:00,1835,49.73,363,364,1472
24.08.2018 04:00,1806,49.06,385,382,1421
24.08.2018 05:00,1799,48.97,389,383,1410
24.08.2018 06:00,1837,49.62,399,351,1438
24.08.2018 07:00,2070,53.18,351,307,1719
24.08.2018 08:00,2433,60.33,307,262,2126
24.08.2018 09:00,2705,64.98,275,249,2430
24.08.2018 10:00,2790,62.96,239,269,2551
24.08.2018 11:00,2776,57.89,287,312,2489
24.08.2018 12:00,2783,54.87,327,382,2456
24.08.2018 13:00,2660,52.51,356,451,2304
24.08.2018 14:00,2661,51.8,449,516,2212
24.08.2018 15:00,2433,50.63,535,553,1898
24.08.2018 16:00,2392,49.45,506,563,1886
24.08.2018 17:00,2327,49.35,501,588,1826
24.08.2018 18:00,2136,50.15,546,589,1590
24.08.2018 19:00,2106,52.53,541,553,1565
24.08.2018 20:00,2168,53.53,480,504,1688
24.08.2018 21:00,2166,52.85,457,478,1709
24.08.2018 22:00,2106,52.87,441,471,1665
24.08.2018 23:00,1867,50.27,460,475,1407
25.08.2018 00:00,1735,49.5,465,461,1270
25.08.2018 01:00,1676,50.21,426,402,1250
25.08.2018 02:00,1642,49.55,374,370,1268
25.08.2018 03:00,1621,49.1,345,333,1276
25.08.2018 04:00,1626,49.28,317,298,1309
25.08.2018 05:00,1633,49.23,283,268,1350
25.08.2018 06:00,1557,49.38,263,248,1294
25.08.2018 07:00,1578,49.64,245,233,1333
25.08.2018 08:00,1755,51.09,224,222,1531
25.08.2018 09:00,1983,54.62,222,228,1761
25.08.2018 10:00,2125,55.2,223,258,1902
25.08.2018 11:00,2147,54.16,241,299,1906
25.08.2018 12:00,2140,51.76,290,326,1850
25.08.2018 13:00,2185,50.34,326,344,1859
25.08.2018 14:00,2194,49.79,337,357,1857
25.08.2018 15:00,2065,49.61,337,357,1728
25.08.2018 16:00,2014,49.62,329,345,1685
25.08.2018 17:00,2085,50.3,344,329,1741
25.08.2018 18:00,2165,52.2,270,301,1895
25.08.2018 19:00,2196,55.37,220,262,1976
25.08.2018 20:00,2157,57.05,190,225,1967
25.08.2018 21:00,2136,55.93,180,208,1956
25.08.2018 22:00,2101,55.65,172,198,1929
25.08.2018 23:00,1937,53.12,180,194,1757
26.08.2018 00:00,1845,49.88,210,197,1635
26.08.2018 01:00,1703,50.02,134,124,1569
26.08.2018 02:00,1622,49.49,154,147,1468
26.08.2018 03:00,1594,48.89,154,168,1440
26.08.2018 04:00,1578,48.56,177,187,1401
26.08.2018 05:00,1578,48.45,205,206,1373
26.08.2018 06:00,1519,48.24,244,224,1275
26.08.2018 07:00,1510,48.39,261,241,1249
26.08.2018 08:00,1658,49.25,268,257,1390
26.08.2018 09:00,1834,50.26,289,270,1545
26.08.2018 10:00,1959,52.39,282,288,1677
26.08.2018 11:00,1974,54.43,297,312,1677
26.08.2018 12:00,1965,54.77,336,356,1629
26.08.2018 13:00,1984,53.38,388,417,1596
26.08.2018 14:00,1932,52.69,449,481,1483
26.08.2018 15:00,1872,52.1,491,521,1381
26.08.2018 16:00,1924,50.29,509,540,1415
26.08.2018 17:00,1969,50.46,517,549,1452
26.08.2018 18:00,2104,52.02,491,503,1613
26.08.2018 19:00,2219,58.36,416,421,1803
26.08.2018 20:00,2168,58.82,352,342,1816
26.08.2018 21:00,2226,59.91,318,300,1908
26.08.2018 22:00,2156,59.14,279,282,1877
26.08.2018 23:00,1980,53.61,258,263,1722
27.08.2018 00:00,1843,50.15,243,242,1600
27.08.2018 01:00,1718,50,187,185,1531
27.08.2018 02:00,1700,48.67,182,172,1518
27.08.2018 03:00,1684,47.22,183,183,1501
27.08.2018 04:00,1724,45.07,201,210,1523
27.08.2018 05:00,1729,45.08,250,256,1479
27.08.2018 06:00,1806,48.82,306,312,1500
27.08.2018 07:00,2049,51.83,366,381,1683
27.08.2018 08:00,2327,54.95,453,452,1874
27.08.2018 09:00,2543,61.16,515,527,2028
27.08.2018 10:00,2712,60.58,575,618,2137
27.08.2018 11:00,2775,60.04,690,720,2085
27.08.2018 12:00,2843,57.36,775,786,2068
27.08.2018 13:00,2815,55.99,793,817,2022
27.08.2018 14:00,2843,59.13,820,831,2023
27.08.2018 15:00,2867,57.04,828,823,2039
27.08.2018 16:00,2820,55.46,815,798,2005
27.08.2018 17:00,2656,54.05,792,751,1864
27.08.2018 18:00,2639,54.1,739,690,1900
27.08.2018 19:00,2583,57.58,702,638,1881
27.08.2018 20:00,2520,62.18,633,591,1887
27.08.2018 21:00,2501,60.96,538,544,1963
27.08.2018 22:00,2339,59.43,496,506,1843
27.08.2018 23:00,2170,52.89,506,480,1664
28.08.2018 00:00,1959,50.14,490,463,1469
28.08.2018 01:00,1887,52.75,473,448,1414
28.08.2018 02:00,1819,52.04,425,419,1394
28.08.2018 03:00,1822,52.51,400,400,1422
28.08.2018 04:00,1816,52.47,374,394,1442
28.08.2018 05:00,1832,52.33,379,388,1453
28.08.2018 06:00,1945,53.55,357,374,1588
28.08.2018 07:00,2228,62.7,336,353,1892
28.08.2018 08:00,2545,69.73,309,326,2236
28.08.2018 09:00,2707,72.18,292,294,2415
28.08.2018 10:00,2669,72.24,274,269,2395
28.08.2018 11:00,2733,70.53,258,256,2475
28.08.2018 12:00,2746,69.95,243,250,2503
28.08.2018 13:00,2653,66.2,232,250,2421
28.08.2018 14:00,2702,68.65,225,251,2477
28.08.2018 15:00,2695,67.1,218,244,2477
28.08.2018 16:00,2685,68.16,202,223,2483
28.08.2018 17:00,2631,68.74,190,200,2441
28.08.2018 18:00,2608,71.95,157,160,2451
28.08.2018 19:00,2519,73.17,125,120,2394
28.08.2018 20:00,2461,79.52,100,92,2361
28.08.2018 21:00,2501,82.51,84,81,2417
28.08.2018 22:00,2372,72.76,73,76,2299
28.08.2018 23:00,2202,64.96,68,73,2134
29.08.2018 00:00,2006,57.4,64,65,1942
29.08.2018 01:00,1877,56.16,54,61,1823
29.08.2018 02:00,1848,54.11,51,57,1797
29.08.2018 03:00,1840,53.05,43,49,1797
29.08.2018 04:00,1830,52.4,34,39,1796
29.08.2018 05:00,1850,52.51,29,33,1821
29.08.2018 06:00,1975,54.44,24,28,1951
29.08.2018 07:00,2284,65.08,20,25,2264
29.08.2018 08:00,2621,71.95,19,24,2602
29.08.2018 09:00,2729,73.66,25,28,2704
29.08.2018 10:00,2754,73.06,28,37,2726
29.08.2018 11:00,2826,71.1,40,49,2786
29.08.2018 12:00,2815,71.03,56,62,2759
29.08.2018 13:00,2749,67.91,74,78,2675
29.08.2018 14:00,2738,64.99,89,97,2649
29.08.2018 15:00,2717,64.94,106,107,2611
29.08.2018 16:00,2697,68.81,110,114,2587
29.08.2018 17:00,2581,70.07,126,122,2455
29.08.2018 18:00,2566,73.28,131,128,2435
29.08.2018 19:00,2522,75.02,136,133,2386
29.08.2018 20:00,2502,74.9,153,149,2349
29.08.2018 21:00,2510,74.1,180,176,2330
29.08.2018 22:00,2381,66.99,214,212,2167
29.08.2018 23:00,2211,53.93,245,254,1966
30.08.2018 00:00,2010,52.25,270,273,1740
30.08.2018 01:00,1907,51.78,290,309,1617
30.08.2018 02:00,1892,50.3,285,309,1607
30.08.2018 03:00,1881,49.84,279,289,1602
30.08.2018 04:00,1867,49.61,265,266,1602
30.08.2018 05:00,1884,50,242,252,1642
30.08.2018 06:00,2004,52.56,232,253,1772
30.08.2018 07:00,2271,56.47,231,256,2040
30.08.2018 08:00,2599,66.14,215,248,2384
30.08.2018 09:00,2772,70.89,190,225,2582
30.08.2018 10:00,2816,72.35,158,200,2658
30.08.2018 11:00,2861,74.08,125,185,2736
30.08.2018 12:00,2879,76.12,126,185,2753
30.08.2018 13:00,2867,76.29,123,187,2744
30.08.2018 14:00,2857,76.82,136,189,2721
30.08.2018 15:00,2823,74.16,123,186,2700
30.08.2018 16:00,2803,70.36,132,185,2671
30.08.2018 17:00,2729,66.22,149,183,2580
30.08.2018 18:00,2699,63.2,175,185,2524
30.08.2018 19:00,2640,65.49,193,198,2447
30.08.2018 20:00,2636,68.31,217,212,2419
30.08.2018 21:00,2634,69.77,244,231,2390
30.08.2018 22:00,2466,63.7,259,257,2207
30.08.2018 23:00,2294,56.16,274,294,2020
31.08.2018 00:00,2129,53.92,297,329,1832
31.08.2018 01:00,1986,53.87,266,309,1720
31.08.2018 02:00,1921,52.8,297,338,1624
31.08.2018 03:00,1883,52.66,313,366,1570
31.08.2018 04:00,1873,53.04,343,396,1530
31.08.2018 05:00,1884,53.43,378,427,1506
31.08.2018 06:00,2029,55.41,397,449,1632
31.08.2018 07:00,2305,58.94,420,457,1885
31.08.2018 08:00,2638,68.05,409,460,2229
31.08.2018 09:00,2752,71.56,420,461,2332
31.08.2018 10:00,2768,71.79,404,463,2364
31.08.2018 11:00,2797,71.19,400,469,2397
31.08.2018 12:00,2725,71.06,417,477,2308
31.08.2018 13:00,2407,69.09,430,483,1977
31.08.2018 14:00,2629,67.25,436,484,2193
31.08.2018 15:00,2647,66.77,423,482,2224
31.08.2018 16:00,2652,65.6,421,477,2231
31.08.2018 17:00,2590,66.7,417,474,2173
31.08.2018 18:00,2569,68.39,378,461,2191
31.08.2018 19:00,2565,67.99,379,444,2186
31.08.2018 20:00,2521,68.02,373,423,2148
31.08.2018 21:00,2500,68.54,350,404,2150
31.08.2018 22:00,2370,66.37,334,391,2036
31.08.2018 23:00,2212,60.72,318,375,1894
09.01.2018 00:00,2064,56.88,317,353,1747
09.01.2018 01:00,1945,57.58,293,284,1652
09.01.2018 02:00,1858,55.99,280,276,1578
09.01.2018 03:00,1826,55.32,264,266,1562
09.01.2018 04:00,1744,54.26,268,263,1476
09.01.2018 05:00,1709,53.99,268,262,1441
09.01.2018 06:00,1735,54.08,254,254,1481
09.01.2018 07:00,1771,55.69,252,247,1519
09.01.2018 08:00,1915,57.2,242,232,1673
09.01.2018 09:00,2070,60.91,231,215,1839
09.01.2018 10:00,2197,64.9,196,196,2001
09.01.2018 11:00,2241,64.68,186,180,2055
09.01.2018 12:00,2300,64.86,160,164,2140
09.01.2018 13:00,2265,61.98,134,143,2131
09.01.2018 14:00,2222,57.72,109,123,2113
09.01.2018 15:00,2156,57.15,97,104,2059
09.01.2018 16:00,2130,56.93,87,87,2043
09.01.2018 17:00,2111,57.43,88,81,2023
09.01.2018 18:00,2116,61,86,75,2030
09.01.2018 19:00,2138,64.99,83,69,2055
09.01.2018 20:00,2070,64.91,100,67,1970
09.01.2018 21:00,2112,66.88,93,67,2019
09.01.2018 22:00,2052,62.37,79,68,1973
09.01.2018 23:00,1951,57.24,72,67,1879
09.02.2018 00:00,1796,55.41,67,65,1729
09.02.2018 01:00,1696,56.14,69,73,1627
09.02.2018 02:00,1656,55.01,67,70,1589
09.02.2018 03:00,1646,54.07,62,65,1584
09.02.2018 04:00,1645,53.74,56,57,1589
09.02.2018 05:00,1638,53.78,55,54,1583
09.02.2018 06:00,1667,53.77,56,53,1611
09.02.2018 07:00,1674,54.07,53,54,1621
09.02.2018 08:00,1769,54.8,47,53,1722
09.02.2018 09:00,1921,56.23,40,48,1881
09.02.2018 10:00,2034,58.05,29,48,2005
09.02.2018 11:00,2109,58.34,26,52,2083
09.02.2018 12:00,2128,58.13,27,55,2101
09.02.2018 13:00,2117,57.88,32,62,2085
09.02.2018 14:00,2113,56.48,37,68,2076
09.02.2018 15:00,2082,55.89,42,71,2040
09.02.2018 16:00,2051,55.86,43,70,2008
09.02.2018 17:00,2077,56.69,45,70,2032
09.02.2018 18:00,2137,57.62,50,67,2087
09.02.2018 19:00,2192,59.22,55,66,2137
09.02.2018 20:00,2192,61.81,61,68,2131
09.02.2018 21:00,2225,62.77,75,76,2150
09.02.2018 22:00,2114,59.65,90,87,2024
09.02.2018 23:00,1948,56.04,105,100,1843
09.03.2018 00:00,1802,53.86,107,108,1695
09.03.2018 01:00,1760,53.29,113,113,1647
09.03.2018 02:00,1674,52.94,120,111,1554
09.03.2018 03:00,1620,52.53,119,114,1501
09.03.2018 04:00,1666,52.23,122,121,1544
09.03.2018 05:00,1663,52.35,137,132,1526
09.03.2018 06:00,1824,56.11,153,148,1671
09.03.2018 07:00,2131,60.25,160,160,1971
09.03.2018 08:00,2496,69.05,163,167,2333
09.03.2018 09:00,2696,71.79,172,167,2524
09.03.2018 10:00,2700,72.02,174,170,2526
09.03.2018 11:00,2709,71.75,181,177,2528
09.03.2018 12:00,2660,71.83,174,175,2486
09.03.2018 13:00,2637,71.12,156,165,2481
09.03.2018 14:00,2666,68.63,145,153,2521
09.03.2018 15:00,2662,67.05,139,140,2523
09.03.2018 16:00,2632,64.97,129,128,2503
09.03.2018 17:00,2565,66.96,121,117,2444
09.03.2018 18:00,2548,65.99,114,108,2434
09.03.2018 19:00,2459,67.01,107,101,2352
09.03.2018 20:00,2444,67.24,100,100,2344
09.03.2018 21:00,2518,65.94,102,101,2416
09.03.2018 22:00,2371,61.06,97,98,2274
09.03.2018 23:00,2136,57.04,100,98,2036
09.04.2018 00:00,1930,53.8,97,90,1833
09.04.2018 01:00,1838,54.77,93,93,1745
09.04.2018 02:00,1795,54.09,88,88,1707
09.04.2018 03:00,1791,53.29,79,85,1712
09.04.2018 04:00,1793,52.94,81,86,1712
09.04.2018 05:00,1807,53.2,90,90,1717
09.04.2018 06:00,1993,56.3,88,91,1905
09.04.2018 07:00,2325,64.67,90,91,2235
09.04.2018 08:00,2650,70.2,85,88,2565
09.04.2018 09:00,2788,74.47,77,83,2711
09.04.2018 10:00,2774,74.02,65,81,2709
09.04.2018 11:00,2818,73.92,56,81,2762
09.04.2018 12:00,2822,73.46,58,84,2764
09.04.2018 13:00,2812,71.06,56,87,2756
09.04.2018 14:00,2770,69.02,56,89,2714
09.04.2018 15:00,2760,68.81,68,86,2692
09.04.2018 16:00,2719,68.55,67,78,2652
09.04.2018 17:00,2654,70.01,56,74,2598
09.04.2018 18:00,2669,69.97,57,66,2612
09.04.2018 19:00,2634,69.99,54,62,2580
09.04.2018 20:00,2627,71.45,58,62,2569
09.04.2018 21:00,2698,73.05,60,64,2638
09.04.2018 22:00,2542,65.2,56,65,2486
09.04.2018 23:00,2329,60.89,55,68,2274
09.05.2018 00:00,2114,57.06,56,68,2058
09.05.2018 01:00,1951,55.72,42,44,1909
09.05.2018 02:00,1877,54.47,43,46,1834
09.05.2018 03:00,1822,53.56,46,48,1776
09.05.2018 04:00,1825,53.38,49,52,1776
09.05.2018 05:00,1859,54.04,54,57,1805
09.05.2018 06:00,1998,57,54,57,1944
09.05.2018 07:00,2302,65.87,48,52,2254
09.05.2018 08:00,2616,69.96,40,46,2576
09.05.2018 09:00,2705,74,34,42,2671
09.05.2018 10:00,2737,73.54,27,41,2710
09.05.2018 11:00,2778,71.96,24,39,2754
09.05.2018 12:00,2782,70.97,23,40,2759
09.05.2018 13:00,2723,66.91,24,42,2699
09.05.2018 14:00,2709,64.74,26,46,2683
09.05.2018 15:00,2700,64.55,25,48,2675
09.05.2018 16:00,2667,67,29,47,2638
09.05.2018 17:00,2593,69.55,32,48,2561
09.05.2018 18:00,2612,70.82,35,46,2577
09.05.2018 19:00,2574,69.46,37,43,2537
09.05.2018 20:00,2595,71.99,39,44,2556
09.05.2018 21:00,2634,70.02,41,46,2593
09.05.2018 22:00,2460,63.9,41,45,2419
09.05.2018 23:00,2234,60.32,42,42,2192
09.06.2018 00:00,2037,57.43,43,41,1994
09.06.2018 01:00,1911,55.11,48,49,1863
09.06.2018 02:00,1849,53.87,50,53,1799
09.06.2018 03:00,1837,53.11,58,59,1779
09.06.2018 04:00,1841,52.99,65,65,1776
09.06.2018 05:00,1880,53.66,75,74,1805
09.06.2018 06:00,2021,55.99,86,85,1935
09.06.2018 07:00,2350,65.03,88,94,2262
09.06.2018 08:00,2681,72.01,98,106,2583
09.06.2018 09:00,2798,74.95,108,112,2690
09.06.2018 10:00,2825,73.78,112,120,2713
09.06.2018 11:00,2860,70.07,107,133,2753
09.06.2018 12:00,2841,68.91,110,151,2731
09.06.2018 13:00,2774,66.88,135,168,2639
09.06.2018 14:00,2720,64.8,161,186,2559
09.06.2018 15:00,2677,68.36,188,198,2489
09.06.2018 16:00,2681,67.84,204,205,2477
09.06.2018 17:00,2614,69.38,206,210,2408
09.06.2018 18:00,2600,69.98,212,214,2388
09.06.2018 19:00,2502,68.95,238,217,2264
09.06.2018 20:00,2466,69.45,246,224,2220
09.06.2018 21:00,2496,64.6,265,248,2231
09.06.2018 22:00,2381,62.12,305,281,2076
09.06.2018 23:00,2179,57.51,334,313,1845
09.07.2018 00:00,1943,54.65,348,325,1595
09.07.2018 01:00,1906,54.57,347,332,1559
09.07.2018 02:00,1820,53.69,346,331,1474
09.07.2018 03:00,1763,53.38,334,330,1429
09.07.2018 04:00,1786,53.37,338,325,1448
09.07.2018 05:00,1841,53.66,342,325,1499
09.07.2018 06:00,1919,55.37,346,335,1573
09.07.2018 07:00,2257,60.78,364,348,1893
09.07.2018 08:00,2598,66.09,380,355,2218
09.07.2018 09:00,2725,73.76,371,350,2354
09.07.2018 10:00,2741,72.42,380,343,2361
09.07.2018 11:00,2759,70.94,377,340,2382
09.07.2018 12:00,2724,69.59,376,335,2348
09.07.2018 13:00,2690,64.05,394,329,2296
09.07.2018 14:00,2632,58.92,382,320,2250
09.07.2018 15:00,2546,57.16,355,310,2191
09.07.2018 16:00,2500,56.5,352,302,2148
09.07.2018 17:00,2457,57.41,298,294,2159
09.07.2018 18:00,2473,59.07,270,282,2203
09.07.2018 19:00,2377,60.79,256,267,2121
09.07.2018 20:00,2376,59.88,263,258,2113
09.07.2018 21:00,2317,58.83,310,254,2007
09.07.2018 22:00,2162,57.91,298,249,1864
09.07.2018 23:00,2037,55.46,300,262,1737
09.08.2018 00:00,1886,53.34,297,278,1589
09.08.2018 01:00,1811,53.97,292,289,1519
09.08.2018 02:00,1750,53.64,280,284,1470
09.08.2018 03:00,1761,52.76,275,270,1486
09.08.2018 04:00,1748,50.99,275,256,1473
09.08.2018 05:00,1737,50.39,241,251,1496
09.08.2018 06:00,1710,51.02,259,255,1451
09.08.2018 07:00,1726,52.08,258,263,1468
09.08.2018 08:00,1851,53.47,290,272,1561
09.08.2018 09:00,2026,55.7,302,300,1724
09.08.2018 10:00,2131,55.66,361,352,1770
09.08.2018 11:00,2122,56.45,444,414,1678
09.08.2018 12:00,2098,56.22,451,450,1647
09.08.2018 13:00,2065,54.91,496,474,1569
09.08.2018 14:00,1970,54.57,532,493,1438
09.08.2018 15:00,1885,54.28,527,483,1358
09.08.2018 16:00,1893,54.27,512,458,1381
09.08.2018 17:00,1966,54.5,483,424,1483
09.08.2018 18:00,2067,55.68,423,372,1644
09.08.2018 19:00,2151,57.26,345,321,1806
09.08.2018 20:00,2183,57.87,305,283,1878
09.08.2018 21:00,2152,57.57,278,263,1874
09.08.2018 22:00,2036,56.8,255,245,1781
09.08.2018 23:00,1913,55.39,242,237,1671
09.09.2018 00:00,1806,53.65,230,239,1576
09.09.2018 01:00,1728,53.57,227,241,1501
09.09.2018 02:00,1596,51.22,225,234,1371
09.09.2018 03:00,1509,50.63,234,238,1275
09.09.2018 04:00,1489,50.6,264,252,1225
09.09.2018 05:00,1522,50.62,287,269,1235
09.09.2018 06:00,1568,50.48,293,277,1275
09.09.2018 07:00,1569,50.55,297,283,1272
09.09.2018 08:00,1664,51.74,299,288,1365
09.09.2018 09:00,1829,52.96,307,291,1522
09.09.2018 10:00,2015,54.22,315,310,1700
09.09.2018 11:00,2072,55.51,344,349,1728
09.09.2018 12:00,2111,55.33,355,379,1756
09.09.2018 13:00,2090,55.03,382,396,1708
09.09.2018 14:00,2110,54.6,395,405,1715
09.09.2018 15:00,2108,54.23,394,396,1714
09.09.2018 16:00,2081,54.01,364,371,1717
09.09.2018 17:00,2102,54.14,331,342,1771
09.09.2018 18:00,2188,55.75,304,307,1884
09.09.2018 19:00,2273,57.3,272,275,2001
09.09.2018 20:00,2300,58.55,254,257,2046
09.09.2018 21:00,2298,58.48,255,258,2043
09.09.2018 22:00,2180,57.74,244,259,1936
09.09.2018 23:00,2053,55.82,251,262,1802
09.10.2018 00:00,1920,53.11,258,267,1662
09.10.2018 01:00,1841,53.47,267,280,1574
09.10.2018 02:00,1782,50.9,274,289,1508
09.10.2018 03:00,1748,49.52,292,303,1456
09.10.2018 04:00,1770,48.06,316,324,1454
09.10.2018 05:00,1782,49.1,341,348,1441
09.10.2018 06:00,1891,54.01,373,376,1518
09.10.2018 07:00,2204,56.84,412,407,1792
09.10.2018 08:00,2534,58.1,441,430,2093
09.10.2018 09:00,2733,59.19,437,435,2296
09.10.2018 10:00,2858,59.31,440,439,2418
09.10.2018 11:00,2900,59.15,436,449,2464
09.10.2018 12:00,2897,58.31,409,449,2488
09.10.2018 13:00,2875,57.59,392,439,2483
09.10.2018 14:00,2842,56.82,380,425,2462
09.10.2018 15:00,2747,57.13,361,413,2386
09.10.2018 16:00,2753,56.86,348,400,2405
09.10.2018 17:00,2726,57.12,335,386,2391
09.10.2018 18:00,2703,57.44,302,351,2401
09.10.2018 19:00,2591,57.52,272,300,2319
09.10.2018 20:00,2605,58.19,263,270,2342
09.10.2018 21:00,2612,79.93,247,264,2365
09.10.2018 22:00,2444,56.36,254,260,2190
09.10.2018 23:00,2178,55.33,236,252,1942
09.11.2018 00:00,2034,54.13,242,239,1792
09.11.2018 01:00,1854,53.4,242,245,1612
09.11.2018 02:00,1854,51.28,236,239,1618
09.11.2018 03:00,1863,48.59,241,240,1622
09.11.2018 04:00,1849,46.9,243,250,1606
09.11.2018 05:00,1888,48.06,264,264,1624
09.11.2018 06:00,2014,52.65,272,274,1742
09.11.2018 07:00,2329,57.03,271,286,2058
09.11.2018 08:00,2594,72.5,296,295,2298
09.11.2018 09:00,2700,69.97,346,329,2354
09.11.2018 10:00,2711,66.59,393,392,2318
09.11.2018 11:00,2807,65.09,463,475,2344
09.11.2018 12:00,2832,62.8,563,576,2269
09.11.2018 13:00,2863,61.89,687,684,2176
09.11.2018 14:00,2800,59.62,799,797,2001
09.11.2018 15:00,2698,57.42,905,910,1793
09.11.2018 16:00,2749,57.4,1030,1020,1719
09.11.2018 17:00,2757,57.92,1118,1102,1639
09.11.2018 18:00,2099,57.3,1172,1136,927
09.11.2018 19:00,1423,57.36,1167,1118,256
09.11.2018 20:00,1401,58.09,1144,1083,257
09.11.2018 21:00,1358,57.28,1101,1039,257
09.11.2018 22:00,1297,56.65,1057,989,240
09.11.2018 23:00,1255,54.36,1025,943,230
09.12.2018 00:00,1220,50.94,992,907,228
09.12.2018 01:00,2029,48.32,1013,1005,1016
09.12.2018 02:00,1939,47.14,967,962,972
09.12.2018 03:00,1880,45.97,911,911,969
09.12.2018 04:00,1896,47.15,857,856,1039
09.12.2018 05:00,1911,47.73,818,807,1093
09.12.2018 06:00,2081,51.15,775,772,1306
09.12.2018 07:00,2411,53.86,744,747,1667
09.12.2018 08:00,2677,56.44,744,737,1933
09.12.2018 09:00,2796,57.93,774,771,2022
09.12.2018 10:00,2844,57.05,831,835,2013
09.12.2018 11:00,2804,56.53,875,905,1929
09.12.2018 12:00,2732,56.15,950,934,1782
09.12.2018 13:00,2664,56.26,921,917,1743
09.12.2018 14:00,2686,55.53,972,899,1714
09.12.2018 15:00,2640,54.74,959,893,1681
09.12.2018 16:00,2620,54.13,906,894,1714
09.12.2018 17:00,2637,54.09,913,904,1724
09.12.2018 18:00,2668,54.6,921,889,1747
09.12.2018 19:00,2662,54.88,880,852,1782
09.12.2018 20:00,2662,55.6,860,820,1802
09.12.2018 21:00,2633,54.88,839,819,1794
09.12.2018 22:00,2476,54.26,847,834,1629
09.12.2018 23:00,2254,52.06,853,849,1401
13.09.2018 00:00,2090,49.55,849,844,1241
13.09.2018 01:00,2011,50.53,838,818,1173
13.09.2018 02:00,1996,50.12,777,774,1219
13.09.2018 03:00,1996,50.12,708,714,1288
13.09.2018 04:00,1970,50.65,629,642,1341
13.09.2018 05:00,2037,51.81,547,568,1490
13.09.2018 06:00,2212,53.39,495,514,1717
13.09.2018 07:00,2479,62.88,454,467,2025
13.09.2018 08:00,2736,79.38,405,421,2331
13.09.2018 09:00,2914,81.9,369,382,2545
13.09.2018 10:00,2855,78.02,375,372,2480
13.09.2018 11:00,2746,77,380,389,2366
13.09.2018 12:00,2742,75.88,383,419,2359
13.09.2018 13:00,2738,74.82,392,444,2346
13.09.2018 14:00,2741,73.51,389,459,2352
13.09.2018 15:00,2659,73.13,377,450,2282
13.09.2018 16:00,2700,72.3,391,421,2309
13.09.2018 17:00,2673,71.18,366,390,2307
13.09.2018 18:00,2658,73.88,334,344,2324
13.09.2018 19:00,2669,75.87,304,306,2365
13.09.2018 20:00,2683,77.3,299,289,2384
13.09.2018 21:00,2654,80.45,312,305,2342
13.09.2018 22:00,2481,73.18,334,335,2147
13.09.2018 23:00,2281,55.89,364,366,1917
14.09.2018 00:00,2052,53.65,394,387,1658
14.09.2018 01:00,1988,53.24,421,446,1567
14.09.2018 02:00,1909,52,450,465,1459
14.09.2018 03:00,1863,51.57,458,468,1405
14.09.2018 04:00,1858,50.81,457,465,1401
14.09.2018 05:00,1831,51.11,459,461,1372
14.09.2018 06:00,1945,54.76,446,453,1499
14.09.2018 07:00,2314,63.59,460,445,1854
14.09.2018 08:00,2641,74.13,459,434,2182
14.09.2018 09:00,2783,76.57,437,428,2346
14.09.2018 10:00,2840,76.58,439,445,2401
14.09.2018 11:00,2866,75.59,426,470,2440
14.09.2018 12:00,2815,74.14,422,483,2393
14.09.2018 13:00,2691,69.58,414,487,2277
14.09.2018 14:00,2671,63.62,490,488,2181
14.09.2018 15:00,2602,57.51,512,487,2090
14.09.2018 16:00,2499,56.39,460,477,2039
14.09.2018 17:00,2438,56.92,464,471,1974
14.09.2018 18:00,2477,60.78,463,455,2014
14.09.2018 19:00,2426,71.16,427,434,1999
14.09.2018 20:00,2413,73.11,401,432,2012
14.09.2018 21:00,2375,58.5,424,450,1951
14.09.2018 22:00,2159,55.14,457,479,1702
14.09.2018 23:00,2026,52.28,496,508,1530
15.09.2018 00:00,1948,50.09,532,542,1416
15.09.2018 01:00,1947,49.65,668,679,1279
15.09.2018 02:00,1809,48.6,690,702,1119
15.09.2018 03:00,1723,46.04,698,697,1025
15.09.2018 04:00,1735,44.26,678,676,1057
15.09.2018 05:00,1797,43.86,633,648,1164
15.09.2018 06:00,1797,44.51,610,617,1187
15.09.2018 07:00,1856,46.81,569,578,1287
15.09.2018 08:00,1943,48.87,500,525,1443
15.09.2018 09:00,2113,50.38,467,482,1646
15.09.2018 10:00,2232,52.02,450,445,1782
15.09.2018 11:00,2289,51.57,435,428,1854
15.09.2018 12:00,2251,51.35,461,444,1790
15.09.2018 13:00,2151,50.2,492,484,1659
15.09.2018 14:00,2115,48.16,518,537,1597
15.09.2018 15:00,2055,47.64,549,575,1506
15.09.2018 16:00,2098,47.8,592,598,1506
15.09.2018 17:00,2173,48.1,587,604,1586
15.09.2018 18:00,2282,50.33,572,584,1710
15.09.2018 19:00,2356,57.29,535,541,1821
15.09.2018 20:00,2319,67.13,506,510,1813
15.09.2018 21:00,2213,67.35,491,494,1722
15.09.2018 22:00,2129,51.63,475,488,1654
15.09.2018 23:00,2007,50.41,476,481,1531
16.09.2018 00:00,1850,49.19,453,465,1397
16.09.2018 01:00,1818,51.87,411,420,1407
16.09.2018 02:00,1769,49.87,392,397,1377
16.09.2018 03:00,1714,46.28,380,377,1334
16.09.2018 04:00,1706,43.59,363,356,1343
16.09.2018 05:00,1705,43.75,339,329,1366
16.09.2018 06:00,1727,44.17,307,298,1420
16.09.2018 07:00,1754,44.17,270,262,1484
16.09.2018 08:00,1850,48.14,239,229,1611
16.09.2018 09:00,2024,50.33,202,201,1822
16.09.2018 10:00,2203,53.19,188,188,2015
16.09.2018 11:00,2190,54.27,205,204,1985
16.09.2018 12:00,2171,54.24,242,250,1929
16.09.2018 13:00,2167,53.27,292,307,1875
16.09.2018 14:00,2153,52.9,349,360,1804
16.09.2018 15:00,2185,52.22,382,393,1803
16.09.2018 16:00,2216,51.93,391,407,1825
16.09.2018 17:00,2259,52.1,401,416,1858
16.09.2018 18:00,2349,53.09,422,424,1927
16.09.2018 19:00,2415,57.14,439,448,1976
16.09.2018 20:00,2459,57.92,489,494,1970
16.09.2018 21:00,2381,55.83,563,553,1818
16.09.2018 22:00,2178,52.79,620,617,1558
16.09.2018 23:00,2021,50.37,676,679,1345
17.09.2018 00:00,1922,47.43,727,728,1195
17.09.2018 01:00,1850,44.2,826,807,1024
17.09.2018 02:00,1734,43.08,860,851,874
17.09.2018 03:00,1742,43.04,891,875,851
17.09.2018 04:00,1757,41.74,899,879,858
17.09.2018 05:00,1826,42.91,873,867,953
17.09.2018 06:00,2011,49.05,833,829,1178
17.09.2018 07:00,2416,60.42,776,777,1640
17.09.2018 08:00,2684,66.96,694,711,1990
17.09.2018 09:00,2814,72.02,664,668,2150
17.09.2018 10:00,2859,70.93,644,651,2215
17.09.2018 11:00,2866,70.22,622,645,2244
17.09.2018 12:00,2872,61.8,602,627,2270
17.09.2018 13:00,2826,58.6,555,595,2271
17.09.2018 14:00,2818,55.55,520,556,2298
17.09.2018 15:00,2771,55.38,473,499,2298
17.09.2018 16:00,2806,57.05,414,431,2392
17.09.2018 17:00,2789,66.37,341,372,2448
17.09.2018 18:00,2860,73.2,294,297,2566
17.09.2018 19:00,2808,74.8,240,235,2568
17.09.2018 20:00,2781,89.12,203,201,2578
17.09.2018 21:00,2691,79.86,192,183,2499
17.09.2018 22:00,2441,68.34,193,166,2248
17.09.2018 23:00,2174,59.55,189,159,1985
18.09.2018 00:00,1978,48.89,203,161,1775
18.09.2018 01:00,1916,50,267,272,1649
18.09.2018 02:00,1853,48.45,285,287,1568
18.09.2018 03:00,1864,45.55,321,322,1543
18.09.2018 04:00,1864,45.03,356,356,1508
18.09.2018 05:00,1908,45.51,374,386,1534
18.09.2018 06:00,2091,49.07,379,397,1712
18.09.2018 07:00,2410,57.25,375,392,2035
18.09.2018 08:00,2654,71.92,373,380,2281
18.09.2018 09:00,2776,73.96,335,342,2441
18.09.2018 10:00,2843,72.99,300,302,2543
18.09.2018 11:00,2852,69.47,293,292,2559
18.09.2018 12:00,2805,65.26,317,325,2488
18.09.2018 13:00,2737,60.17,372,382,2365
18.09.2018 14:00,2676,55.44,422,436,2254
18.09.2018 15:00,2560,54.96,489,468,2071
18.09.2018 16:00,2530,54.3,524,488,2006
18.09.2018 17:00,2511,55.68,526,506,1985
18.09.2018 18:00,2573,59.15,543,539,2030
18.09.2018 19:00,2505,59.72,598,612,1907
18.09.2018 20:00,2533,59.99,665,699,1868
18.09.2018 21:00,2510,55.09,734,741,1776
18.09.2018 22:00,2289,51.87,794,750,1495
18.09.2018 23:00,2182,48.56,728,754,1454
19.09.2018 00:00,2100,44.72,679,707,1421
19.09.2018 01:00,1999,44.04,614,659,1385
19.09.2018 02:00,1933,41.23,583,604,1350
19.09.2018 03:00,1898,41.28,550,571,1348
19.09.2018 04:00,1889,41.69,539,551,1350
19.09.2018 05:00,1909,42.84,522,537,1387
19.09.2018 06:00,2051,46.19,516,516,1535
19.09.2018 07:00,2321,56.2,482,491,1839
19.09.2018 08:00,2594,68.23,472,473,2122
19.09.2018 09:00,2757,74.22,441,455,2316
19.09.2018 10:00,2843,58.03,419,448,2424
19.09.2018 11:00,2845,55.97,410,459,2435
19.09.2018 12:00,2806,55.91,455,494,2351
19.09.2018 13:00,2789,51.92,524,547,2265
19.09.2018 14:00,2698,50.74,580,598,2118
19.09.2018 15:00,2588,50.26,614,604,1974
19.09.2018 16:00,2645,50.67,589,592,2056
19.09.2018 17:00,2659,51.63,584,578,2075
19.09.2018 18:00,2731,55.46,580,568,2151
19.09.2018 19:00,2725,55.28,575,571,2150
19.09.2018 20:00,2770,55.92,581,595,2189
19.09.2018 21:00,2653,51.08,650,649,2003
19.09.2018 22:00,2373,48.52,711,715,1662
19.09.2018 23:00,2263,43.12,746,778,1517
20.09.2018 00:00,2115,37.58,778,819,1337
20.09.2018 01:00,2022,37.12,824,835,1198
20.09.2018 02:00,1969,31.16,850,867,1119
20.09.2018 03:00,1946,29.58,885,881,1061
20.09.2018 04:00,1936,31.76,902,878,1034
20.09.2018 05:00,1953,33.52,880,861,1073
20.09.2018 06:00,2098,41.26,808,819,1290
20.09.2018 07:00,2444,47.68,732,771,1712
20.09.2018 08:00,2680,49.23,711,729,1969
20.09.2018 09:00,2818,49.64,714,716,2104
20.09.2018 10:00,2897,48.51,741,747,2156
20.09.2018 11:00,2889,46.5,810,798,2079
20.09.2018 12:00,2943,45.68,837,845,2106
20.09.2018 13:00,2964,45,793,862,2171
20.09.2018 14:00,2952,44.71,731,848,2221
20.09.2018 15:00,2841,44.5,703,800,2138
20.09.2018 16:00,2780,44.89,638,731,2142
20.09.2018 17:00,2828,46.04,581,662,2247
20.09.2018 18:00,2918,47.12,530,587,2388
20.09.2018 19:00,2884,47.61,493,523,2391
20.09.2018 20:00,3015,77.74,441,481,2574
20.09.2018 21:00,2920,77,411,444,2509
20.09.2018 22:00,2716,47.12,374,403,2342
20.09.2018 23:00,2436,44.21,360,376,2076
21.09.2018 00:00,2129,41.86,373,393,1756
21.09.2018 01:00,1924,40.02,416,442,1508
21.09.2018 02:00,1921,34.02,509,528,1412
21.09.2018 03:00,1872,25.48,578,589,1294
21.09.2018 04:00,1867,25.73,634,646,1233
21.09.2018 05:00,1834,26.29,686,702,1148
21.09.2018 06:00,1938,34.05,755,757,1183
21.09.2018 07:00,2182,42.85,824,818,1358
21.09.2018 08:00,2422,46.68,902,881,1520
21.09.2018 09:00,2587,48.89,956,939,1631
21.09.2018 10:00,2673,46.48,1012,1011,1661
21.09.2018 11:00,2717,45.04,1078,1092,1639
21.09.2018 12:00,2701,43.37,1158,1170,1543
21.09.2018 13:00,2635,41.22,1211,1230,1424
21.09.2018 14:00,2617,38.13,1248,1270,1369
21.09.2018 15:00,2594,39.43,1288,1308,1306
21.09.2018 16:00,2638,37.37,1316,1352,1322
21.09.2018 17:00,2736,38.24,1344,1381,1392
21.09.2018 18:00,2911,40.07,1314,1389,1597
21.09.2018 19:00,2733,43.45,1289,1374,1444
21.09.2018 20:00,2740,43.49,1263,1356,1477
21.09.2018 21:00,2639,37.98,1260,1352,1379
21.09.2018 22:00,2426,34.65,1282,1368,1144
21.09.2018 23:00,2210,22.17,1317,1386,893
22.09.2018 00:00,2084,2.4,1364,1399,720
22.09.2018 01:00,1932,3.98,1342,1344,590
22.09.2018 02:00,1893,3.06,1361,1369,532
22.09.2018 03:00,1883,2.42,1359,1368,524
22.09.2018 04:00,1869,2.33,1346,1352,523
22.09.2018 05:00,1835,2.82,1320,1329,515
22.09.2018 06:00,1821,3.52,1301,1306,520
22.09.2018 07:00,1945,16.43,1277,1283,668
22.09.2018 08:00,2083,23.53,1258,1261,825
22.09.2018 09:00,2229,32.04,1250,1262,979
22.09.2018 10:00,2355,31.68,1263,1284,1092
22.09.2018 11:00,2378,31.86,1266,1308,1112
22.09.2018 12:00,2362,31.39,1284,1315,1078
22.09.2018 13:00,2359,28.6,1271,1301,1088
22.09.2018 14:00,2412,23.95,1246,1282,1166
22.09.2018 15:00,2437,23.07,1239,1254,1198
22.09.2018 16:00,2479,22.21,1193,1213,1286
22.09.2018 17:00,2443,23.89,1140,1165,1303
22.09.2018 18:00,2485,31.54,1113,1129,1372
22.09.2018 19:00,2561,36.52,1057,1106,1504
22.09.2018 20:00,2554,37.7,1082,1094,1472
22.09.2018 21:00,2356,35.48,1102,1106,1254
22.09.2018 22:00,2235,31.96,1125,1135,1110
22.09.2018 23:00,2101,25.94,1150,1156,951
23.09.2018 00:00,1947,21.04,1156,1161,791
23.09.2018 01:00,1974,22.09,1229,2155,745
23.09.2018 02:00,1888,12.97,1207,2118,681
23.09.2018 03:00,1884,10.03,1183,2080,701
23.09.2018 04:00,1907,17,1163,2045,744
23.09.2018 05:00,1916,22.8,1148,2013,768
23.09.2018 06:00,1935,30.84,1117,1971,818
23.09.2018 07:00,2015,34.94,1081,1919,934
23.09.2018 08:00,2084,36.08,1044,1859,1040
23.09.2018 09:00,2244,42.05,1035,1825,1209
23.09.2018 10:00,2262,43.71,1040,1831,1222
23.09.2018 11:00,2266,44.41,1049,1839,1217
23.09.2018 12:00,2285,44.32,1019,1794,1266
23.09.2018 13:00,2309,43.83,984,1721,1325
23.09.2018 14:00,2279,43.69,916,1512,1363
23.09.2018 15:00,2343,43.57,857,1407,1486
23.09.2018 16:00,2367,42.76,786,1278,1581
23.09.2018 17:00,2379,43.02,683,1052,1696
23.09.2018 18:00,2523,43.85,585,921,1938
23.09.2018 19:00,2665,46.84,521,802,2144
23.09.2018 20:00,2712,48.21,459,726,2253
23.09.2018 21:00,2535,46.88,450,702,2085
23.09.2018 22:00,2400,44.01,445,703,1955
23.09.2018 23:00,2204,42.47,472,707,1732
24.09.2018 00:00,2019,36.94,507,724,1512
24.09.2018 01:00,1925,25.53,518,730,1407
24.09.2018 02:00,1994,18.13,528,756,1466
24.09.2018 03:00,1979,3.97,564,782,1415
24.09.2018 04:00,1952,4.4,549,818,1403
24.09.2018 05:00,1955,19.69,607,848,1348
24.09.2018 06:00,2170,37.02,586,859,1584
24.09.2018 07:00,2595,44.88,603,854,1992
24.09.2018 08:00,2847,47.77,594,828,2253
24.09.2018 09:00,3009,49.64,548,789,2461
24.09.2018 10:00,3042,48.41,560,775,2482
24.09.2018 11:00,2962,47.96,571,793,2391
24.09.2018 12:00,2888,47.1,585,855,2303
24.09.2018 13:00,2800,47.21,605,946,2195
24.09.2018 14:00,2874,46.6,661,1042,2213
24.09.2018 15:00,2775,45.1,701,1111,2074
24.09.2018 16:00,2713,45.09,779,1145,1934
24.09.2018 17:00,2702,45.08,780,1158,1922
24.09.2018 18:00,2829,48.14,736,1126,2093
24.09.2018 19:00,2924,48.23,726,1050,2198
24.09.2018 20:00,2988,48.85,647,969,2341
24.09.2018 21:00,2858,48.63,595,884,2263
24.09.2018 22:00,2586,46.09,588,802,1998
24.09.2018 23:00,2345,42.77,539,728,1806
25.09.2018 00:00,2189,39.22,480,669,1709
25.09.2018 01:00,2159,37.96,462,474,1697
25.09.2018 02:00,2144,38.06,405,419,1739
25.09.2018 03:00,2125,38.13,372,386,1753
25.09.2018 04:00,2135,38.64,357,363,1778
25.09.2018 05:00,2128,39.22,383,343,1745
25.09.2018 06:00,2268,45.19,345,327,1923
25.09.2018 07:00,2737,49.47,281,294,2456
25.09.2018 08:00,3014,49.52,262,265,2752
25.09.2018 09:00,3150,70.49,252,219,2898
25.09.2018 10:00,3123,66.96,214,181,2909
25.09.2018 11:00,3084,63.78,178,169,2906
25.09.2018 12:00,3004,60.2,183,200,2821
25.09.2018 13:00,2837,54.03,236,262,2601
25.09.2018 14:00,2852,49.32,299,333,2553
25.09.2018 15:00,2883,47.05,361,396,2522
25.09.2018 16:00,2851,46.9,424,453,2427
25.09.2018 17:00,2705,48.01,464,499,2241
25.09.2018 18:00,2800,47.27,481,534,2319
25.09.2018 19:00,2897,48.54,511,552,2386
25.09.2018 20:00,2991,48.57,544,586,2447
25.09.2018 21:00,2840,46.7,599,639,2241
25.09.2018 22:00,2607,42.81,664,661,1943
25.09.2018 23:00,2436,38.02,723,723,1713
26.09.2018 00:00,2263,34.47,788,791,1475
26.09.2018 01:00,2171,25.32,907,893,1264
26.09.2018 02:00,2116,16.26,982,979,1134
26.09.2018 03:00,2127,10.09,1072,1066,1055
26.09.2018 04:00,2103,6.28,1153,1152,950
26.09.2018 05:00,2134,3.88,1226,1229,908
26.09.2018 06:00,2312,19.04,1288,1290,1024
26.09.2018 07:00,2684,35,1330,1339,1354
26.09.2018 08:00,2978,38.93,1363,1373,1615
26.09.2018 09:00,3080,39.1,1384,1392,1696
26.09.2018 10:00,3114,38.96,1388,1410,1726
26.09.2018 11:00,3163,38.9,1393,1426,1770
26.09.2018 12:00,3171,37.14,1400,1431,1771
26.09.2018 13:00,3123,35.03,1409,1433,1714
26.09.2018 14:00,3054,31.98,1400,1434,1654
26.09.2018 15:00,3049,30.82,1403,1430,1646
26.09.2018 16:00,3093,33.95,1420,1427,1673
26.09.2018 17:00,3017,36.24,1418,1418,1599
26.09.2018 18:00,3008,37.47,1403,1407,1605
26.09.2018 19:00,3003,38,1399,1397,1604
26.09.2018 20:00,2981,38.52,1383,1384,1598
26.09.2018 21:00,2860,37.9,1368,1374,1492
26.09.2018 22:00,2690,35.2,1352,1363,1338
26.09.2018 23:00,2488,30,1333,1349,1155
27.09.2018 00:00,2338,21.61,1312,1331,1026
27.09.2018 01:00,2166,18.67,1258,1246,908
27.09.2018 02:00,2077,14.49,1216,1202,861
27.09.2018 03:00,2100,17.98,1173,1163,927
27.09.2018 04:00,2084,22.54,1147,1129,937
27.09.2018 05:00,2116,17.46,1104,1094,1012
27.09.2018 06:00,2204,29.43,1062,1037,1142
27.09.2018 07:00,2598,39.33,989,956,1609
27.09.2018 08:00,2894,43.91,893,867,2001
27.09.2018 09:00,3066,43.91,816,832,2250
27.09.2018 10:00,3131,42.33,799,856,2332
27.09.2018 11:00,3216,41.73,842,935,2374
27.09.2018 12:00,3269,42.56,918,1038,2351
27.09.2018 13:00,3149,41.41,1024,1127,2125
27.09.2018 14:00,3020,39.72,1141,1204,1879
27.09.2018 15:00,2979,39.13,1243,1273,1736
27.09.2018 16:00,2978,39.47,1301,1314,1677
27.09.2018 17:00,2882,39.53,1333,1341,1549
27.09.2018 18:00,2892,39.37,1353,1365,1539
27.09.2018 19:00,2871,41.73,1377,1382,1494
27.09.2018 20:00,2939,43.91,1393,1398,1546
27.09.2018 21:00,2823,42.76,1399,1403,1424
27.09.2018 22:00,2621,40,1400,1401,1221
27.09.2018 23:00,2457,36,1400,1396,1057
28.09.2018 00:00,2248,30.41,1387,1379,861
28.09.2018 01:00,2199,32.78,1373,1378,826
28.09.2018 02:00,2128,29.91,1336,1350,792
28.09.2018 03:00,2076,26.07,1298,1307,778
28.09.2018 04:00,2104,28.54,1234,1244,870
28.09.2018 05:00,2163,28.87,1160,1157,1003
28.09.2018 06:00,2339,35.65,1037,1046,1302
28.09.2018 07:00,2697,40.2,893,924,1804
28.09.2018 08:00,2914,44.44,766,790,2148
28.09.2018 09:00,2986,45.48,659,677,2327
28.09.2018 10:00,3043,45.06,592,605,2451
28.09.2018 11:00,3022,44.91,538,555,2484
28.09.2018 12:00,2972,44.1,537,543,2435
28.09.2018 13:00,2803,42.07,528,567,2275
28.09.2018 14:00,2658,41.41,584,623,2074
28.09.2018 15:00,2546,39.87,655,679,1891
28.09.2018 16:00,2432,38.99,704,717,1728
28.09.2018 17:00,2364,38.49,739,735,1625
28.09.2018 18:00,2522,40.28,698,696,1824
28.09.2018 19:00,2725,44.13,585,618,2140
28.09.2018 20:00,2770,44.65,501,547,2269
28.09.2018 21:00,2697,44.64,429,481,2268
28.09.2018 22:00,2478,43.95,394,431,2084
28.09.2018 23:00,2401,43.77,361,385,2040
29.09.2018 00:00,2300,42.98,337,344,1963
29.09.2018 01:00,2198,42.91,258,255,1940
29.09.2018 02:00,2125,42.46,222,218,1903
29.09.2018 03:00,2158,42.48,187,189,1971
29.09.2018 04:00,2141,42.46,153,174,1988
29.09.2018 05:00,2127,42.5,149,167,1978
29.09.2018 06:00,2150,42.07,167,173,1983
29.09.2018 07:00,2303,41.38,212,198,2091
29.09.2018 08:00,2334,41.13,264,237,2070
29.09.2018 09:00,2444,41.8,287,264,2157
29.09.2018 10:00,2538,42.49,287,280,2251
29.09.2018 11:00,2585,42.52,332,315,2253
29.09.2018 12:00,2429,40.55,342,391,2087
29.09.2018 13:00,2294,36.63,436,489,1858
29.09.2018 14:00,2218,32.84,505,586,1713
29.09.2018 15:00,2230,27.26,626,663,1604
29.09.2018 16:00,2264,33.36,712,714,1552
29.09.2018 17:00,2325,35.69,711,747,1614
29.09.2018 18:00,2483,39.45,785,771,1698
29.09.2018 19:00,2562,40.86,801,795,1761
29.09.2018 20:00,2621,41.06,871,834,1750
29.09.2018 21:00,2500,40.07,910,888,1590
29.09.2018 22:00,2271,37.41,972,946,1299
29.09.2018 23:00,2115,29.1,1012,992,1103
30.09.2018 00:00,2029,19.92,1071,1024,958
30.09.2018 01:00,1979,25.89,1090,1071,889
30.09.2018 02:00,1978,20.63,1096,1079,882
30.09.2018 03:00,1922,19.17,1095,1080,827
30.09.2018 04:00,1934,21.71,1083,1073,851
30.09.2018 05:00,1928,24.99,1069,1059,859
30.09.2018 06:00,1940,26.53,1058,1035,882
30.09.2018 07:00,1985,30.52,1031,1005,954
30.09.2018 08:00,1981,32.31,1000,981,981
30.09.2018 09:00,2130,35.65,983,982,1147
30.09.2018 10:00,2304,37.63,994,1005,1310
30.09.2018 11:00,2412,32.06,1062,1027,1350
30.09.2018 12:00,2286,31.14,995,1006,1291
30.09.2018 13:00,2291,30.91,926,961,1365
30.09.2018 14:00,2349,30.04,870,901,1479
30.09.2018 15:00,2370,30.78,815,819,1555
30.09.2018 16:00,2345,34.75,710,720,1635
30.09.2018 17:00,2407,39.12,630,616,1777
30.09.2018 18:00,2542,43,534,517,2008
30.09.2018 19:00,2660,45.19,440,431,2220
30.09.2018 20:00,2713,46.79,382,372,2331
30.09.2018 21:00,2558,45.37,329,327,2229
30.09.2018 22:00,2430,43.8,298,285,2132
30.09.2018 23:00,2292,42.52,248,246,2044
10.01.2018 00:00,2152,41.14,214,209,1938
10.01.2018 01:00,2069,42.32,198,194,1871
10.01.2018 02:00,2035,42.35,167,154,1868
10.01.2018 03:00,2049,42.4,143,132,1906
10.01.2018 04:00,2072,42.61,127,115,1945
10.01.2018 05:00,2147,42.98,109,102,2038
10.01.2018 06:00,2302,45.95,102,99,2200
10.01.2018 07:00,2700,67.47,104,102,2596
10.01.2018 08:00,2964,75.47,103,99,2861
10.01.2018 09:00,3065,82.93,93,92,2972
10.01.2018 10:00,3040,79.56,90,90,2950
10.01.2018 11:00,3002,73.7,94,96,2908
10.01.2018 12:00,2927,71.63,100,105,2827
10.01.2018 13:00,2857,63.15,118,118,2739
10.01.2018 14:00,2853,60.24,134,132,2719
10.01.2018 15:00,2951,56.18,153,144,2798
10.01.2018 16:00,2825,53,150,147,2675
10.01.2018 17:00,2641,53.37,157,148,2484
10.01.2018 18:00,2780,60.42,151,146,2629
10.01.2018 19:00,2888,69.93,146,149,2742
10.01.2018 20:00,3021,75,172,166,2849
10.01.2018 21:00,2921,65.83,202,182,2719
10.01.2018 22:00,2714,53.86,218,195,2496
10.01.2018 23:00,2547,45.35,214,207,2333
10.02.2018 00:00,2340,42.5,231,219,2109
10.02.2018 01:00,2178,45.1,244,239,1934
10.02.2018 02:00,2129,44.1,257,249,1872
10.02.2018 03:00,2060,44.06,303,270,1757
10.02.2018 04:00,2022,43.77,345,301,1677
10.02.2018 05:00,2144,44.29,370,332,1774
10.02.2018 06:00,2283,48.13,417,370,1866
10.02.2018 07:00,2662,57.7,440,418,2222
10.02.2018 08:00,3028,68.21,461,470,2567
10.02.2018 09:00,3102,70.36,492,500,2610
10.02.2018 10:00,3061,54.53,529,526,2532
10.02.2018 11:00,3130,48.49,598,573,2532
10.02.2018 12:00,3261,47.07,656,662,2605
10.02.2018 13:00,3192,46.33,805,760,2387
10.02.2018 14:00,3022,46.85,871,856,2151
10.02.2018 15:00,2980,46.69,983,952,1997
10.02.2018 16:00,2970,46.27,1056,1044,1914
10.02.2018 17:00,2952,46.4,1150,1136,1802
10.02.2018 18:00,3047,46.25,1204,1197,1843
10.02.2018 19:00,3099,48.52,1240,1232,1859
10.02.2018 20:00,3182,49.03,1265,1260,1917
10.02.2018 21:00,3055,46.26,1276,1275,1779
10.02.2018 22:00,2885,44.85,1279,1285,1606
10.02.2018 23:00,2827,42.69,1283,1290,1544
10.03.2018 00:00,2625,42.6,1267,1285,1358
10.03.2018 01:00,2405,40.69,1200,1226,1205
10.03.2018 02:00,2374,38.07,1187,1210,1187
10.03.2018 03:00,2333,36.42,1172,1186,1161
10.03.2018 04:00,2335,39.14,1137,1149,1198
10.03.2018 05:00,2422,39.65,1098,1117,1324
10.03.2018 06:00,2591,41.34,1049,1078,1542
10.03.2018 07:00,2926,45.27,987,1023,1939
10.03.2018 08:00,3234,47.52,953,964,2281
10.03.2018 09:00,3383,48.39,922,928,2461
10.03.2018 10:00,3389,48.46,885,918,2504
10.03.2018 11:00,3323,47.74,866,925,2457
10.03.2018 12:00,3301,46.92,878,929,2423
10.03.2018 13:00,3204,46.75,883,930,2321
10.03.2018 14:00,3137,46.52,895,933,2242
10.03.2018 15:00,3082,46.5,887,930,2195
10.03.2018 16:00,3009,46.4,873,909,2136
10.03.2018 17:00,2878,46.24,817,862,2061
10.03.2018 18:00,3050,46.75,741,786,2309
10.03.2018 19:00,3243,54.06,668,700,2575
10.03.2018 20:00,3193,58,605,631,2588
10.03.2018 21:00,2979,63.82,591,596,2388
10.03.2018 22:00,2743,55.22,578,581,2165
10.03.2018 23:00,2479,46.1,561,569,1918
10.04.2018 00:00,2281,44.16,576,564,1705
10.04.2018 01:00,2204,46.25,563,555,1641
10.04.2018 02:00,2221,44.99,531,549,1690
10.04.2018 03:00,2161,44.51,529,526,1632
10.04.2018 04:00,2218,45.74,499,491,1719
10.04.2018 05:00,2283,46.01,457,446,1826
10.04.2018 06:00,2461,49.66,418,392,2043
10.04.2018 07:00,2874,61.71,369,336,2505
10.04.2018 08:00,3191,73.8,289,278,2902
10.04.2018 09:00,3256,81,220,205,3036
10.04.2018 10:00,3194,81.58,157,139,3037
10.04.2018 11:00,3213,78.96,114,104,3099
10.04.2018 12:00,3166,75.34,118,102,3048
10.04.2018 13:00,3029,63.05,128,118,2901
10.04.2018 14:00,2970,54.49,153,140,2817
10.04.2018 15:00,2983,54.4,186,165,2797
10.04.2018 16:00,2968,57.61,206,191,2762
10.04.2018 17:00,2917,66.96,233,227,2684
10.04.2018 18:00,2948,77.23,303,274,2645
10.04.2018 19:00,2922,80.25,346,336,2576
10.04.2018 20:00,2939,88.08,431,413,2508
10.04.2018 21:00,2815,78.74,513,484,2302
10.04.2018 22:00,2629,70.49,571,542,2058
10.04.2018 23:00,2469,48.59,617,592,1852
10.05.2018 00:00,2312,43.67,642,647,1670
10.05.2018 01:00,2267,45.26,717,738,1550
10.05.2018 02:00,2128,42.47,760,780,1368
10.05.2018 03:00,2101,40.64,793,815,1308
10.05.2018 04:00,2103,41.06,833,840,1270
10.05.2018 05:00,2167,42.45,845,872,1322
10.05.2018 06:00,2293,46.07,876,889,1417
10.05.2018 07:00,2661,61.14,882,894,1779
10.05.2018 08:00,2936,70.54,879,887,2057
10.05.2018 09:00,3022,77.83,863,856,2159
10.05.2018 10:00,3051,72.71,798,823,2253
10.05.2018 11:00,3049,54.09,748,794,2301
10.05.2018 12:00,3038,50.21,720,771,2318
10.05.2018 13:00,2998,47.44,719,761,2279
10.05.2018 14:00,2925,49.92,706,762,2219
10.05.2018 15:00,2843,48.24,686,758,2157
10.05.2018 16:00,2841,48.5,672,749,2169
10.05.2018 17:00,2838,53.66,679,742,2159
10.05.2018 18:00,2863,73.19,693,720,2170
10.05.2018 19:00,2932,76.78,705,701,2227
10.05.2018 20:00,2927,80.97,695,687,2232
10.05.2018 21:00,2743,77.56,683,674,2060
10.05.2018 22:00,2620,63.52,671,653,1949
10.05.2018 23:00,2417,46.48,658,626,1759
10.06.2018 00:00,2213,44.41,613,580,1600
10.06.2018 01:00,2167,44.89,608,570,1559
10.06.2018 02:00,2047,43.47,520,488,1527
10.06.2018 03:00,1987,43.39,431,402,1556
10.06.2018 04:00,1962,43.35,343,316,1619
10.06.2018 05:00,1941,43.85,274,236,1667
10.06.2018 06:00,2002,44.26,205,175,1797
10.06.2018 07:00,2145,44.4,150,130,1995
10.06.2018 08:00,2221,52.85,108,96,2113
10.06.2018 09:00,2387,60.23,70,65,2317
10.06.2018 10:00,2491,69.02,42,46,2449
10.06.2018 11:00,2546,63.23,32,40,2514
10.06.2018 12:00,2531,57.64,30,38,2501
10.06.2018 13:00,2495,56.61,30,41,2465
10.06.2018 14:00,2451,50.27,31,45,2420
10.06.2018 15:00,2414,49,36,48,2378
10.06.2018 16:00,2406,48.18,40,52,2366
10.06.2018 17:00,2413,53.5,41,56,2372
10.06.2018 18:00,2481,58.49,46,57,2435
10.06.2018 19:00,2587,70.33,55,60,2532
10.06.2018 20:00,2606,80.3,59,68,2547
10.06.2018 21:00,2523,68.91,58,70,2465
10.06.2018 22:00,2423,57.11,61,72,2362
10.06.2018 23:00,2321,47.13,73,81,2248
10.07.2018 00:00,2163,45.34,86,102,2077
10.07.2018 01:00,2094,46.95,151,172,1943
10.07.2018 02:00,1959,45.5,203,226,1756
10.07.2018 03:00,1953,44.65,260,275,1693
10.07.2018 04:00,1894,43.02,344,320,1550
10.07.2018 05:00,1919,42.5,393,363,1526
10.07.2018 06:00,1837,43.8,417,377,1420
10.07.2018 07:00,1867,44.6,421,377,1446
10.07.2018 08:00,2066,46.56,419,368,1647
10.07.2018 09:00,2318,49.49,394,334,1924
10.07.2018 10:00,2532,51.95,341,301,2191
10.07.2018 11:00,2550,53.77,364,280,2186
10.07.2018 12:00,2483,53.71,334,263,2149
10.07.2018 13:00,2525,52.77,281,239,2244
10.07.2018 14:00,2492,50.9,228,214,2264
10.07.2018 15:00,2424,49.91,168,174,2256
10.07.2018 16:00,2376,49.05,126,126,2250
10.07.2018 17:00,2452,50.21,84,84,2368
10.07.2018 18:00,2599,54.14,59,57,2540
10.07.2018 19:00,2762,68.32,52,47,2710
10.07.2018 20:00,2848,79,53,51,2795
10.07.2018 21:00,2748,75.22,71,68,2677
10.07.2018 22:00,2553,63.09,111,98,2442
10.07.2018 23:00,2289,59.91,171,138,2118
10.08.2018 00:00,2107,51.47,218,177,1889
10.08.2018 01:00,2028,46.15,272,264,1756
10.08.2018 02:00,1955,44.16,313,301,1642
10.08.2018 03:00,1997,42.94,351,335,1646
10.08.2018 04:00,2008,41.82,402,376,1606
10.08.2018 05:00,2122,41.79,450,424,1672
10.08.2018 06:00,2269,44.2,529,479,1740
10.08.2018 07:00,2668,61.28,584,533,2084
10.08.2018 08:00,2983,78.06,617,587,2366
10.08.2018 09:00,3064,79.5,691,652,2373
10.08.2018 10:00,3022,79.62,754,737,2268
10.08.2018 11:00,3108,65.29,887,831,2221
10.08.2018 12:00,3107,50.81,976,899,2131
10.08.2018 13:00,3049,50.33,1000,948,2049
10.08.2018 14:00,3075,48.76,1018,976,2057
10.08.2018 15:00,3087,48.82,988,970,2099
10.08.2018 16:00,3148,51.54,972,943,2176
10.08.2018 17:00,3150,60.05,974,902,2176
10.08.2018 18:00,3177,73.1,909,862,2268
10.08.2018 19:00,3197,82.79,848,825,2349
10.08.2018 20:00,3135,99.56,833,797,2302
10.08.2018 21:00,2958,81.65,820,782,2138
10.08.2018 22:00,2848,67.02,812,773,2036
10.08.2018 23:00,2633,46.15,792,760,1841
10.09.2018 00:00,2427,43.98,775,737,1652
10.09.2018 01:00,2288,41.32,786,443.144979,1502
10.09.2018 02:00,2230,38.65,755,443.144979,1475
10.09.2018 03:00,2184,37.03,712,443.144979,1472
10.09.2018 04:00,2154,38.55,656,443.144979,1498
10.09.2018 05:00,2207,38.79,602,443.144979,1605
10.09.2018 06:00,2385,44.93,585,443.144979,1800
10.09.2018 07:00,2740,61.71,570,443.144979,2170
10.09.2018 08:00,3014,74.3,554,443.144979,2460
10.09.2018 09:00,3141,80.97,577,443.144979,2564
10.09.2018 10:00,3149,82.58,588,443.144979,2561
10.09.2018 11:00,3199,78.19,631,443.144979,2568
10.09.2018 12:00,3218,63.14,677,443.144979,2541
10.09.2018 13:00,3145,53,714,443.144979,2431
10.09.2018 14:00,3143,52.07,727,443.144979,2416
10.09.2018 15:00,3110,54.3,722,443.144979,2388
10.09.2018 16:00,3115,60.91,708,443.144979,2407
10.09.2018 17:00,3079,67.31,686,443.144979,2393
10.09.2018 18:00,3091,78.16,687,443.144979,2404
10.09.2018 19:00,3114,87.84,662,443.144979,2452
10.09.2018 20:00,3123,107.63,677,443.144979,2446
10.09.2018 21:00,2976,86.76,692,443.144979,2284
10.09.2018 22:00,2821,64,694,443.144979,2127
10.09.2018 23:00,2619,59.34,672,443.144979,1947
10.10.2018 00:00,2414,41.35,647,443.144979,1767
10.10.2018 01:00,2316,42.28,654,443.144979,1662
10.10.2018 02:00,2220,41.4,623,443.144979,1597
10.10.2018 03:00,2141,41.35,574,443.144979,1567
10.10.2018 04:00,2134,42.33,527,443.144979,1607
10.10.2018 05:00,2194,42.35,477,443.144979,1717
10.10.2018 06:00,2375,54.12,431,443.144979,1944
10.10.2018 07:00,2776,70.43,374,443.144979,2402
10.10.2018 08:00,3111,88,321,443.144979,2790
10.10.2018 09:00,3151,93.22,272,443.144979,2879
10.10.2018 10:00,3072,86.84,182,443.144979,2890
10.10.2018 11:00,3058,80.81,131,443.144979,2927
10.10.2018 12:00,3056,73.69,106,443.144979,2950
10.10.2018 13:00,2910,56.63,72,443.144979,2838
10.10.2018 14:00,2876,53.63,54,443.144979,2822
10.10.2018 15:00,2918,51.99,47,443.144979,2871
10.10.2018 16:00,2906,53.68,36,443.144979,2870
10.10.2018 17:00,2849,57.47,37,443.144979,2812
10.10.2018 18:00,2866,69.3,43,443.144979,2823
10.10.2018 19:00,2965,70.68,64,443.144979,2901
10.10.2018 20:00,3000,72.88,100,443.144979,2900
10.10.2018 21:00,2879,53.71,136,443.144979,2743
10.10.2018 22:00,2744,51.18,179,443.144979,2565
10.10.2018 23:00,2522,46.74,240,443.144979,2282
10.11.2018 00:00,2270,42.1,294,443.144979,1976
10.11.2018 01:00,2125,35.01,344,359,1781
10.11.2018 02:00,2035,31.71,398,415,1637
10.11.2018 03:00,1998,29.97,443,449,1555
10.11.2018 04:00,1976,30.91,469,469,1507
10.11.2018 05:00,1989,34.98,482,493,1507
10.11.2018 06:00,2137,44.08,515,527,1622
10.11.2018 07:00,2546,49.98,543,565,2003
10.11.2018 08:00,2802,71.21,575,603,2227
10.11.2018 09:00,2914,71.52,588,606,2326
10.11.2018 10:00,2946,59.71,574,595,2372
10.11.2018 11:00,2969,49.3,560,593,2409
10.11.2018 12:00,2934,48.61,587,601,2347
10.11.2018 13:00,2934,47.59,628,618,2306
10.11.2018 14:00,2890,47.79,637,632,2253
10.11.2018 15:00,2861,48.36,653,642,2208
10.11.2018 16:00,2845,58.51,641,651,2204
10.11.2018 17:00,2782,63.5,683,668,2099
10.11.2018 18:00,2720,71.1,715,703,2005
10.11.2018 19:00,2811,76.84,775,753,2036
10.11.2018 20:00,2890,76.92,807,792,2083
10.11.2018 21:00,2802,70.15,832,803,1970
10.11.2018 22:00,2532,57.03,803,782,1729
10.11.2018 23:00,2253,44.6,768,746,1485
10.12.2018 00:00,2068,42.12,736,697,1332
10.12.2018 01:00,2021,40.98,741,708,1280
10.12.2018 02:00,2006,40.13,699,674,1307
10.12.2018 03:00,2006,39.36,666,647,1340
10.12.2018 04:00,2044,40.19,632,625,1412
10.12.2018 05:00,2126,40.39,599,607,1527
10.12.2018 06:00,2233,44.86,579,595,1654
10.12.2018 07:00,2575,56.65,564,587,2011
10.12.2018 08:00,2885,68.85,539,572,2346
10.12.2018 09:00,2913,71.47,524,525,2389
10.12.2018 10:00,2884,69.71,449,453,2435
10.12.2018 11:00,2967,69.52,398,385,2569
10.12.2018 12:00,2899,61.95,344,334,2555
10.12.2018 13:00,2792,49.25,298,297,2494
10.12.2018 14:00,2734,48.75,280,271,2454
10.12.2018 15:00,2610,47.84,259,256,2351
10.12.2018 16:00,2590,53.32,254,249,2336
10.12.2018 17:00,2594,56.95,250,253,2344
10.12.2018 18:00,2649,67.32,288,276,2361
10.12.2018 19:00,2578,69.94,298,314,2280
10.12.2018 20:00,2478,77.18,325,348,2153
10.12.2018 21:00,2336,65,355,364,1981
10.12.2018 22:00,2209,53.58,363,366,1846
10.12.2018 23:00,2098,48.8,372,363,1726
13.10.2018 00:00,2012,40.07,365,351,1647
13.10.2018 01:00,1947,35.28,413,402,1534
13.10.2018 02:00,1893,30,423,409,1470
13.10.2018 03:00,1869,26.33,436,416,1433
13.10.2018 04:00,1891,25.42,437,425,1454
13.10.2018 05:00,1897,26.97,439,440,1458
13.10.2018 06:00,1953,31.4,453,463,1500
13.10.2018 07:00,2075,34.56,465,489,1610
13.10.2018 08:00,2207,36.56,481,509,1726
13.10.2018 09:00,2303,39.45,460,485,1843
13.10.2018 10:00,2387,40.32,405,428,1982
13.10.2018 11:00,2468,40.52,338,367,2130
13.10.2018 12:00,2466,40.39,320,338,2146
13.10.2018 13:00,2336,37.4,300,336,2036
13.10.2018 14:00,2260,34.1,299,344,1961
13.10.2018 15:00,2240,31.95,315,361,1925
13.10.2018 16:00,2257,36.52,348,380,1909
13.10.2018 17:00,2303,38.54,390,407,1913
13.10.2018 18:00,2403,39.85,445,454,1958
13.10.2018 19:00,2488,41.29,490,518,1998
13.10.2018 20:00,2409,40.35,582,577,1827
13.10.2018 21:00,2311,38.68,608,618,1703
13.10.2018 22:00,2153,31.52,623,643,1530
13.10.2018 23:00,1987,24.72,645,659,1342
14.10.2018 00:00,1849,13.99,652,657,1197
14.10.2018 01:00,1773,4.69,655,270,1118
14.10.2018 02:00,1753,4.27,651,262,1102
14.10.2018 03:00,1786,3.37,625,255,1161
14.10.2018 04:00,1804,3.23,584,249,1220
14.10.2018 05:00,1861,3.7,545,245,1316
14.10.2018 06:00,1918,4.18,554,248,1364
14.10.2018 07:00,1930,4.06,579,253,1351
14.10.2018 08:00,1942,5.06,609,198,1333
14.10.2018 09:00,2031,23.42,610,198,1421
14.10.2018 10:00,2162,26.71,613,183,1549
14.10.2018 11:00,2261,26.94,578,65,1683
14.10.2018 12:00,2314,25.76,575,69,1739
14.10.2018 13:00,2169,20.73,606,72,1563
14.10.2018 14:00,2174,20.75,624,75,1550
14.10.2018 15:00,2170,13.92,644,76,1526
14.10.2018 16:00,2188,19.54,651,75,1537
14.10.2018 17:00,2282,20.74,663,76,1619
14.10.2018 18:00,2431,36.15,687,78,1744
14.10.2018 19:00,2597,38.53,749,82,1848
14.10.2018 20:00,2523,38.27,781,84,1742
14.10.2018 21:00,2419,32.6,810,84,1609
14.10.2018 22:00,2203,29.41,832,82,1371
14.10.2018 23:00,2081,23.75,804,80,1277
15.10.2018 00:00,2001,4.45,764,78,1237
15.10.2018 01:00,1872,1.92,669,65,1203
15.10.2018 02:00,1883,2.41,605,62,1278
15.10.2018 03:00,1868,4.1,559,58,1309
15.10.2018 04:00,1850,7.33,543,55,1307
15.10.2018 05:00,1934,12.33,498,52,1436
15.10.2018 06:00,2150,40.95,493,50,1657
15.10.2018 07:00,2543,58.58,483,49,2060
15.10.2018 08:00,2867,72.77,455,41,2412
15.10.2018 09:00,2886,77.15,417,37,2469
15.10.2018 10:00,2961,74.72,363,34,2598
15.10.2018 11:00,2982,62.39,253,31,2729
15.10.2018 12:00,2998,54.19,232,29,2766
15.10.2018 13:00,2885,49.71,189,28,2696
15.10.2018 14:00,2821,51.05,185,28,2636
15.10.2018 15:00,2817,51.45,204,27,2613
15.10.2018 16:00,2812,55.26,235,28,2577
15.10.2018 17:00,2776,71.86,240,29,2536
15.10.2018 18:00,2797,78.36,267,30,2530
15.10.2018 19:00,2860,90,316,31,2544
15.10.2018 20:00,2737,91.93,357,19,2380
15.10.2018 21:00,2526,73.5,380,20,2146
15.10.2018 22:00,2367,58.99,394,21,1973
15.10.2018 23:00,2181,52.68,417,21,1764
16.10.2018 00:00,2056,44.96,366,21,1690
16.10.2018 01:00,2054,44.7,293,256,1761
16.10.2018 02:00,2030,43.43,241,204,1789
16.10.2018 03:00,2101,42.47,169,155,1932
16.10.2018 04:00,2137,44.18,116,107,2021
16.10.2018 05:00,2145,50.95,89,70,2056
16.10.2018 06:00,2317,55.66,61,46,2256
16.10.2018 07:00,2688,72.27,42,34,2646
16.10.2018 08:00,3029,76.05,33,31,2996
16.10.2018 09:00,3132,80.06,51,28,3081
16.10.2018 10:00,3036,83.95,21,30,3015
16.10.2018 11:00,3015,78.82,15,31,3000
16.10.2018 12:00,3000,75.93,13,33,2987
16.10.2018 13:00,2950,72.23,21,37,2929
16.10.2018 14:00,2926,71.07,22,39,2904
16.10.2018 15:00,2872,70.29,28,38,2844
16.10.2018 16:00,2817,69.72,31,37,2786
16.10.2018 17:00,2749,72.26,32,36,2717
16.10.2018 18:00,2764,76.08,42,39,2722
16.10.2018 19:00,2863,89.97,59,47,2804
16.10.2018 20:00,2820,105.12,83,60,2737
16.10.2018 21:00,2676,82.92,82,66,2594
16.10.2018 22:00,2536,67.41,95,67,2441
16.10.2018 23:00,2331,58.55,79,65,2252
17.10.2018 00:00,2176,45.6,74,61,2102
17.10.2018 01:00,2117,44.08,122,123,1995
17.10.2018 02:00,2060,42.74,116,117,1944
17.10.2018 03:00,2029,40.39,105,107,1924
17.10.2018 04:00,2033,41.86,94,97,1939
17.10.2018 05:00,2083,48.91,92,93,1991
17.10.2018 06:00,2203,54.36,82,88,2121
17.10.2018 07:00,2565,69.29,73,83,2492
17.10.2018 08:00,2917,77.72,71,81,2846
17.10.2018 09:00,3006,89.99,70,79,2936
17.10.2018 10:00,2984,85.5,72,81,2912
17.10.2018 11:00,2945,78.55,74,84,2871
17.10.2018 12:00,2917,74.24,74,84,2843
17.10.2018 13:00,2857,61.22,55,83,2802
17.10.2018 14:00,2834,59.27,58,80,2776
17.10.2018 15:00,2794,61.48,66,78,2728
17.10.2018 16:00,2807,70.81,72,78,2735
17.10.2018 17:00,2750,74.53,83,80,2667
17.10.2018 18:00,2805,80.95,98,90,2707
17.10.2018 19:00,2883,89.94,119,107,2764
17.10.2018 20:00,2806,112.66,142,127,2664
17.10.2018 21:00,2650,81.57,155,142,2495
17.10.2018 22:00,2533,60.1,152,150,2381
17.10.2018 23:00,2354,56.49,145,154,2209
18.10.2018 00:00,2212,53.58,145,153,2067
18.10.2018 01:00,2121,41.94,154,149,1967
18.10.2018 02:00,2072,41.24,148,145,1924
18.10.2018 03:00,2057,40.42,142,142,1915
18.10.2018 04:00,2071,42.33,131,135,1940
18.10.2018 05:00,2109,44.01,119,130,1990
18.10.2018 06:00,2255,51.06,120,134,2135
18.10.2018 07:00,2641,59.59,133,151,2508
18.10.2018 08:00,2966,76.09,150,173,2816
18.10.2018 09:00,3013,80.99,193,185,2820
18.10.2018 10:00,3017,79.02,188,201,2829
18.10.2018 11:00,3073,72.8,199,225,2874
18.10.2018 12:00,3010,63.03,225,255,2785
18.10.2018 13:00,2686,55.28,262,284,2424
18.10.2018 14:00,2540,55.04,285,310,2255
18.10.2018 15:00,2559,55.12,294,325,2265
18.10.2018 16:00,2458,55.28,312,329,2146
18.10.2018 17:00,2388,60.45,312,323,2076
18.10.2018 18:00,2437,69.97,315,318,2122
18.10.2018 19:00,2576,80.15,327,325,2249
18.10.2018 20:00,2826,83.86,318,330,2508
18.10.2018 21:00,2815,72.09,304,313,2511
18.10.2018 22:00,2674,58.63,281,280,2393
18.10.2018 23:00,2523,51.75,247,240,2276
19.10.2018 00:00,2408,42.09,192,199,2216
19.10.2018 01:00,2350,50.48,157,161,2193
19.10.2018 02:00,2334,47.8,116,123,2218
19.10.2018 03:00,2346,38.64,87,93,2259
19.10.2018 04:00,2367,47.47,66,68,2301
19.10.2018 05:00,2421,47.94,53,51,2368
19.10.2018 06:00,2621,53.04,47,42,2574
19.10.2018 07:00,3002,70.89,41,38,2961
19.10.2018 08:00,3336,79.02,35,38,3301
19.10.2018 09:00,3381,84.09,28,36,3353
19.10.2018 10:00,3303,84.28,20,33,3283
19.10.2018 11:00,3247,81.94,16,34,3231
19.10.2018 12:00,3167,75.19,14,35,3153
19.10.2018 13:00,3016,69.16,18,39,2998
19.10.2018 14:00,2917,63.9,26,46,2891
19.10.2018 15:00,2846,60.29,47,55,2799
19.10.2018 16:00,2750,60.92,47,64,2703
19.10.2018 17:00,2711,70.63,53,74,2658
19.10.2018 18:00,2861,78.08,70,82,2791
19.10.2018 19:00,2998,81.96,76,95,2922
19.10.2018 20:00,2925,83.95,92,117,2833
19.10.2018 21:00,2729,77.58,130,141,2599
19.10.2018 22:00,2584,67.3,168,169,2416
19.10.2018 23:00,2396,58.42,206,202,2190
20.10.2018 00:00,2273,43.85,230,230,2043
20.10.2018 01:00,2251,45,265,255,1986
20.10.2018 02:00,2156,43.51,275,266,1881
20.10.2018 03:00,2020,42.09,272,272,1748
20.10.2018 04:00,2019,40.92,280,280,1739
20.10.2018 05:00,2094,41.38,271,290,1823
20.10.2018 06:00,2180,43.59,286,309,1894
20.10.2018 07:00,2221,42.73,308,331,1913
20.10.2018 08:00,2313,51.08,350,355,1963
20.10.2018 09:00,2529,58.13,308,352,2221
20.10.2018 10:00,2724,65.06,312,334,2412
20.10.2018 11:00,2706,64.8,271,322,2435
20.10.2018 12:00,2739,60.07,241,322,2498
20.10.2018 13:00,2689,53.17,242,330,2447
20.10.2018 14:00,2603,49.64,244,340,2359
20.10.2018 15:00,2533,49.39,260,343,2273
20.10.2018 16:00,2477,50.47,247,333,2230
20.10.2018 17:00,2512,53.67,248,322,2264
20.10.2018 18:00,2686,59.26,245,323,2441
20.10.2018 19:00,2826,68.1,249,340,2577
20.10.2018 20:00,2792,67.63,283,363,2509
20.10.2018 21:00,2681,60.7,289,348,2392
20.10.2018 22:00,2515,52.97,268,304,2247
20.10.2018 23:00,2448,44.91,244,255,2204
21.10.2018 00:00,2333,39.76,205,214,2128
21.10.2018 01:00,2273,47.19,116,114,2157
21.10.2018 02:00,2251,42.02,108,102,2143
21.10.2018 03:00,2199,40.48,106,100,2093
21.10.2018 04:00,2191,39.43,119,111,2072
21.10.2018 05:00,2193,39.38,135,132,2058
21.10.2018 06:00,2207,40,159,161,2048
21.10.2018 07:00,2244,39.97,188,189,2056
21.10.2018 08:00,2311,43.98,215,217,2096
21.10.2018 09:00,2384,47.69,247,245,2137
21.10.2018 10:00,2465,52.32,280,265,2185
21.10.2018 11:00,2544,52.55,305,284,2239
21.10.2018 12:00,2528,51.75,335,319,2193
21.10.2018 13:00,2527,50.39,386,379,2141
21.10.2018 14:00,2545,45.89,451,448,2094
21.10.2018 15:00,2559,46.37,506,512,2053
21.10.2018 16:00,2591,39.53,547,565,2044
21.10.2018 17:00,2635,40.12,604,616,2031
21.10.2018 18:00,2745,50.86,681,676,2064
21.10.2018 19:00,2887,65.8,743,748,2144
21.10.2018 20:00,2845,65.06,815,819,2030
21.10.2018 21:00,2678,41.57,884,875,1794
21.10.2018 22:00,2536,40.4,916,918,1620
21.10.2018 23:00,2366,38.32,949,955,1417
22.10.2018 00:00,2224,35.08,984,980,1240
22.10.2018 01:00,2092,24.82,990,983,1102
22.10.2018 02:00,2096,20.99,989,985,1107
22.10.2018 03:00,2084,19.95,972,965,1112
22.10.2018 04:00,2073,21.11,913,921,1160
22.10.2018 05:00,2193,25.26,866,899,1327
22.10.2018 06:00,2359,39.14,884,897,1475
22.10.2018 07:00,2817,41.62,899,913,1918
22.10.2018 08:00,3225,56.47,908,937,2317
22.10.2018 09:00,3253,58.05,917,952,2336
22.10.2018 10:00,3220,56.1,955,976,2265
22.10.2018 11:00,3130,43.26,998,1026,2132
22.10.2018 12:00,3005,42.5,1087,1085,1918
22.10.2018 13:00,2980,42.08,1133,1130,1847
22.10.2018 14:00,2980,41.69,1161,1155,1819
22.10.2018 15:00,2964,41.28,1152,1150,1812
22.10.2018 16:00,2938,41.57,1114,1126,1824
22.10.2018 17:00,2970,42.14,1063,1084,1907
22.10.2018 18:00,3170,58.03,1039,1039,2131
22.10.2018 19:00,3315,67.04,1008,1009,2307
22.10.2018 20:00,3218,65.09,1014,990,2204
22.10.2018 21:00,2995,42.72,1012,990,1983
22.10.2018 22:00,2802,41.6,1022,997,1780
22.10.2018 23:00,2576,39.43,1036,1009,1540
23.10.2018 00:00,2400,35.01,1070,1046,1330
23.10.2018 01:00,2280,30.36,1130,1107,1150
23.10.2018 02:00,2225,17.38,1202,1177,1023
23.10.2018 03:00,2222,12.1,1278,1256,944
23.10.2018 04:00,2263,12.96,1345,1329,918
23.10.2018 05:00,2316,21.8,1389,1378,927
23.10.2018 06:00,2474,34.92,1411,1402,1063
23.10.2018 07:00,2844,41.21,1411,1408,1433
23.10.2018 08:00,3246,43.54,1392,1406,1854
23.10.2018 09:00,3309,43.66,1382,1391,1927
23.10.2018 10:00,3330,43.1,1362,1373,1968
23.10.2018 11:00,3343,42.83,1355,1365,1988
23.10.2018 12:00,3298,41.99,1338,1356,1960
23.10.2018 13:00,3171,41.07,1342,1349,1829
23.10.2018 14:00,3172,40.39,1344,1349,1828
23.10.2018 15:00,3132,40.52,1341,1345,1791
23.10.2018 16:00,3112,40.01,1325,1328,1787
23.10.2018 17:00,3098,39.6,1307,1310,1791
23.10.2018 18:00,3172,40.47,1285,1284,1887
23.10.2018 19:00,3284,41.22,1257,1251,2027
23.10.2018 20:00,3218,40.93,1238,1214,1980
23.10.2018 21:00,3065,40.17,1215,1177,1850
23.10.2018 22:00,2886,38.56,1182,1138,1704
23.10.2018 23:00,2754,36.22,1142,1092,1612
24.10.2018 00:00,2573,30.08,1095,1061,1478
24.10.2018 01:00,2410,26.09,1049,1055,1361
24.10.2018 02:00,2321,29.79,991,1012,1330
24.10.2018 03:00,2292,29.73,982,975,1310
24.10.2018 04:00,2396,28.58,915,945,1481
24.10.2018 05:00,2459,29.95,914,923,1545
24.10.2018 06:00,2590,38.42,891,919,1699
24.10.2018 07:00,3025,42.57,898,924,2127
24.10.2018 08:00,3437,50.24,919,921,2518
24.10.2018 09:00,3526,51.62,890,904,2636
24.10.2018 10:00,3512,51.89,899,888,2613
24.10.2018 11:00,3468,51.91,860,883,2608
24.10.2018 12:00,3362,50.58,841,879,2521
24.10.2018 13:00,3213,45.5,835,877,2378
24.10.2018 14:00,3061,51.73,807,867,2254
24.10.2018 15:00,2999,50.97,783,830,2216
24.10.2018 16:00,3062,50.03,714,763,2348
24.10.2018 17:00,3024,51.5,643,679,2381
24.10.2018 18:00,3282,58.31,578,609,2704
24.10.2018 19:00,3446,65.13,519,557,2927
24.10.2018 20:00,3291,63.51,527,515,2764
24.10.2018 21:00,3140,60.07,523,500,2617
24.10.2018 22:00,2960,50.07,515,496,2445
24.10.2018 23:00,2699,42.87,554,497,2145
25.10.2018 00:00,2607,41.19,547,499,2060
25.10.2018 01:00,2560,40.92,670,681,1890
25.10.2018 02:00,2385,38.53,758,772,1627
25.10.2018 03:00,2322,37.68,872,880,1450
25.10.2018 04:00,2356,38.02,991,995,1365
25.10.2018 05:00,2383,38.31,1079,1083,1304
25.10.2018 06:00,2569,40.94,1128,1136,1441
25.10.2018 07:00,3020,44.59,1175,1176,1845
25.10.2018 08:00,3431,46.78,1203,1202,2228
25.10.2018 09:00,3486,46.92,1187,1200,2299
25.10.2018 10:00,3422,46.79,1144,1181,2278
25.10.2018 11:00,3405,46.16,1122,1166,2283
25.10.2018 12:00,3270,45.59,1126,1157,2144
25.10.2018 13:00,3107,44.52,1110,1148,1997
25.10.2018 14:00,3047,43.92,1093,1135,1954
25.10.2018 15:00,3071,44.12,1042,1092,2029
25.10.2018 16:00,3078,44.86,980,1024,2098
25.10.2018 17:00,3164,45.7,890,938,2274
25.10.2018 18:00,3310,55.13,807,858,2503
25.10.2018 19:00,3352,60.54,738,785,2614
25.10.2018 20:00,3332,60.31,660,715,2672
25.10.2018 21:00,3207,54.64,566,643,2641
25.10.2018 22:00,3102,46.14,521,574,2581
25.10.2018 23:00,2832,45.16,445,511,2387
26.10.2018 00:00,2609,44.21,388,462,2221
26.10.2018 01:00,2475,44.93,341,346,2134
26.10.2018 02:00,2414,44.66,335,342,2079
26.10.2018 03:00,2434,44.72,314,334,2120
26.10.2018 04:00,2409,45.06,316,321,2093
26.10.2018 05:00,2428,45.65,307,301,2121
26.10.2018 06:00,2631,48.7,276,267,2355
26.10.2018 07:00,3024,67,234,224,2790
26.10.2018 08:00,3359,75.69,180,180,3179
26.10.2018 09:00,3378,80.31,145,147,3233
26.10.2018 10:00,3372,77,99,133,3273
26.10.2018 11:00,3383,73.42,87,139,3296
26.10.2018 12:00,3368,67.75,129,165,3239
26.10.2018 13:00,3339,57.2,183,200,3156
26.10.2018 14:00,3238,50.46,219,239,3019
26.10.2018 15:00,3094,47.85,264,260,2830
26.10.2018 16:00,3034,48.6,303,273,2731
26.10.2018 17:00,3017,55.27,344,296,2673
26.10.2018 18:00,3058,65.75,393,328,2665
26.10.2018 19:00,3089,69.31,426,363,2663
26.10.2018 20:00,2981,65.98,428,401,2553
26.10.2018 21:00,2820,56.68,450,452,2370
26.10.2018 22:00,2645,48.75,485,503,2160
26.10.2018 23:00,2500,44.26,519,547,1981
27.10.2018 00:00,2379,42.52,544,572,1835
27.10.2018 01:00,2367,43.01,621,610,1746
27.10.2018 02:00,2276,41.22,648,633,1628
27.10.2018 03:00,2242,40.06,662,644,1580
27.10.2018 04:00,2272,39.18,699,651,1573
27.10.2018 05:00,2257,39.46,735,668,1522
27.10.2018 06:00,2287,40.44,741,692,1546
27.10.2018 07:00,2426,40.6,754,727,1672
27.10.2018 08:00,2647,43.33,800,782,1847
27.10.2018 09:00,2805,44.71,856,847,1949
27.10.2018 10:00,3024,45.59,864,911,2160
27.10.2018 11:00,3147,46,1013,963,2134
27.10.2018 12:00,3177,46.09,1042,986,2135
27.10.2018 13:00,3168,45.6,1009,986,2159
27.10.2018 14:00,3142,45.47,975,967,2167
27.10.2018 15:00,3142,45.48,930,925,2212
27.10.2018 16:00,3155,45.24,868,869,2287
27.10.2018 17:00,3194,46.09,810,801,2384
27.10.2018 18:00,3336,56.33,768,736,2568
27.10.2018 19:00,3442,66.15,722,685,2720
27.10.2018 20:00,3321,66.16,658,634,2663
27.10.2018 21:00,3212,59.69,609,590,2603
27.10.2018 22:00,3097,46.16,549,548,2548
27.10.2018 23:00,2946,45.82,504,508,2442
28.10.2018 00:00,2768,44.23,476,471,2292
28.10.2018 01:00,2641,44.53,440,443.144979,2201
28.10.2018 02:00,2575,43.58,428,443.144979,2147
28.10.2018 03:00,2544,41.62,419,443.144979,2125
28.10.2018 03:00,2559,41.59,415,443.144979,2144
28.10.2018 04:00,2582,40.12,416,443.144979,2166
28.10.2018 05:00,2609,40.01,421,443.144979,2188
28.10.2018 06:00,2634,40.93,418,443.144979,2216
28.10.2018 07:00,2738,41.95,424,443.144979,2314
28.10.2018 08:00,2834,43.61,437,443.144979,2397
28.10.2018 09:00,3019,45.02,463,443.144979,2556
28.10.2018 10:00,3142,45.86,499,443.144979,2643
28.10.2018 11:00,3163,47,540,443.144979,2623
28.10.2018 12:00,3084,46.87,505,443.144979,2579
28.10.2018 13:00,3054,46.25,541,443.144979,2513
28.10.2018 14:00,2995,45,543,443.144979,2452
28.10.2018 15:00,2994,44.51,559,443.144979,2435
28.10.2018 16:00,3003,45.58,552,443.144979,2451
28.10.2018 17:00,3106,47.2,584,443.144979,2522
28.10.2018 18:00,3321,48.37,642,443.144979,2679
28.10.2018 19:00,3319,47.94,708,443.144979,2611
28.10.2018 20:00,3236,46.3,723,443.144979,2513
28.10.2018 21:00,3121,45,769,443.144979,2352
28.10.2018 22:00,2993,44.27,834,443.144979,2159
28.10.2018 23:00,2805,42.58,864,443.144979,1941
29.10.2018 00:00,2755,41.16,790,443.144979,1965
29.10.2018 01:00,2626,40.53,866,826,1760
29.10.2018 02:00,2560,39.95,881,844,1679
29.10.2018 03:00,2579,39.62,894,857,1685
29.10.2018 04:00,2554,39.94,903,868,1651
29.10.2018 05:00,2646,40.6,911,876,1735
29.10.2018 06:00,2811,43.75,912,881,1899
29.10.2018 07:00,3154,50.1,940,886,2214
29.10.2018 08:00,3394,62.79,944,900,2450
29.10.2018 09:00,3481,61.06,979,927,2502
29.10.2018 10:00,3516,55.19,999,965,2517
29.10.2018 11:00,3572,56.94,1096,1031,2476
29.10.2018 12:00,3629,47.03,1146,1113,2483
29.10.2018 13:00,3615,46.53,1193,1187,2422
29.10.2018 14:00,3635,46.07,1216,1217,2419
29.10.2018 15:00,3585,45.92,1224,1219,2361
29.10.2018 16:00,3604,45.96,1230,1213,2374
29.10.2018 17:00,3718,50.98,1248,1217,2470
29.10.2018 18:00,3790,54.87,1263,1239,2527
29.10.2018 19:00,3664,47.51,1277,1261,2387
29.10.2018 20:00,3551,45.63,1283,1276,2268
29.10.2018 21:00,3327,44.91,1295,1288,2032
29.10.2018 22:00,3153,43.16,1309,1299,1844
29.10.2018 23:00,2924,41.07,1322,1319,1602
30.10.2018 00:00,2750,39.02,1335,1340,1415
30.10.2018 01:00,2613,39.29,1294,1298,1319
30.10.2018 02:00,2522,37.07,1307,1312,1215
30.10.2018 03:00,2469,37.03,1319,1326,1150
30.10.2018 04:00,2478,37.76,1330,1336,1148
30.10.2018 05:00,2531,39.57,1338,1340,1193
30.10.2018 06:00,2674,41.04,1336,1337,1338
30.10.2018 07:00,2981,43,1324,1330,1657
30.10.2018 08:00,3280,44.89,1313,1319,1967
30.10.2018 09:00,3383,44.81,1298,1299,2085
30.10.2018 10:00,3366,44.23,1279,1282,2087
30.10.2018 11:00,3387,44.11,1263,1269,2124
30.10.2018 12:00,3414,44.16,1231,1253,2183
30.10.2018 13:00,3316,43.93,1217,1233,2099
30.10.2018 14:00,3335,43.77,1199,1207,2136
30.10.2018 15:00,3191,43.91,1163,1170,2028
30.10.2018 16:00,3227,44.65,1110,1125,2117
30.10.2018 17:00,3350,45.4,988,1079,2362
30.10.2018 18:00,3619,46.36,922,1020,2697
30.10.2018 19:00,3586,46.12,829,944,2757
30.10.2018 20:00,3551,44.91,751,874,2800
30.10.2018 21:00,3328,44.02,709,824,2619
30.10.2018 22:00,2898,42.81,771,802,2127
30.10.2018 23:00,2521,40.33,814,850,1707
31.10.2018 00:00,2320,38.66,904,924,1416
31.10.2018 01:00,2332,37.26,972,982,1360
31.10.2018 02:00,2294,37.04,1045,1051,1249
31.10.2018 03:00,2312,35.06,1108,1106,1204
31.10.2018 04:00,2358,35.21,1143,1143,1215
31.10.2018 05:00,2372,38.45,1152,1174,1220
31.10.2018 06:00,2525,40.74,1195,1206,1330
31.10.2018 07:00,2937,43.52,1233,1238,1704
31.10.2018 08:00,3310,44.94,1270,1280,2040
31.10.2018 09:00,3374,44.82,1304,1315,2070
31.10.2018 10:00,3306,44.19,1325,1337,1981
31.10.2018 11:00,3271,43.83,1310,1335,1961
31.10.2018 12:00,3266,44.04,1287,1298,1979
31.10.2018 13:00,3277,44.13,1233,1239,2044
31.10.2018 14:00,3268,44.47,1163,1135,2105
31.10.2018 15:00,3263,52.42,1024,992,2239
31.10.2018 16:00,3281,64.49,853,831,2428
31.10.2018 17:00,3272,73.64,725,689,2547
31.10.2018 18:00,3384,82.07,625,584,2759
31.10.2018 19:00,3295,74.02,548,499,2747
31.10.2018 20:00,3222,62.2,437,416,2785
31.10.2018 21:00,3138,48.88,345,337,2793
31.10.2018 22:00,2958,43.63,284,268,2674
31.10.2018 23:00,2713,42.26,235,219,2478
11.01.2018 00:00,2560,40.34,200,192,2360
11.01.2018 01:00,2435,41.05,172,179,2263
11.01.2018 02:00,2374,41.1,192,198,2182
11.01.2018 03:00,2302,40.59,241,238,2061
11.01.2018 04:00,2244,40.09,284,289,1960
11.01.2018 05:00,2253,40.07,328,325,1925
11.01.2018 06:00,2435,42.78,343,353,2092
11.01.2018 07:00,2822,44.03,382,381,2440
11.01.2018 08:00,3080,44.55,408,409,2672
11.01.2018 09:00,3075,45.33,412,420,2663
11.01.2018 10:00,3094,45.05,404,428,2690
11.01.2018 11:00,3105,45.37,377,420,2728
11.01.2018 12:00,3121,45.91,357,402,2764
11.01.2018 13:00,3018,46.93,327,384,2691
11.01.2018 14:00,3094,49.6,317,376,2777
11.01.2018 15:00,3076,47.95,331,377,2745
11.01.2018 16:00,3060,47.31,365,392,2695
11.01.2018 17:00,3101,49.17,408,423,2693
11.01.2018 18:00,3228,54.1,446,455,2782
11.01.2018 19:00,3163,54.07,467,476,2696
11.01.2018 20:00,3081,47.03,453,459,2628
11.01.2018 21:00,2948,45.94,413,419,2535
11.01.2018 22:00,2818,44.7,376,373,2442
11.01.2018 23:00,2577,43.8,340,336,2237
11.02.2018 00:00,2360,41.87,315,309,2045
11.02.2018 01:00,2278,42.22,330,341,1948
11.02.2018 02:00,2274,40.98,306,323,1968
11.02.2018 03:00,2286,40.8,314,318,1972
11.02.2018 04:00,2308,40.55,319,326,1989
11.02.2018 05:00,2373,41.16,334,360,2039
11.02.2018 06:00,2531,44.04,384,418,2147
11.02.2018 07:00,2894,45.39,444,490,2450
11.02.2018 08:00,3180,48.14,511,563,2669
11.02.2018 09:00,3278,51.87,562,618,2716
11.02.2018 10:00,3246,47.26,630,669,2616
11.02.2018 11:00,3315,45.78,615,705,2700
11.02.2018 12:00,3319,45.06,636,717,2683
11.02.2018 13:00,3221,45.26,691,728,2530
11.02.2018 14:00,3200,45.78,725,750,2475
11.02.2018 15:00,3126,45.15,741,775,2385
11.02.2018 16:00,3120,44.94,767,802,2353
11.02.2018 17:00,3121,45.81,821,817,2300
11.02.2018 18:00,3179,49.3,829,826,2350
11.02.2018 19:00,3078,47.3,864,837,2214
11.02.2018 20:00,3000,44.89,847,843,2153
11.02.2018 21:00,2955,44.2,849,838,2106
11.02.2018 22:00,2721,43.94,833,825,1888
11.02.2018 23:00,2547,43.45,809,807,1738
11.03.2018 00:00,2362,42.54,789,790,1573
11.03.2018 01:00,2309,42.87,799,808,1510
11.03.2018 02:00,2215,42.15,791,784,1424
11.03.2018 03:00,2258,41.7,768,750,1490
11.03.2018 04:00,2262,41.64,720,712,1542
11.03.2018 05:00,2299,41.92,662,673,1637
11.03.2018 06:00,2358,42.85,622,633,1736
11.03.2018 07:00,2491,43.08,588,591,1903
11.03.2018 08:00,2572,43.43,539,546,2033
11.03.2018 09:00,2666,44.05,484,493,2182
11.03.2018 10:00,2762,51.04,441,445,2321
11.03.2018 11:00,2683,51.03,385,412,2298
11.03.2018 12:00,2587,51.06,375,388,2212
11.03.2018 13:00,2518,49.15,340,363,2178
11.03.2018 14:00,2517,44.31,299,319,2218
11.03.2018 15:00,2552,44.63,255,260,2297
11.03.2018 16:00,2630,44.7,227,219,2403
11.03.2018 17:00,2810,59.07,222,215,2588
11.03.2018 18:00,2905,67.91,233,232,2672
11.03.2018 19:00,2833,60.75,255,257,2578
11.03.2018 20:00,2715,53.15,275,271,2440
11.03.2018 21:00,2641,44.58,284,277,2357
11.03.2018 22:00,2585,43.74,287,276,2298
11.03.2018 23:00,2468,42.33,277,266,2191
11.04.2018 00:00,2341,41.44,258,251,2083
11.04.2018 01:00,2271,42.44,253,247,2018
11.04.2018 02:00,2222,42.06,251,242,1971
11.04.2018 03:00,2252,41.9,240,239,2012
11.04.2018 04:00,2309,41.19,236,238,2073
11.04.2018 05:00,2313,41.04,245,245,2068
11.04.2018 06:00,2348,41.34,257,261,2091
11.04.2018 07:00,2427,41.95,280,281,2147
11.04.2018 08:00,2485,43.13,299,294,2186
11.04.2018 09:00,2589,44.03,298,296,2291
11.04.2018 10:00,2736,44.51,298,299,2438
11.04.2018 11:00,2794,44.7,313,305,2481
11.04.2018 12:00,2877,44.66,298,314,2579
11.04.2018 13:00,2850,44.53,321,330,2529
11.04.2018 14:00,2797,44.42,348,348,2449
11.04.2018 15:00,2800,44.36,341,364,2459
11.04.2018 16:00,2817,44.43,370,386,2447
11.04.2018 17:00,3000,44.94,405,407,2595
11.04.2018 18:00,3104,59.04,411,425,2693
11.04.2018 19:00,3068,45.15,412,436,2656
11.04.2018 20:00,2974,56.3,399,423,2575
11.04.2018 21:00,2857,46.89,376,389,2481
11.04.2018 22:00,2660,44.01,338,348,2322
11.04.2018 23:00,2526,43.64,303,307,2223
11.05.2018 00:00,2361,42.1,259,270,2102
11.05.2018 01:00,2265,40.54,192,199,2073
11.05.2018 02:00,2220,41.63,166,177,2054
11.05.2018 03:00,2225,41.75,151,164,2074
11.05.2018 04:00,2215,40.95,153,156,2062
11.05.2018 05:00,2240,40.58,151,158,2089
11.05.2018 06:00,2422,42.53,151,165,2271
11.05.2018 07:00,2905,45.48,153,173,2752
11.05.2018 08:00,3225,63.48,155,173,3070
11.05.2018 09:00,3284,68.23,158,171,3126
11.05.2018 10:00,3292,65.88,156,170,3136
11.05.2018 11:00,3298,66.65,152,179,3146
11.05.2018 12:00,3346,66.67,158,194,3188
11.05.2018 13:00,3330,64.25,174,215,3156
11.05.2018 14:00,3355,65.56,215,241,3140
11.05.2018 15:00,3317,66.57,210,271,3107
11.05.2018 16:00,3371,69.24,227,311,3144
11.05.2018 17:00,3393,68.12,278,357,3115
11.05.2018 18:00,3479,67.16,338,394,3141
11.05.2018 19:00,3374,59.33,374,426,3000
11.05.2018 20:00,3258,57.17,396,438,2862
11.05.2018 21:00,3109,46.91,391,432,2718
11.05.2018 22:00,2957,46.31,373,421,2584
11.05.2018 23:00,2685,44.76,364,414,2321
11.06.2018 00:00,2456,43,391,413,2065
11.06.2018 01:00,2321,42.92,346,358,1975
11.06.2018 02:00,2225,42.39,368,380,1857
11.06.2018 03:00,2187,42.23,388,405,1799
11.06.2018 04:00,2216,42.14,408,430,1808
11.06.2018 05:00,2283,42.52,442,447,1841
11.06.2018 06:00,2440,45.29,484,453,1956
11.06.2018 07:00,2869,55.73,503,455,2366
11.06.2018 08:00,3016,66.32,474,438,2542
11.06.2018 09:00,3194,68.42,416,395,2778
11.06.2018 10:00,3212,66.61,352,345,2860
11.06.2018 11:00,3243,63.16,298,292,2945
11.06.2018 12:00,3217,63.03,216,238,3001
11.06.2018 13:00,3146,60.73,194,194,2952
11.06.2018 14:00,3097,62.41,165,172,2932
11.06.2018 15:00,3078,63.14,165,167,2913
11.06.2018 16:00,3116,64.34,178,179,2938
11.06.2018 17:00,3230,66.89,198,198,3032
11.06.2018 18:00,3341,74.68,208,209,3133
11.06.2018 19:00,3305,72.94,199,216,3106
11.06.2018 20:00,3233,69.26,187,207,3046
11.06.2018 21:00,3143,57.84,170,190,2973
11.06.2018 22:00,3016,46.6,167,175,2849
11.06.2018 23:00,2830,45.58,159,173,2671
11.07.2018 00:00,2615,43.87,157,183,2458
11.07.2018 01:00,2429,43.45,116,124,2313
11.07.2018 02:00,2358,42.51,134,144,2224
11.07.2018 03:00,2307,41.59,159,175,2148
11.07.2018 04:00,2294,40.64,204,210,2090
11.07.2018 05:00,2340,41.77,228,234,2112
11.07.2018 06:00,2472,43.77,240,251,2232
11.07.2018 07:00,2905,49.57,258,268,2647
11.07.2018 08:00,3227,60.38,263,270,2964
11.07.2018 09:00,3267,62.64,257,255,3010
11.07.2018 10:00,3256,61.5,236,236,3020
11.07.2018 11:00,3201,60.08,198,208,3003
11.07.2018 12:00,3191,58.36,177,181,3014
11.07.2018 13:00,3179,58.35,158,157,3021
11.07.2018 14:00,3188,60.03,137,150,3051
11.07.2018 15:00,3146,61.43,154,157,2992
11.07.2018 16:00,3195,64.04,172,179,3023
11.07.2018 17:00,3235,67.7,180,194,3055
11.07.2018 18:00,3364,70.99,190,195,3174
11.07.2018 19:00,3307,68.61,168,191,3139
11.07.2018 20:00,3265,64.46,152,174,3113
11.07.2018 21:00,3169,60.74,127,148,3042
11.07.2018 22:00,3026,46.82,102,123,2924
11.07.2018 23:00,2843,44.79,77,100,2766
11.08.2018 00:00,2590,43.53,55,78,2535
11.08.2018 01:00,2454,43.73,28,29,2426
11.08.2018 02:00,2400,43.33,17,20,2383
11.08.2018 03:00,2378,42.89,15,16,2363
11.08.2018 04:00,2391,42.92,11,16,2380
11.08.2018 05:00,2429,43.5,12,18,2417
11.08.2018 06:00,2644,45.66,15,20,2629
11.08.2018 07:00,3046,53.54,19,24,3027
11.08.2018 08:00,3343,67,17,25,3326
11.08.2018 09:00,3419,68.95,17,25,3402
11.08.2018 10:00,3404,68.82,15,24,3389
11.08.2018 11:00,3409,67.71,13,22,3396
11.08.2018 12:00,3357,65.81,10,21,3347
11.08.2018 13:00,3338,64.97,8,22,3330
11.08.2018 14:00,3334,65.06,8,21,3326
11.08.2018 15:00,3314,67.49,17,21,3297
11.08.2018 16:00,3327,68.49,12,22,3315
11.08.2018 17:00,3380,72.63,20,26,3360
11.08.2018 18:00,3457,92.18,24,31,3433
11.08.2018 19:00,3357,90.06,32,39,3325
11.08.2018 20:00,3245,75.82,34,43,3211
11.08.2018 21:00,3121,67.41,36,46,3085
11.08.2018 22:00,2992,59.16,39,47,2953
11.08.2018 23:00,2787,45.02,42,47,2745
11.09.2018 00:00,2604,43.84,41,45,2563
11.09.2018 01:00,2452,44.8,26,27,2426
11.09.2018 02:00,2359,44.14,26,26,2333
11.09.2018 03:00,2324,43.66,27,28,2297
11.09.2018 04:00,2336,43.7,31,31,2305
11.09.2018 05:00,2366,44.08,33,33,2333
11.09.2018 06:00,2550,46.1,33,35,2517
11.09.2018 07:00,2900,59.69,35,38,2865
11.09.2018 08:00,3241,69.06,35,41,3206
11.09.2018 09:00,3299,72.56,45,47,3254
11.09.2018 10:00,3308,66.3,51,54,3257
11.09.2018 11:00,3362,66.07,60,58,3302
11.09.2018 12:00,3378,64.41,63,62,3315
11.09.2018 13:00,3338,62.22,74,69,3264
11.09.2018 14:00,3249,60.66,93,75,3156
11.09.2018 15:00,3186,61.33,99,80,3087
11.09.2018 16:00,3190,63.26,106,85,3084
11.09.2018 17:00,3278,65.78,118,98,3160
11.09.2018 18:00,3313,69.72,118,116,3195
11.09.2018 19:00,3220,66.53,135,138,3085
11.09.2018 20:00,3049,62.06,146,156,2903
11.09.2018 21:00,2868,53.83,174,170,2694
11.09.2018 22:00,2673,45.38,186,183,2487
11.09.2018 23:00,2527,44.26,189,187,2338
11.10.2018 00:00,2329,42.71,205,187,2124
11.10.2018 01:00,2137,42.69,203,161,1934
11.10.2018 02:00,2053,41.48,201,174,1852
11.10.2018 03:00,2062,40.49,205,192,1857
11.10.2018 04:00,2071,40.03,212,220,1859
11.10.2018 05:00,2026,40.03,243,250,1783
11.10.2018 06:00,2075,40.95,270,283,1805
11.10.2018 07:00,2156,41.54,315,322,1841
11.10.2018 08:00,2265,42.23,367,365,1898
11.10.2018 09:00,2449,42.71,409,411,2040
11.10.2018 10:00,2643,43.23,450,453,2193
11.10.2018 11:00,2771,43.69,497,497,2274
11.10.2018 12:00,2792,43.75,545,541,2247
11.10.2018 13:00,2811,43.74,583,584,2228
11.10.2018 14:00,2814,42.87,608,606,2206
11.10.2018 15:00,2827,43.99,620,610,2207
11.10.2018 16:00,2835,44.49,639,619,2196
11.10.2018 17:00,2949,45.16,668,648,2281
11.10.2018 18:00,3009,45.89,705,688,2304
11.10.2018 19:00,2914,45.32,726,725,2188
11.10.2018 20:00,2818,44.35,736,737,2082
11.10.2018 21:00,2689,42.93,705,731,1984
11.10.2018 22:00,2529,41.21,686,714,1843
11.10.2018 23:00,2354,41.19,690,694,1664
11.11.2018 00:00,2194,39.58,673,674,1521
11.11.2018 01:00,2085,40.12,644,634,1441
11.11.2018 02:00,2050,38.35,673,657,1377
11.11.2018 03:00,2043,37.93,693,692,1350
11.11.2018 04:00,2089,35.84,730,723,1359
11.11.2018 05:00,2087,34.89,759,739,1328
11.11.2018 06:00,2085,34.98,765,741,1320
11.11.2018 07:00,2106,35.93,755,740,1351
11.11.2018 08:00,2237,37.98,754,735,1483
11.11.2018 09:00,2379,40.05,739,718,1640
11.11.2018 10:00,2572,41.26,707,692,1865
11.11.2018 11:00,2699,42.08,660,645,2039
11.11.2018 12:00,2731,42.25,620,584,2111
11.11.2018 13:00,2766,41.14,571,526,2195
11.11.2018 14:00,2744,40.36,519,487,2225
11.11.2018 15:00,2733,40.85,501,461,2232
11.11.2018 16:00,2748,42.38,474,446,2274
11.11.2018 17:00,2911,44.75,471,447,2440
11.11.2018 18:00,2968,45.63,491,453,2477
11.11.2018 19:00,3027,45.12,509,460,2518
11.11.2018 20:00,2919,43.85,499,468,2420
11.11.2018 21:00,2797,43.04,497,480,2300
11.11.2018 22:00,2614,41.64,512,493,2102
11.11.2018 23:00,2457,41.68,511,495,1946
11.12.2018 00:00,2325,38.58,501,493,1824
11.12.2018 01:00,2312,36.1,503,517,1809
11.12.2018 02:00,2313,37.8,468,488,1845
11.12.2018 03:00,2322,38.26,436,450,1886
11.12.2018 04:00,2334,39.2,394,415,1940
11.12.2018 05:00,2333,39.05,355,381,1978
11.12.2018 06:00,2497,43.07,329,348,2168
11.12.2018 07:00,2934,46.41,298,316,2636
11.12.2018 08:00,3243,47.99,262,278,2981
11.12.2018 09:00,3361,48.57,215,230,3146
11.12.2018 10:00,3341,51.98,174,189,3167
11.12.2018 11:00,3369,51.95,132,168,3237
11.12.2018 12:00,3386,51.98,134,152,3252
11.12.2018 13:00,3313,52.77,108,134,3205
11.12.2018 14:00,3329,52.77,109,122,3220
11.12.2018 15:00,3333,52.49,128,125,3205
11.12.2018 16:00,3374,52.38,135,149,3239
11.12.2018 17:00,3475,53.14,142,188,3333
11.12.2018 18:00,3490,53.27,150,234,3340
11.12.2018 19:00,3362,53.01,195,282,3167
11.12.2018 20:00,3253,52.02,203,317,3050
11.12.2018 21:00,3169,46.48,228,349,2941
11.12.2018 22:00,2885,45.78,236,387,2649
11.12.2018 23:00,2679,44.25,259,443,2420
13.11.2018 00:00,2498,41.81,310,493,2188
13.11.2018 01:00,2319,42.87,231,239,2088
13.11.2018 02:00,2293,42.62,239,256,2054
13.11.2018 03:00,2286,42.5,251,267,2035
13.11.2018 04:00,2303,42.48,256,274,2047
13.11.2018 05:00,2398,42.93,259,275,2139
13.11.2018 06:00,2634,44.98,251,276,2383
13.11.2018 07:00,3047,51.01,252,276,2795
13.11.2018 08:00,3379,58.25,254,271,3125
13.11.2018 09:00,3457,59.31,254,260,3203
13.11.2018 10:00,3400,60.03,216,258,3184
13.11.2018 11:00,3453,59.6,209,273,3244
13.11.2018 12:00,3462,53.13,249,291,3213
13.11.2018 13:00,3388,48.52,258,309,3130
13.11.2018 14:00,3360,47.91,295,322,3065
13.11.2018 15:00,3289,48.31,344,333,2945
13.11.2018 16:00,3287,49.94,377,350,2910
13.11.2018 17:00,3455,51.65,375,370,3080
13.11.2018 18:00,3479,60.08,403,393,3076
13.11.2018 19:00,3386,59.28,436,422,2950
13.11.2018 20:00,3231,54.31,450,436,2781
13.11.2018 21:00,2970,48.05,478,437,2492
13.11.2018 22:00,2784,46.69,463,429,2321
13.11.2018 23:00,2571,45.52,446,419,2125
14.11.2018 00:00,2365,43.68,434,415,1931
14.11.2018 01:00,2232,43.14,453,437,1779
14.11.2018 02:00,2150,43.13,418,428,1732
14.11.2018 03:00,2172,43.15,404,410,1768
14.11.2018 04:00,2220,44.2,388,385,1832
14.11.2018 05:00,2302,44.94,351,354,1951
14.11.2018 06:00,2460,46.97,318,327,2142
14.11.2018 07:00,2885,53.39,298,304,2587
14.11.2018 08:00,3147,62.73,275,286,2872
14.11.2018 09:00,3257,63,256,270,3001
14.11.2018 10:00,3274,65.42,234,261,3040
14.11.2018 11:00,3300,65.53,221,245,3079
14.11.2018 12:00,3282,64.45,203,228,3079
14.11.2018 13:00,3194,62.23,176,210,3018
14.11.2018 14:00,3199,63.75,154,176,3045
14.11.2018 15:00,3190,64.32,127,141,3063
14.11.2018 16:00,3223,68.42,119,115,3104
14.11.2018 17:00,3286,72.2,114,111,3172
14.11.2018 18:00,3372,81.47,118,124,3254
14.11.2018 19:00,3316,76.29,133,141,3183
14.11.2018 20:00,3172,73.1,148,153,3024
14.11.2018 21:00,3054,62.72,171,166,2883
14.11.2018 22:00,2898,48.2,172,179,2726
14.11.2018 23:00,2684,46.69,173,181,2511
15.11.2018 00:00,2488,45.18,169,174,2319
15.11.2018 01:00,2418,44.76,199,210,2219
15.11.2018 02:00,2401,44.07,203,214,2198
15.11.2018 03:00,2373,43.77,201,215,2172
15.11.2018 04:00,2415,43.52,199,216,2216
15.11.2018 05:00,2485,44.67,201,214,2284
15.11.2018 06:00,2655,46.18,201,209,2454
15.11.2018 07:00,3008,55.81,196,206,2812
15.11.2018 08:00,3332,71.41,192,203,3140
15.11.2018 09:00,3337,72.66,181,194,3156
15.11.2018 10:00,3305,73.27,181,190,3124
15.11.2018 11:00,3351,69.88,177,185,3174
15.11.2018 12:00,3318,66.76,174,180,3144
15.11.2018 13:00,3227,67.19,152,174,3075
15.11.2018 14:00,3172,65.89,153,168,3019
15.11.2018 15:00,3216,66.79,149,164,3067
15.11.2018 16:00,3318,71.35,152,167,3166
15.11.2018 17:00,3375,72.69,171,179,3204
15.11.2018 18:00,3400,79.7,206,194,3194
15.11.2018 19:00,3266,71.34,234,212,3032
15.11.2018 20:00,3242,63.08,235,232,3007
15.11.2018 21:00,3154,58.01,262,257,2892
15.11.2018 22:00,2955,47.21,297,280,2658
15.11.2018 23:00,2749,46.02,309,295,2440
16.11.2018 00:00,2515,44.99,322,307,2193
16.11.2018 01:00,2402,44.88,358,338,2044
16.11.2018 02:00,2315,44.41,362,339,1953
16.11.2018 03:00,2285,44.05,381,336,1904
16.11.2018 04:00,2293,44.19,380,333,1913
16.11.2018 05:00,2304,44.66,375,332,1929
16.11.2018 06:00,2552,46.45,361,337,2191
16.11.2018 07:00,3001,56.15,353,347,2648
16.11.2018 08:00,3382,64.94,365,355,3017
16.11.2018 09:00,3403,70.06,367,361,3036
16.11.2018 10:00,3375,67.11,366,365,3009
16.11.2018 11:00,3357,67.51,366,356,2991
16.11.2018 12:00,3289,61.97,362,339,2927
16.11.2018 13:00,3186,58.74,335,321,2851
16.11.2018 14:00,3146,61.83,293,291,2853
16.11.2018 15:00,3188,65.25,249,254,2939
16.11.2018 16:00,3199,66.05,238,231,2961
16.11.2018 17:00,3164,68.29,242,227,2922
16.11.2018 18:00,3186,67.76,254,232,2932
16.11.2018 19:00,3033,58.41,283,241,2750
16.11.2018 20:00,2898,50.78,272,241,2626
16.11.2018 21:00,2760,46.08,278,233,2482
16.11.2018 22:00,2636,45.77,270,222,2366
16.11.2018 23:00,2552,45.23,243,196,2309
17.11.2018 00:00,2425,43.8,208,163,2217
17.11.2018 01:00,2373,43.71,239,215,2134
17.11.2018 02:00,2289,39.38,181,168,2108
17.11.2018 03:00,2300,42.87,150,131,2150
17.11.2018 04:00,2319,42.03,127,103,2192
17.11.2018 05:00,2340,42.87,109,91,2231
17.11.2018 06:00,2385,42.18,102,86,2283
17.11.2018 07:00,2495,44.22,87,82,2408
17.11.2018 08:00,2656,45.2,77,72,2579
17.11.2018 09:00,2793,46.15,64,58,2729
17.11.2018 10:00,2925,46.9,55,48,2870
17.11.2018 11:00,2985,46.82,44,41,2941
17.11.2018 12:00,3015,46.9,36,36,2979
17.11.2018 13:00,2964,46.4,29,33,2935
17.11.2018 14:00,2911,46.4,25,30,2886
17.11.2018 15:00,2871,46.89,32,32,2839
17.11.2018 16:00,2957,51.56,40,41,2917
17.11.2018 17:00,3155,59.66,51,54,3104
17.11.2018 18:00,3249,58.2,59,63,3190
17.11.2018 19:00,3191,60.62,69,74,3122
17.11.2018 20:00,3047,58.12,79,83,2968
17.11.2018 21:00,2927,51.62,89,91,2838
17.11.2018 22:00,2814,47.02,106,105,2708
17.11.2018 23:00,2715,46.92,122,118,2593
18.11.2018 00:00,2583,45.39,140,133,2443
18.11.2018 01:00,2468,46.2,134,136,2334
18.11.2018 02:00,2349,43.9,154,152,2195
18.11.2018 03:00,2240,42.94,184,183,2056
18.11.2018 04:00,2265,43.93,217,219,2048
18.11.2018 05:00,2263,44.28,256,260,2007
18.11.2018 06:00,2268,43.8,297,304,1971
18.11.2018 07:00,2325,44.9,357,356,1968
18.11.2018 08:00,2392,45.51,430,404,1962
18.11.2018 09:00,2512,46.36,482,442,2030
18.11.2018 10:00,2685,47.99,517,480,2168
18.11.2018 11:00,2697,47.96,537,508,2160
18.11.2018 12:00,2778,48.4,569,524,2209
18.11.2018 13:00,2893,48.95,565,538,2328
18.11.2018 14:00,2850,48.27,588,555,2262
18.11.2018 15:00,2829,48.4,600,568,2229
18.11.2018 16:00,2850,49.91,621,587,2229
18.11.2018 17:00,3008,50.93,664,604,2344
18.11.2018 18:00,3068,52.39,676,618,2392
18.11.2018 19:00,3099,51.9,702,636,2397
18.11.2018 20:00,3010,49.52,689,645,2321
18.11.2018 21:00,2880,46.96,683,645,2197
18.11.2018 22:00,2682,46.15,662,636,2020
18.11.2018 23:00,2546,46.47,638,619,1908
19.11.2018 00:00,2447,44.16,621,601,1826
19.11.2018 01:00,2431,41.97,683,697,1748
19.11.2018 02:00,2384,41.71,691,706,1693
19.11.2018 03:00,2330,40.13,709,725,1621
19.11.2018 04:00,2314,39.91,752,748,1562
19.11.2018 05:00,2354,41.55,791,771,1563
19.11.2018 06:00,2561,45.62,810,790,1751
19.11.2018 07:00,3032,48.08,818,804,2214
19.11.2018 08:00,3445,53.69,821,799,2624
19.11.2018 09:00,3542,53.67,840,795,2702
19.11.2018 10:00,3527,53.17,841,796,2686
19.11.2018 11:00,3566,52.28,834,797,2732
19.11.2018 12:00,3536,51.97,827,802,2709
19.11.2018 13:00,3462,51.5,814,803,2648
19.11.2018 14:00,3421,51.59,801,785,2620
19.11.2018 15:00,3441,52.16,777,757,2664
19.11.2018 16:00,3515,53.09,764,730,2751
19.11.2018 17:00,3609,53.63,743,711,2866
19.11.2018 18:00,3678,56.43,731,702,2947
19.11.2018 19:00,3614,53.11,712,694,2902
19.11.2018 20:00,3510,51.18,679,673,2831
19.11.2018 21:00,3340,47.56,663,642,2677
19.11.2018 22:00,3129,46.21,638,609,2491
19.11.2018 23:00,2868,44.64,624,580,2244
20.11.2018 00:00,2717,40.6,596,554,2121
20.11.2018 01:00,2644,39.1,608,622,2036
20.11.2018 02:00,2583,37.01,603,611,1980
20.11.2018 03:00,2479,37.83,618,603,1861
20.11.2018 04:00,2489,37.06,616,604,1873
20.11.2018 05:00,2545,40.14,600,610,1945
20.11.2018 06:00,2730,44.03,604,615,2126
20.11.2018 07:00,3089,46.58,593,619,2496
20.11.2018 08:00,3458,50.5,594,611,2864
20.11.2018 09:00,3504,51.66,585,595,2919
20.11.2018 10:00,3569,49.78,553,578,3016
20.11.2018 11:00,3581,48.94,562,576,3019
20.11.2018 12:00,3511,48.78,544,585,2967
20.11.2018 13:00,3435,48.44,567,604,2868
20.11.2018 14:00,3389,49.05,589,625,2800
20.11.2018 15:00,3415,50.11,622,640,2793
20.11.2018 16:00,3515,51.49,642,657,2873
20.11.2018 17:00,3553,52.88,661,687,2892
20.11.2018 18:00,3654,58.68,723,726,2931
20.11.2018 19:00,3598,51.62,785,768,2813
20.11.2018 20:00,3445,50.63,772,789,2673
20.11.2018 21:00,3288,49.46,787,782,2501
20.11.2018 22:00,3129,48.86,767,764,2362
20.11.2018 23:00,2882,47.12,748,745,2134
21.11.2018 00:00,2677,44.65,718,728,1959
21.11.2018 01:00,2528,44.52,622,657,1906
21.11.2018 02:00,2495,42.83,639,644,1856
21.11.2018 03:00,2524,42.43,638,648,1886
21.11.2018 04:00,2547,42.17,637,655,1910
21.11.2018 05:00,2554,43.22,686,669,1868
21.11.2018 06:00,2691,45.64,685,682,2006
21.11.2018 07:00,3113,49.52,700,692,2413
21.11.2018 08:00,3515,55.94,694,682,2821
21.11.2018 09:00,3557,57.58,712,659,2845
21.11.2018 10:00,3528,52.9,688,634,2840
21.11.2018 11:00,3603,54.41,678,615,2925
21.11.2018 12:00,3576,56.85,654,595,2922
21.11.2018 13:00,3623,56.86,619,577,3004
21.11.2018 14:00,3630,58.13,573,548,3057
21.11.2018 15:00,3622,64.2,516,514,3106
21.11.2018 16:00,3703,65,471,483,3232
21.11.2018 17:00,3757,68.31,442,463,3315
21.11.2018 18:00,3727,69.24,438,452,3289
21.11.2018 19:00,3568,65.43,463,444,3105
21.11.2018 20:00,3466,59.69,452,425,3014
21.11.2018 21:00,3372,58.46,402,390,2970
21.11.2018 22:00,3165,50.41,362,351,2803
21.11.2018 23:00,2966,49.2,331,310,2635
22.11.2018 00:00,2738,47.61,288,274,2450
22.11.2018 01:00,2607,47.15,263,252,2344
22.11.2018 02:00,2534,46.65,241,224,2293
22.11.2018 03:00,2507,46.37,219,202,2288
22.11.2018 04:00,2538,46.53,199,186,2339
22.11.2018 05:00,2648,47.37,168,178,2480
22.11.2018 06:00,2843,49.46,162,172,2681
22.11.2018 07:00,3240,61.26,152,166,3088
22.11.2018 08:00,3609,80.94,138,155,3471
22.11.2018 09:00,3657,80.03,134,144,3523
22.11.2018 10:00,3674,85.3,125,135,3549
22.11.2018 11:00,3714,81.99,133,124,3581
22.11.2018 12:00,3718,90.7,135,115,3583
22.11.2018 13:00,3711,88.69,125,106,3586
22.11.2018 14:00,3719,92.87,122,100,3597
22.11.2018 15:00,3685,93.24,113,92,3572
22.11.2018 16:00,3743,94.37,96,86,3647
22.11.2018 17:00,3794,103,98,88,3696
22.11.2018 18:00,3812,128.26,102,93,3710
22.11.2018 19:00,3715,109.94,104,102,3611
22.11.2018 20:00,3607,84.08,104,103,3503
22.11.2018 21:00,3494,78.18,103,100,3391
22.11.2018 22:00,3303,60.46,101,97,3202
22.11.2018 23:00,3093,52.57,90,93,3003
23.11.2018 00:00,2946,49.56,87,87,2859
23.11.2018 01:00,2817,49.73,64,61,2753
23.11.2018 02:00,2767,49.12,63,59,2704
23.11.2018 03:00,2710,48.53,63,59,2647
23.11.2018 04:00,2715,48.67,62,61,2653
23.11.2018 05:00,2776,49.33,64,63,2712
23.11.2018 06:00,2960,50.67,62,67,2898
23.11.2018 07:00,3297,71.26,69,73,3228
23.11.2018 08:00,3587,95,69,77,3518
23.11.2018 09:00,3734,103.46,80,81,3654
23.11.2018 10:00,3710,98,75,87,3635
23.11.2018 11:00,3752,94.84,72,88,3680
23.11.2018 12:00,3772,98.93,75,84,3697
23.11.2018 13:00,3696,98.28,67,78,3629
23.11.2018 14:00,3691,94.9,66,72,3625
23.11.2018 15:00,3660,93.6,60,64,3600
23.11.2018 16:00,3670,92.17,61,58,3609
23.11.2018 17:00,3715,97.09,55,55,3660
23.11.2018 18:00,3675,106.58,53,52,3622
23.11.2018 19:00,3587,93.72,34,51,3553
23.11.2018 20:00,3468,84.05,29,48,3439
23.11.2018 21:00,3291,73.75,26,44,3265
23.11.2018 22:00,3152,57.78,29,40,3123
23.11.2018 23:00,3033,53.25,25,36,3008
24.11.2018 00:00,2875,47.5,23,32,2852
24.11.2018 01:00,2769,48.46,14,19,2755
24.11.2018 02:00,2673,47.94,14,17,2659
24.11.2018 03:00,2628,46.61,15,17,2613
24.11.2018 04:00,2632,47.06,16,19,2616
24.11.2018 05:00,2637,47.55,19,21,2618
24.11.2018 06:00,2696,47.95,18,23,2678
24.11.2018 07:00,2819,48.12,23,29,2796
24.11.2018 08:00,2960,52.07,27,32,2933
24.11.2018 09:00,3023,61.66,30,37,2993
24.11.2018 10:00,3151,70.47,34,45,3117
24.11.2018 11:00,3205,71.73,41,53,3164
24.11.2018 12:00,3220,71.41,48,60,3172
24.11.2018 13:00,3203,71.26,56,69,3147
24.11.2018 14:00,3245,65.32,68,85,3177
24.11.2018 15:00,3209,63.02,92,106,3117
24.11.2018 16:00,3287,63.48,112,134,3175
24.11.2018 17:00,3454,68.11,134,158,3320
24.11.2018 18:00,3498,74.5,153,185,3345
24.11.2018 19:00,3430,69.1,174,214,3256
24.11.2018 20:00,3349,70.07,192,234,3157
24.11.2018 21:00,3231,60.48,212,251,3019
24.11.2018 22:00,3119,52.19,229,265,2890
24.11.2018 23:00,2975,49.21,231,272,2744
25.11.2018 00:00,2867,48.12,245,279,2622
25.11.2018 01:00,2793,48.43,231,235,2562
25.11.2018 02:00,2751,47.9,239,246,2512
25.11.2018 03:00,2702,47.23,240,251,2462
25.11.2018 04:00,2668,46.91,247,260,2421
25.11.2018 05:00,2646,46.57,262,270,2384
25.11.2018 06:00,2646,46.92,271,282,2375
25.11.2018 07:00,2757,47.91,286,298,2471
25.11.2018 08:00,2893,47.97,293,300,2600
25.11.2018 09:00,3046,49.27,294,298,2752
25.11.2018 10:00,3170,53.87,295,294,2875
25.11.2018 11:00,3223,54.96,286,279,2937
25.11.2018 12:00,3273,56.95,261,256,3012
25.11.2018 13:00,3248,51.69,249,241,2999
25.11.2018 14:00,3220,49.87,260,245,2960
25.11.2018 15:00,3270,55.02,274,257,2996
25.11.2018 16:00,3315,50.35,283,283,3032
25.11.2018 17:00,3514,59.99,305,310,3209
25.11.2018 18:00,3594,66.03,323,327,3271
25.11.2018 19:00,3599,63.87,334,337,3265
25.11.2018 20:00,3541,51.68,340,329,3201
25.11.2018 21:00,3467,51.19,322,313,3145
25.11.2018 22:00,3361,49.71,301,296,3060
25.11.2018 23:00,3249,49.41,277,279,2972
26.11.2018 00:00,3104,47.88,249,262,2855
26.11.2018 01:00,3016,48.27,171,167,2845
26.11.2018 02:00,2964,47.85,156,151,2808
26.11.2018 03:00,2944,46.42,144,140,2800
26.11.2018 04:00,2989,45.07,136,132,2853
26.11.2018 05:00,3061,45.08,122,120,2939
26.11.2018 06:00,3254,48.8,106,106,3148
26.11.2018 07:00,3722,56.66,89,92,3633
26.11.2018 08:00,4113,79.27,77,79,4036
26.11.2018 09:00,4207,83.08,70,67,4137
26.11.2018 10:00,4125,80.95,62,57,4063
26.11.2018 11:00,4038,78.33,49,51,3989
26.11.2018 12:00,3916,84.9,38,45,3878
26.11.2018 13:00,3886,84.85,40,40,3846
26.11.2018 14:00,3851,90.2,44,41,3807
26.11.2018 15:00,3851,92.47,67,54,3784
26.11.2018 16:00,3933,95,103,80,3830
26.11.2018 17:00,4035,100.02,122,107,3913
26.11.2018 18:00,4135,105.02,145,123,3990
26.11.2018 19:00,4101,94.05,164,137,3937
26.11.2018 20:00,4010,74.76,175,146,3835
26.11.2018 21:00,3841,62.05,179,149,3662
26.11.2018 22:00,3671,52.97,181,152,3490
26.11.2018 23:00,3500,50.64,190,156,3310
27.11.2018 00:00,3329,49.06,199,164,3130
27.11.2018 01:00,3248,49.01,191,189,3057
27.11.2018 02:00,3266,48.26,184,189,3082
27.11.2018 03:00,3254,48.05,184,192,3070
27.11.2018 04:00,3322,48.45,195,197,3127
27.11.2018 05:00,3373,49.32,197,201,3176
27.11.2018 06:00,3590,51.34,199,201,3391
27.11.2018 07:00,3888,70.18,201,201,3687
27.11.2018 08:00,4244,93.03,199,192,4045
27.11.2018 09:00,4375,100,180,175,4195
27.11.2018 10:00,4349,99,157,156,4192
27.11.2018 11:00,4292,93.37,130,131,4162
27.11.2018 12:00,4207,95,106,104,4101
27.11.2018 13:00,4074,88.98,86,85,3988
27.11.2018 14:00,4023,88.21,82,83,3941
27.11.2018 15:00,4013,85.99,94,102,3919
27.11.2018 16:00,4117,86.94,121,140,3996
27.11.2018 17:00,4296,89.34,158,172,4138
27.11.2018 18:00,4385,98.27,181,191,4204
27.11.2018 19:00,4333,92.43,184,202,4149
27.11.2018 20:00,4249,82.76,182,204,4067
27.11.2018 21:00,4143,68.48,182,201,3961
27.11.2018 22:00,3982,56.98,192,198,3790
27.11.2018 23:00,3807,53.12,198,196,3609
28.11.2018 00:00,3580,49.49,206,195,3374
28.11.2018 01:00,3400,48.97,205,186,3195
28.11.2018 02:00,3327,47.57,212,186,3115
28.11.2018 03:00,3300,47.01,211,187,3089
28.11.2018 04:00,3287,46.28,235,190,3052
28.11.2018 05:00,3314,46.73,233,202,3081
28.11.2018 06:00,3489,48.95,251,221,3238
28.11.2018 07:00,3898,55.78,291,245,3607
28.11.2018 08:00,4216,67.76,292,271,3924
28.11.2018 09:00,4269,70,312,300,3957
28.11.2018 10:00,4200,65.29,321,326,3879
28.11.2018 11:00,4170,55.22,341,349,3829
28.11.2018 12:00,4120,52.26,391,374,3729
28.11.2018 13:00,4003,51.61,409,410,3594
28.11.2018 14:00,4001,51.61,477,466,3524
28.11.2018 15:00,3976,51.93,542,544,3434
28.11.2018 16:00,4053,55.88,625,639,3428
28.11.2018 17:00,4098,59.27,729,737,3369
28.11.2018 18:00,4109,60.76,821,820,3288
28.11.2018 19:00,3977,50.39,902,898,3075
28.11.2018 20:00,3891,49.21,991,986,2900
28.11.2018 21:00,3736,47.79,1072,1071,2664
28.11.2018 22:00,3566,46.21,1145,1148,2421
28.11.2018 23:00,3359,44.91,1195,1207,2164
29.11.2018 00:00,3164,38.91,1237,1249,1927
29.11.2018 01:00,3101,40.9,1271,1270,1830
29.11.2018 02:00,3091,35.96,1294,1298,1797
29.11.2018 03:00,3031,34.26,1315,1319,1716
29.11.2018 04:00,3068,35.01,1329,1334,1739
29.11.2018 05:00,3102,38.98,1343,1343,1759
29.11.2018 06:00,3262,43.69,1344,1346,1918
29.11.2018 07:00,3683,47.88,1340,1343,2343
29.11.2018 08:00,4042,49.6,1320,1331,2722
29.11.2018 09:00,4104,49.6,1303,1312,2801
29.11.2018 10:00,4122,48.94,1288,1292,2834
29.11.2018 11:00,4160,48.65,1272,1270,2888
29.11.2018 12:00,4191,48.65,1245,1244,2946
29.11.2018 13:00,4149,48.65,1196,1214,2953
29.11.2018 14:00,4170,48.78,1179,1194,2991
29.11.2018 15:00,4206,48.65,1202,1192,3004
29.11.2018 16:00,4268,48.83,1227,1197,3041
29.11.2018 17:00,4218,48.77,1221,1214,2997
29.11.2018 18:00,4154,48.88,1234,1234,2920
29.11.2018 19:00,4090,48.68,1273,1254,2817
29.11.2018 20:00,3980,48,1281,1268,2699
29.11.2018 21:00,3773,46.74,1288,1275,2485
29.11.2018 22:00,3552,45.63,1293,1274,2259
29.11.2018 23:00,3325,42.73,1283,1266,2042
30.11.2018 00:00,3138,39.34,1267,1254,1871
30.11.2018 01:00,3029,35.26,1249,1194,1780
30.11.2018 02:00,2979,36.77,1224,1164,1755
30.11.2018 03:00,2954,36.63,1200,1185,1754
30.11.2018 04:00,2894,36.96,1167,1154,1727
30.11.2018 05:00,2966,39.51,1149,1127,1817
30.11.2018 06:00,3122,43.05,1130,1105,1992
30.11.2018 07:00,3544,46.61,1111,1085,2433
30.11.2018 08:00,4031,48.56,1087,1064,2944
30.11.2018 09:00,4137,48.97,1100,1036,3037
30.11.2018 10:00,4055,48.67,1039,1007,3016
30.11.2018 11:00,4061,48.13,994,974,3067
30.11.2018 12:00,4041,47.95,962,941,3079
30.11.2018 13:00,3997,47.92,901,905,3096
30.11.2018 14:00,3979,47.98,855,869,3124
30.11.2018 15:00,3989,47.99,845,842,3144
30.11.2018 16:00,3989,48.36,835,820,3154
30.11.2018 17:00,3903,60.7,837,810,3066
30.11.2018 18:00,3871,60.22,835,805,3036
30.11.2018 19:00,3778,51.72,826,798,2952
30.11.2018 20:00,3621,47.52,808,788,2813
30.11.2018 21:00,3498,46.08,784,769,2714
30.11.2018 22:00,3312,45.67,769,745,2543
30.11.2018 23:00,3078,44.8,727,716,2351
12.01.2018 00:00,2893,43.22,716,686,2177
12.01.2018 01:00,2733,43.25,693,725,2040
12.01.2018 02:00,2672,42.09,660,694,2012
12.01.2018 03:00,2638,41.07,639,660,1999
12.01.2018 04:00,2645,42.05,612,638,2033
12.01.2018 05:00,2638,43.5,586,614,2052
12.01.2018 06:00,2705,43.37,575,588,2130
12.01.2018 07:00,2851,42.89,551,565,2300
12.01.2018 08:00,3101,45.6,518,539,2583
12.01.2018 09:00,3255,46.37,482,512,2773
12.01.2018 10:00,3352,47.06,454,486,2898
12.01.2018 11:00,3395,47.46,434,463,2961
12.01.2018 12:00,3411,47.8,417,447,2994
12.01.2018 13:00,3391,47.7,407,434,2984
12.01.2018 14:00,3341,47.61,386,413,2955
12.01.2018 15:00,3308,47.93,346,390,2962
12.01.2018 16:00,3407,48.45,334,373,3073
12.01.2018 17:00,3512,48.97,349,369,3163
12.01.2018 18:00,3507,56.95,356,372,3151
12.01.2018 19:00,3414,48.41,365,383,3049
12.01.2018 20:00,3303,46.56,350,386,2953
12.01.2018 21:00,3129,45.57,344,381,2785
12.01.2018 22:00,2971,45.45,347,376,2624
12.01.2018 23:00,2805,43.06,330,382,2475
12.02.2018 00:00,2685,38.63,341,393,2344
12.02.2018 01:00,2544,43.33,308,354,2236
12.02.2018 02:00,2460,42.16,305,370,2155
12.02.2018 03:00,2433,41.83,334,399,2099
12.02.2018 04:00,2455,40.55,365,432,2090
12.02.2018 05:00,2463,41.35,399,474,2064
12.02.2018 06:00,2489,41.66,435,522,2054
12.02.2018 07:00,2520,42.96,500,574,2020
12.02.2018 08:00,2620,43.96,545,620,2075
12.02.2018 09:00,2688,44.48,590,655,2098
12.02.2018 10:00,2874,45.29,618,676,2256
12.02.2018 11:00,3023,46.18,646,674,2377
12.02.2018 12:00,3158,46.53,642,661,2516
12.02.2018 13:00,3226,46.54,616,644,2610
12.02.2018 14:00,3246,46.57,623,638,2623
12.02.2018 15:00,3284,46.25,634,642,2650
12.02.2018 16:00,3340,46.74,639,647,2701
12.02.2018 17:00,3441,47.29,641,642,2800
12.02.2018 18:00,3477,47.56,617,630,2860
12.02.2018 19:00,3416,47.38,584,611,2832
12.02.2018 20:00,3342,46.7,547,573,2795
12.02.2018 21:00,3193,45.87,501,522,2692
12.02.2018 22:00,3005,45.1,454,473,2551
12.02.2018 23:00,2792,43.09,400,438,2392
12.03.2018 00:00,2582,39.22,372,411,2210
12.03.2018 01:00,2508,43.52,383,415,2125
12.03.2018 02:00,2462,41.93,368,397,2094
12.03.2018 03:00,2423,40.77,349,379,2074
12.03.2018 04:00,2456,40.86,321,362,2135
12.03.2018 05:00,2483,42.01,318,365,2165
12.03.2018 06:00,2656,45.1,335,389,2321
12.03.2018 07:00,3073,47.66,378,427,2695
12.03.2018 08:00,3490,52.38,424,476,3066
12.03.2018 09:00,3551,51.03,484,520,3067
12.03.2018 10:00,3515,50,515,560,3000
12.03.2018 11:00,3443,49.58,537,600,2906
12.03.2018 12:00,3452,49.3,566,636,2886
12.03.2018 13:00,3416,49.2,584,662,2832
12.03.2018 14:00,3503,49.33,614,684,2889
12.03.2018 15:00,3576,49.69,667,705,2909
12.03.2018 16:00,3541,50.07,683,726,2858
12.03.2018 17:00,3609,50.53,703,748,2906
12.03.2018 18:00,3616,50.56,731,778,2885
12.03.2018 19:00,3591,50.02,771,811,2820
12.03.2018 20:00,3388,49.67,813,836,2575
12.03.2018 21:00,3243,48.93,810,859,2433
12.03.2018 22:00,3037,47.56,788,874,2249
12.03.2018 23:00,2848,46.03,786,891,2062
12.04.2018 00:00,2617,44.71,808,909,1809
12.04.2018 01:00,2485,36.22,782,789,1703
12.04.2018 02:00,2345,33.14,825,835,1520
12.04.2018 03:00,2305,34.68,885,889,1420
12.04.2018 04:00,2398,36.08,936,947,1462
12.04.2018 05:00,2444,40.82,1009,1015,1435
12.04.2018 06:00,2655,43.79,1070,1082,1585
12.04.2018 07:00,3076,46.62,1145,1136,1931
12.04.2018 08:00,3461,48.22,1166,1166,2295
12.04.2018 09:00,3552,48.85,1177,1176,2375
12.04.2018 10:00,3537,48.58,1190,1188,2347
12.04.2018 11:00,3556,47.95,1194,1191,2362
12.04.2018 12:00,3550,47.03,1206,1199,2344
12.04.2018 13:00,3437,46.61,1202,1204,2235
12.04.2018 14:00,3453,47.18,1207,1204,2246
12.04.2018 15:00,3457,47.8,1204,1199,2253
12.04.2018 16:00,3566,48.07,1197,1196,2369
12.04.2018 17:00,3715,48.9,1195,1192,2520
12.04.2018 18:00,3787,49.31,1183,1202,2604
12.04.2018 19:00,3707,49.04,1174,1198,2533
12.04.2018 20:00,3656,49.03,1151,1184,2505
12.04.2018 21:00,3607,48.25,1114,1164,2493
12.04.2018 22:00,3417,47.49,1091,1142,2326
12.04.2018 23:00,3195,46.24,1076,1116,2119
12.05.2018 00:00,3002,44.93,1049,1083,1953
12.05.2018 01:00,2912,46.01,970,981,1942
12.05.2018 02:00,2832,45.82,939,926,1893
12.05.2018 03:00,2792,45.94,884,857,1908
12.05.2018 04:00,2725,45.81,815,780,1910
12.05.2018 05:00,2771,46.01,744,704,2027
12.05.2018 06:00,3003,47.3,660,632,2343
12.05.2018 07:00,3455,54.35,582,567,2873
12.05.2018 08:00,3815,52.53,511,508,3304
12.05.2018 09:00,3886,59.01,447,449,3439
12.05.2018 10:00,3858,58.38,387,395,3471
12.05.2018 11:00,3869,54.57,336,344,3533
12.05.2018 12:00,3842,53.06,286,293,3556
12.05.2018 13:00,3743,53.12,252,253,3491
12.05.2018 14:00,3727,52.74,220,239,3507
12.05.2018 15:00,3757,52.94,234,249,3523
12.05.2018 16:00,3809,54.31,255,272,3554
12.05.2018 17:00,3818,57.92,275,290,3543
12.05.2018 18:00,3811,59.01,295,302,3516
12.05.2018 19:00,3753,53.39,320,313,3433
12.05.2018 20:00,3672,61.52,329,326,3343
12.05.2018 21:00,3568,50.63,336,338,3232
12.05.2018 22:00,3379,49.21,330,342,3049
12.05.2018 23:00,3154,48.57,329,338,2825
12.06.2018 00:00,2935,46.54,338,331,2597
12.06.2018 01:00,2792,47.23,341,343,2451
12.06.2018 02:00,2731,46.28,342,340,2389
12.06.2018 03:00,2702,45.87,339,336,2363
12.06.2018 04:00,2679,45.45,359,335,2320
12.06.2018 05:00,2708,45.49,360,336,2348
12.06.2018 06:00,2827,48,374,340,2453
12.06.2018 07:00,3294,51.22,359,348,2935
12.06.2018 08:00,3622,55.54,372,355,3250
12.06.2018 09:00,3692,58.06,389,363,3303
12.06.2018 10:00,3699,57.98,400,365,3299
12.06.2018 11:00,3802,54.56,385,353,3417
12.06.2018 12:00,3796,54.58,356,336,3440
12.06.2018 13:00,3781,56.5,309,321,3472
12.06.2018 14:00,3812,55.17,296,302,3516
12.06.2018 15:00,3885,56.26,282,280,3603
12.06.2018 16:00,3976,59.02,272,269,3704
12.06.2018 17:00,3977,60.5,272,276,3705
12.06.2018 18:00,3917,57.15,288,295,3629
12.06.2018 19:00,3788,54.5,322,315,3466
12.06.2018 20:00,3592,51.91,353,333,3239
12.06.2018 21:00,3405,50.65,364,353,3041
12.06.2018 22:00,3211,49.38,368,382,2843
12.06.2018 23:00,2951,47.76,385,398,2566
12.07.2018 00:00,2670,46.56,427,410,2243
12.07.2018 01:00,2520,45.16,513,494,2007
12.07.2018 02:00,2417,43.87,536,529,1881
12.07.2018 03:00,2366,43.35,593,576,1773
12.07.2018 04:00,2371,43.56,634,620,1737
12.07.2018 05:00,2432,43.67,646,631,1786
12.07.2018 06:00,2598,46.01,619,615,1979
12.07.2018 07:00,3066,48.57,587,585,2479
12.07.2018 08:00,3374,52.09,543,516,2831
12.07.2018 09:00,3477,56.69,448,423,3029
12.07.2018 10:00,3433,54.5,356,336,3077
12.07.2018 11:00,3504,53.23,270,261,3234
12.07.2018 12:00,3530,52.52,195,199,3335
12.07.2018 13:00,3414,50.89,139,158,3275
12.07.2018 14:00,3376,49.79,131,155,3245
12.07.2018 15:00,3348,49.05,170,187,3178
12.07.2018 16:00,3357,48.98,270,253,3087
12.07.2018 17:00,3362,49,365,343,2997
12.07.2018 18:00,3340,49,457,443,2883
12.07.2018 19:00,3229,48.53,551,543,2678
12.07.2018 20:00,3051,47.45,622,618,2429
12.07.2018 21:00,2862,46.24,696,689,2166
12.07.2018 22:00,2673,46.2,754,759,1919
12.07.2018 23:00,2537,44.55,806,803,1731
12.08.2018 00:00,2413,42.08,822,833,1591
12.08.2018 01:00,2280,43.04,844,805,1436
12.08.2018 02:00,2191,40.16,882,846,1309
12.08.2018 03:00,2184,39.07,915,884,1269
12.08.2018 04:00,2245,38.63,929,918,1316
12.08.2018 05:00,2262,38.73,962,949,1300
12.08.2018 06:00,2315,40.13,999,975,1316
12.08.2018 07:00,2432,43.14,1025,997,1407
12.08.2018 08:00,2579,44.32,1034,1015,1545
12.08.2018 09:00,2767,45.57,1029,1025,1738
12.08.2018 10:00,2866,46.34,1036,1032,1830
12.08.2018 11:00,3016,46.47,1030,1042,1986
12.08.2018 12:00,3149,46.65,1046,1043,2103
12.08.2018 13:00,3169,46.53,1034,1041,2135
12.08.2018 14:00,3073,46.42,1048,1045,2025
12.08.2018 15:00,2979,46.43,1077,1051,1902
12.08.2018 16:00,3075,46.73,1082,1057,1993
12.08.2018 17:00,3162,47.07,1110,1077,2052
12.08.2018 18:00,3144,47.17,1161,1107,1983
12.08.2018 19:00,3079,46.82,1186,1138,1893
12.08.2018 20:00,2948,46.3,1217,1175,1731
12.08.2018 21:00,2857,44.5,1247,1214,1610
12.08.2018 22:00,2733,41.22,1281,1250,1452
12.08.2018 23:00,2633,40.2,1314,1281,1319
12.09.2018 00:00,2537,39.24,1341,1309,1196
12.09.2018 01:00,2463,37.06,1355,1345,1108
12.09.2018 02:00,2422,36.05,1344,1340,1078
12.09.2018 03:00,2420,33.25,1286,1307,1134
12.09.2018 04:00,2413,30.4,1235,1250,1178
12.09.2018 05:00,2468,24.28,1152,1176,1316
12.09.2018 06:00,2543,25.71,1028,1057,1515
12.09.2018 07:00,2643,37.24,907,925,1736
12.09.2018 08:00,2738,40.44,785,809,1953
12.09.2018 09:00,2835,43.57,655,679,2180
12.09.2018 10:00,2916,44.78,573,587,2343
12.09.2018 11:00,3006,45.52,480,502,2526
12.09.2018 12:00,3072,45.87,392,464,2680
12.09.2018 13:00,3101,45.87,363,440,2738
12.09.2018 14:00,3092,45.82,368,414,2724
12.09.2018 15:00,3025,45.63,318,398,2707
12.09.2018 16:00,3097,46.1,324,389,2773
12.09.2018 17:00,3226,46.87,354,392,2872
12.09.2018 18:00,3279,46.87,362,406,2917
12.09.2018 19:00,3149,46.64,371,438,2778
12.09.2018 20:00,3043,46.21,507,474,2536
12.09.2018 21:00,2904,45.83,518,513,2386
12.09.2018 22:00,2869,43.72,558,553,2311
12.09.2018 23:00,2920,41.76,564,585,2356
12.10.2018 00:00,2729,38.89,620,613,2109
12.10.2018 01:00,2534,40.78,645,595,1889
12.10.2018 02:00,2448,37.75,657,628,1791
12.10.2018 03:00,2468,37.54,683,662,1785
12.10.2018 04:00,2508,38.39,727,700,1781
12.10.2018 05:00,2571,41.46,759,729,1812
12.10.2018 06:00,2796,45.45,765,747,2031
12.10.2018 07:00,3259,47.44,754,756,2505
12.10.2018 08:00,3712,50.76,743,747,2969
12.10.2018 09:00,3760,51.18,697,725,3063
12.10.2018 10:00,3691,51.22,689,699,3002
12.10.2018 11:00,3663,49.67,681,678,2982
12.10.2018 12:00,3681,49.4,673,660,3008
12.10.2018 13:00,3596,49,666,646,2930
12.10.2018 14:00,3588,48.79,647,636,2941
12.10.2018 15:00,3668,49.11,629,628,3039
12.10.2018 16:00,3811,50.41,629,625,3182
12.10.2018 17:00,3851,50.59,627,624,3224
12.10.2018 18:00,3898,50.68,622,622,3276
12.10.2018 19:00,3796,49.14,615,617,3181
12.10.2018 20:00,3708,49.02,612,602,3096
12.10.2018 21:00,3541,48.1,628,590,2913
12.10.2018 22:00,3304,46.91,647,584,2657
12.10.2018 23:00,3133,45.57,644,602,2489
12.11.2018 00:00,2908,44.54,672,631,2236
12.11.2018 01:00,2795,44.85,662,653,2133
12.11.2018 02:00,2760,43.87,659,650,2101
12.11.2018 03:00,2758,43.17,650,644,2108
12.11.2018 04:00,2799,43,636,639,2163
12.11.2018 05:00,2859,43.96,634,631,2225
12.11.2018 06:00,3066,46.21,624,618,2442
12.11.2018 07:00,3460,48.14,628,600,2832
12.11.2018 08:00,3809,50.2,616,589,3193
12.11.2018 09:00,3866,51.25,592,590,3274
12.11.2018 10:00,3867,51.74,604,593,3263
12.11.2018 11:00,3905,52.26,603,610,3302
12.11.2018 12:00,3951,53,623,639,3328
12.11.2018 13:00,3907,52.82,645,663,3262
12.11.2018 14:00,3872,52.8,650,654,3222
12.11.2018 15:00,3889,53.19,624,629,3265
12.11.2018 16:00,3997,54.62,610,607,3387
12.11.2018 17:00,4030,56.66,602,597,3428
12.11.2018 18:00,4017,56.7,603,593,3414
12.11.2018 19:00,3910,53.81,598,592,3312
12.11.2018 20:00,3826,53.19,586,590,3240
12.11.2018 21:00,3670,52.52,561,581,3109
12.11.2018 22:00,3461,51.01,549,571,2912
12.11.2018 23:00,3279,49.45,532,561,2747
12.12.2018 00:00,3092,48.41,519,552,2573
12.12.2018 01:00,2991,48.82,474,467,2517
12.12.2018 02:00,2853,48.09,454,445,2399
12.12.2018 03:00,2793,47.83,461,432,2332
12.12.2018 04:00,2811,47.82,449,426,2362
12.12.2018 05:00,2877,48.36,423,424,2454
12.12.2018 06:00,3054,51.04,417,419,2637
12.12.2018 07:00,3466,55.32,426,412,3040
12.12.2018 08:00,3834,69.62,409,403,3425
12.12.2018 09:00,3932,75.62,396,389,3536
12.12.2018 10:00,3888,73.66,373,375,3515
12.12.2018 11:00,3920,63.16,356,366,3564
12.12.2018 12:00,3925,62.32,341,357,3584
12.12.2018 13:00,3867,66.06,334,347,3533
12.12.2018 14:00,3877,64.04,321,335,3556
12.12.2018 15:00,3879,65.04,319,325,3560
12.12.2018 16:00,4035,74.94,310,326,3725
12.12.2018 17:00,4112,79.55,324,334,3788
12.12.2018 18:00,4087,76.4,333,341,3754
12.12.2018 19:00,4007,69.99,322,345,3685
12.12.2018 20:00,3928,62.83,319,343,3609
12.12.2018 21:00,3802,53.57,318,337,3484
12.12.2018 22:00,3656,53.48,305,332,3351
12.12.2018 23:00,3474,50.92,312,333,3162
13.12.2018 00:00,3253,49.22,321,338,2932
13.12.2018 01:00,3059,49.57,304,306,2755
13.12.2018 02:00,2978,48.77,298,321,2680
13.12.2018 03:00,2972,48.16,299,334,2673
13.12.2018 04:00,3001,47.86,309,343,2692
13.12.2018 05:00,2992,48.24,327,352,2665
13.12.2018 06:00,3126,50.08,345,360,2781
13.12.2018 07:00,3545,56.05,353,366,3192
13.12.2018 08:00,3898,70.04,366,368,3532
13.12.2018 09:00,4041,74.66,372,368,3669
13.12.2018 10:00,4029,74.08,364,371,3665
13.12.2018 11:00,4073,62.41,373,371,3700
13.12.2018 12:00,4031,58.46,394,372,3637
13.12.2018 13:00,4051,65.46,399,373,3652
13.12.2018 14:00,4065,62.9,403,373,3662
13.12.2018 15:00,4039,63.03,400,373,3639
13.12.2018 16:00,4115,76.1,386,381,3729
13.12.2018 17:00,4124,79.38,429,392,3695
13.12.2018 18:00,4096,68,438,402,3658
13.12.2018 19:00,4034,75.38,459,417,3575
13.12.2018 20:00,3967,61.39,443,424,3524
13.12.2018 21:00,3890,52.81,415,424,3475
13.12.2018 22:00,3710,52.69,418,422,3292
13.12.2018 23:00,3463,50.74,419,413,3044
14.12.2018 00:00,3273,49.65,416,405,2857
14.12.2018 01:00,3068,49.69,380,390,2688
14.12.2018 02:00,2945,48.83,379,377,2566
14.12.2018 03:00,2845,48.39,401,372,2444
14.12.2018 04:00,2912,48.69,362,366,2550
14.12.2018 05:00,2977,49.49,371,362,2606
14.12.2018 06:00,3206,52.98,368,365,2838
14.12.2018 07:00,3618,63.42,364,371,3254
14.12.2018 08:00,3951,75.88,385,375,3566
14.12.2018 09:00,4063,87.92,367,373,3696
14.12.2018 10:00,4076,88.93,362,366,3714
14.12.2018 11:00,4088,81.88,364,355,3724
14.12.2018 12:00,4091,82.31,324,340,3767
14.12.2018 13:00,3990,82.66,313,327,3677
14.12.2018 14:00,3970,79.85,286,310,3684
14.12.2018 15:00,3899,81.3,288,293,3611
14.12.2018 16:00,3918,83.04,267,282,3651
14.12.2018 17:00,3954,84.84,263,279,3691
14.12.2018 18:00,3950,94.96,264,277,3686
14.12.2018 19:00,3868,81.35,262,277,3606
14.12.2018 20:00,3731,73.84,253,268,3478
14.12.2018 21:00,3542,55.1,245,257,3297
14.12.2018 22:00,3345,55,233,247,3112
14.12.2018 23:00,3154,53.71,231,243,2923
15.12.2018 00:00,3019,51.55,222,245,2797
15.12.2018 01:00,2892,53.1,205,217,2687
15.12.2018 02:00,2799,51.56,207,219,2592
15.12.2018 03:00,2712,50.92,213,220,2499
15.12.2018 04:00,2716,51.06,220,225,2496
15.12.2018 05:00,2730,50.5,223,234,2507
15.12.2018 06:00,2800,50.78,231,243,2569
15.12.2018 07:00,2896,51.07,240,255,2656
15.12.2018 08:00,3077,52.21,246,258,2831
15.12.2018 09:00,3229,53.45,244,254,2985
15.12.2018 10:00,3316,66.76,249,251,3067
15.12.2018 11:00,3383,65.38,253,246,3130
15.12.2018 12:00,3422,67.27,249,238,3173
15.12.2018 13:00,3420,63.39,245,232,3175
15.12.2018 14:00,3446,58.71,254,237,3192
15.12.2018 15:00,3447,55.35,277,252,3170
15.12.2018 16:00,3513,53.89,311,275,3202
15.12.2018 17:00,3626,53.66,324,297,3302
15.12.2018 18:00,3636,60.32,353,315,3283
15.12.2018 19:00,3546,52.87,366,335,3180
15.12.2018 20:00,3449,51.41,368,358,3081
15.12.2018 21:00,3297,50.3,375,379,2922
15.12.2018 22:00,3163,49.41,409,403,2754
15.12.2018 23:00,2995,48.2,461,415,2534
16.12.2018 00:00,2933,46.59,453,421,2480
16.12.2018 01:00,2884,47.13,449,448,2435
16.12.2018 02:00,2843,46.98,441,449,2402
16.12.2018 03:00,2811,46.59,431,443,2380
16.12.2018 04:00,2801,46.25,407,432,2394
16.12.2018 05:00,2786,46.32,413,429,2373
16.12.2018 06:00,2750,46.34,435,435,2315
16.12.2018 07:00,2825,46.79,455,446,2370
16.12.2018 08:00,2939,47.59,465,452,2474
16.12.2018 09:00,3102,48.34,456,449,2646
16.12.2018 10:00,3287,48.67,451,441,2836
16.12.2018 11:00,3455,49.09,429,421,3026
16.12.2018 12:00,3513,50.55,402,394,3111
16.12.2018 13:00,3527,51.52,370,361,3157
16.12.2018 14:00,3570,51.45,316,314,3254
16.12.2018 15:00,3558,51.71,268,262,3290
16.12.2018 16:00,3686,52.49,208,219,3478
16.12.2018 17:00,3815,55.2,166,188,3649
16.12.2018 18:00,3841,57.08,150,162,3691
16.12.2018 19:00,3781,58.25,134,140,3647
16.12.2018 20:00,3710,52.93,119,116,3591
16.12.2018 21:00,3576,52.13,108,96,3468
16.12.2018 22:00,3419,51.57,101,80,3318
16.12.2018 23:00,3222,50.63,70,66,3152
17.12.2018 00:00,3085,49.82,58,58,3027
17.12.2018 01:00,2960,50.41,43,47,2917
17.12.2018 02:00,2897,49.94,34,43,2863
17.12.2018 03:00,2883,49.78,32,41,2851
17.12.2018 04:00,2883,49.05,36,40,2847
17.12.2018 05:00,2958,49.47,41,39,2917
17.12.2018 06:00,3170,52.03,40,37,3130
17.12.2018 07:00,3638,60.68,39,36,3599
17.12.2018 08:00,4003,75.6,35,34,3968
17.12.2018 09:00,4106,81.02,34,33,4072
17.12.2018 10:00,4043,80.04,34,31,4009
17.12.2018 11:00,4125,76.69,27,27,4098
17.12.2018 12:00,4148,77.73,21,23,4127
17.12.2018 13:00,4070,76.49,20,19,4050
17.12.2018 14:00,4083,76.49,16,17,4067
17.12.2018 15:00,4062,76.75,16,17,4046
17.12.2018 16:00,4137,78.81,21,20,4116
17.12.2018 17:00,4156,79.05,26,23,4130
17.12.2018 18:00,4166,80.9,28,26,4138
17.12.2018 19:00,4080,78.78,32,31,4048
17.12.2018 20:00,3989,70.15,34,34,3955
17.12.2018 21:00,3834,56.56,36,36,3798
17.12.2018 22:00,3639,54.86,38,39,3601
17.12.2018 23:00,3426,53.58,44,43,3382
18.12.2018 00:00,3210,52.5,50,45,3160
18.12.2018 01:00,3026,52.33,62,50,2964
18.12.2018 02:00,2964,51.02,66,54,2898
18.12.2018 03:00,2941,50.24,65,60,2876
18.12.2018 04:00,2947,49.42,73,71,2874
18.12.2018 05:00,2984,50.19,85,83,2899
18.12.2018 06:00,3200,52.91,96,95,3104
18.12.2018 07:00,3636,57.14,108,108,3528
18.12.2018 08:00,3997,71.22,119,121,3878
18.12.2018 09:00,4081,74.63,130,138,3951
18.12.2018 10:00,3991,72.04,161,158,3830
18.12.2018 11:00,4022,69.68,173,167,3849
18.12.2018 12:00,3991,67.63,177,168,3814
18.12.2018 13:00,3924,66.12,184,168,3740
18.12.2018 14:00,3890,66.43,202,174,3688
18.12.2018 15:00,3869,66.87,219,187,3650
18.12.2018 16:00,3929,66.15,259,209,3670
18.12.2018 17:00,3981,65.9,267,233,3714
18.12.2018 18:00,3966,67.14,278,259,3688
18.12.2018 19:00,3870,61.05,287,281,3583
18.12.2018 20:00,3734,55.07,308,298,3426
18.12.2018 21:00,3584,53.53,316,313,3268
18.12.2018 22:00,3400,52.56,320,327,3080
18.12.2018 23:00,3172,50.68,340,345,2832
19.12.2018 00:00,2886,48.82,361,369,2525
19.12.2018 01:00,2716,49.69,346,350,2370
19.12.2018 02:00,2651,49.11,372,379,2279
19.12.2018 03:00,2617,48.47,431,421,2186
19.12.2018 04:00,2648,48.1,494,469,2154
19.12.2018 05:00,2693,48.94,550,526,2143
19.12.2018 06:00,2897,50.69,601,584,2296
19.12.2018 07:00,3304,51.86,654,641,2650
19.12.2018 08:00,3667,53.86,707,692,2960
19.12.2018 09:00,3770,54.97,753,736,3017
19.12.2018 10:00,3774,54.95,781,775,2993
19.12.2018 11:00,3806,55.01,796,787,3010
19.12.2018 12:00,3778,55.29,799,782,2979
19.12.2018 13:00,3741,55.31,795,771,2946
19.12.2018 14:00,3743,55.12,793,760,2950
19.12.2018 15:00,3718,55.1,774,754,2944
19.12.2018 16:00,3828,55.93,757,747,3071
19.12.2018 17:00,3898,56.58,734,740,3164
19.12.2018 18:00,3928,56.38,718,729,3210
19.12.2018 19:00,3845,55.67,714,709,3131
19.12.2018 20:00,3756,55.15,688,680,3068
19.12.2018 21:00,3650,54.31,642,640,3008
19.12.2018 22:00,3452,53.13,577,599,2875
19.12.2018 23:00,3263,51.63,521,556,2742
20.12.2018 00:00,3056,50.08,471,512,2585
20.12.2018 01:00,2863,47.62,407,406,2456
20.12.2018 02:00,2814,48.18,364,366,2450
20.12.2018 03:00,2773,48.35,345,342,2428
20.12.2018 04:00,2748,47.5,328,322,2420
20.12.2018 05:00,2779,48.03,310,303,2469
20.12.2018 06:00,2996,50.74,289,289,2707
20.12.2018 07:00,3477,53.99,270,276,3207
20.12.2018 08:00,3846,66.29,265,264,3581
20.12.2018 09:00,3952,68.03,246,253,3706
20.12.2018 10:00,3873,68.4,229,243,3644
20.12.2018 11:00,3913,66.6,219,230,3694
20.12.2018 12:00,3886,66.53,209,220,3677
20.12.2018 13:00,3835,64.8,211,215,3624
20.12.2018 14:00,3840,64.79,220,220,3620
20.12.2018 15:00,3834,64.07,230,235,3604
20.12.2018 16:00,3908,64.33,254,255,3654
20.12.2018 17:00,3943,60.78,270,275,3673
20.12.2018 18:00,3886,57.97,286,291,3600
20.12.2018 19:00,3807,57.73,287,304,3520
20.12.2018 20:00,3744,55.75,315,300,3429
20.12.2018 21:00,3558,52.24,300,286,3258
20.12.2018 22:00,3350,51.33,281,274,3069
20.12.2018 23:00,3179,50,274,270,2905
21.12.2018 00:00,2936,48.12,263,275,2673
21.12.2018 01:00,2785,47.27,288,310,2497
21.12.2018 02:00,2706,46.52,294,319,2412
21.12.2018 03:00,2666,45.73,303,327,2363
21.12.2018 04:00,2673,46.15,316,337,2357
21.12.2018 05:00,2720,46.59,325,343,2395
21.12.2018 06:00,2871,50.21,335,348,2536
21.12.2018 07:00,3256,52.62,351,353,2905
21.12.2018 08:00,3636,62.77,361,362,3275
21.12.2018 09:00,3744,62.81,366,373,3378
21.12.2018 10:00,3694,56.91,386,382,3308
21.12.2018 11:00,3707,58.12,404,386,3303
21.12.2018 12:00,3719,56.21,415,391,3304
21.12.2018 13:00,3680,55.99,418,400,3262
21.12.2018 14:00,3559,56.34,450,416,3109
21.12.2018 15:00,3463,54.34,485,436,2978
21.12.2018 16:00,3466,53.7,501,458,2965
21.12.2018 17:00,3501,53.94,534,477,2967
21.12.2018 18:00,3437,54.42,565,488,2872
21.12.2018 19:00,3316,53.91,590,493,2726
21.12.2018 20:00,3157,52.76,609,493,2548
21.12.2018 21:00,2976,52.03,644,492,2332
21.12.2018 22:00,2801,51.43,647,492,2154
21.12.2018 23:00,2592,50.07,626,492,1966
22.12.2018 00:00,2501,49.01,616,497,1885
22.12.2018 01:00,2700,46.32,923,904,1777
22.12.2018 02:00,2614,45.51,946,871,1668
22.12.2018 03:00,2609,45.33,914,835,1695
22.12.2018 04:00,2628,45.3,850,795,1778
22.12.2018 05:00,2694,46.54,800,759,1894
22.12.2018 06:00,2734,47.9,777,724,1957
22.12.2018 07:00,2903,48.42,709,679,2194
22.12.2018 08:00,3097,49.44,638,614,2459
22.12.2018 09:00,3284,50.29,559,542,2725
22.12.2018 10:00,3426,51.52,474,469,2952
22.12.2018 11:00,3567,52.56,363,385,3204
22.12.2018 12:00,3613,53.08,291,305,3322
22.12.2018 13:00,3573,52.99,234,240,3339
22.12.2018 14:00,3523,53.13,188,201,3335
22.12.2018 15:00,3463,52.93,165,181,3298
22.12.2018 16:00,3583,53.78,162,166,3421
22.12.2018 17:00,3689,55.04,145,146,3544
22.12.2018 18:00,3746,56.52,130,130,3616
22.12.2018 19:00,3724,57.07,124,123,3600
22.12.2018 20:00,3616,55.29,114,116,3502
22.12.2018 21:00,3465,53.07,98,106,3367
22.12.2018 22:00,3306,52.07,93,99,3213
22.12.2018 23:00,3119,51.09,89,93,3030
23.12.2018 00:00,2972,50.47,85,86,2887
23.12.2018 01:00,2848,51.49,67,62,2781
23.12.2018 02:00,2758,50.83,57,54,2701
23.12.2018 03:00,2709,50.74,48,49,2661
23.12.2018 04:00,2696,50.14,42,44,2654
23.12.2018 05:00,2723,49.94,42,41,2681
23.12.2018 06:00,2782,50.46,45,41,2737
23.12.2018 07:00,2880,50.88,57,46,2823
23.12.2018 08:00,2999,51.37,64,49,2935
23.12.2018 09:00,3144,51.61,66,52,3078
23.12.2018 10:00,3259,52.22,62,54,3197
23.12.2018 11:00,3376,52.8,57,54,3319
23.12.2018 12:00,3446,53,58,51,3388
23.12.2018 13:00,3454,53.11,53,51,3401
23.12.2018 14:00,3437,52.93,55,58,3382
23.12.2018 15:00,3452,52.93,66,73,3386
23.12.2018 16:00,3518,53.75,88,96,3430
23.12.2018 17:00,3668,55.99,110,118,3558
23.12.2018 18:00,3694,61.2,134,139,3560
23.12.2018 19:00,3643,61.2,148,161,3495
23.12.2018 20:00,3533,57.42,173,180,3360
23.12.2018 21:00,3424,55.61,188,194,3236
23.12.2018 22:00,3285,53.99,203,209,3082
23.12.2018 23:00,3188,53.86,211,223,2977
24.12.2018 00:00,3030,52.32,231,240,2799
24.12.2018 01:00,2857,51.29,233,234,2624
24.12.2018 02:00,2762,50.31,278,245,2484
24.12.2018 03:00,2723,49.1,313,256,2410
24.12.2018 04:00,2733,48.76,291,265,2442
24.12.2018 05:00,2735,48.43,312,273,2423
24.12.2018 06:00,2822,49.71,319,280,2503
24.12.2018 07:00,3033,50.02,311,286,2722
24.12.2018 08:00,3238,50.56,273,273,2965
24.12.2018 09:00,3442,52.33,250,255,3192
24.12.2018 10:00,3594,53.39,229,242,3365
24.12.2018 11:00,3622,53.1,194,220,3428
24.12.2018 12:00,3618,52.88,167,192,3451
24.12.2018 13:00,3567,52.97,152,177,3415
24.12.2018 14:00,3494,52.46,143,178,3351
24.12.2018 15:00,3405,52.44,169,193,3236
24.12.2018 16:00,3378,52.9,197,211,3181
24.12.2018 17:00,3446,53.24,217,233,3229
24.12.2018 18:00,3338,52.61,235,253,3103
24.12.2018 19:00,3186,51.31,258,268,2928
24.12.2018 20:00,3094,50.74,291,277,2803
24.12.2018 21:00,3075,49.76,305,285,2770
24.12.2018 22:00,2991,48.53,343,295,2648
24.12.2018 23:00,2886,48.38,371,332,2515
25.12.2018 00:00,2747,46.4,427,389,2320
25.12.2018 01:00,2648,43.48,620,596,2028
25.12.2018 02:00,2596,41.27,730,695,1866
25.12.2018 03:00,2561,38.03,811,789,1750
25.12.2018 04:00,2502,35.21,892,870,1610
25.12.2018 05:00,2487,35.08,932,915,1555
25.12.2018 06:00,2481,42.99,950,930,1531
25.12.2018 07:00,2541,45.68,955,932,1586
25.12.2018 08:00,2662,46.46,959,926,1703
25.12.2018 09:00,2773,46.5,940,912,1833
25.12.2018 10:00,2813,46.31,910,886,1903
25.12.2018 11:00,2870,40.57,873,844,1997
25.12.2018 12:00,2881,42.26,830,792,2051
25.12.2018 13:00,2883,46.76,762,741,2121
25.12.2018 14:00,2858,46,730,706,2128
25.12.2018 15:00,2851,46.3,735,699,2116
25.12.2018 16:00,2876,47,722,705,2154
25.12.2018 17:00,2968,46.67,742,717,2226
25.12.2018 18:00,2966,46.26,743,723,2223
25.12.2018 19:00,2960,45.26,750,731,2210
25.12.2018 20:00,2869,42.74,775,732,2094
25.12.2018 21:00,2782,42.53,761,729,2021
25.12.2018 22:00,2708,38.68,767,727,1941
25.12.2018 23:00,2510,39.94,768,739,1742
26.12.2018 00:00,2327,27.4,766,755,1561
26.12.2018 01:00,2361,25.04,832,841,1529
26.12.2018 02:00,2362,24.57,780,802,1582
26.12.2018 03:00,2316,21.71,739,746,1577
26.12.2018 04:00,2316,23.68,685,692,1631
26.12.2018 05:00,2327,20.99,639,641,1688
26.12.2018 06:00,2382,28.51,594,592,1788
26.12.2018 07:00,2594,35.7,538,544,2056
26.12.2018 08:00,2714,46.48,490,502,2224
26.12.2018 09:00,2795,49.35,442,461,2353
26.12.2018 10:00,2868,50.97,397,416,2471
26.12.2018 11:00,2994,50.85,342,366,2652
26.12.2018 12:00,3094,51.19,304,311,2790
26.12.2018 13:00,3078,51.74,278,273,2800
26.12.2018 14:00,3021,51.81,270,272,2751
26.12.2018 15:00,2999,51.33,279,286,2720
26.12.2018 16:00,3025,51.92,306,307,2719
26.12.2018 17:00,3220,52.58,335,332,2885
26.12.2018 18:00,3205,52.53,375,364,2830
26.12.2018 19:00,3164,52.36,427,410,2737
26.12.2018 20:00,3058,50.99,465,465,2593
26.12.2018 21:00,2891,50.23,540,525,2351
26.12.2018 22:00,2694,49.73,597,581,2097
26.12.2018 23:00,2470,49.21,639,621,1831
27.12.2018 00:00,2271,48.03,660,646,1611
27.12.2018 01:00,2169,47.41,732,714,1437
27.12.2018 02:00,2174,47.1,723,717,1451
27.12.2018 03:00,2110,46.74,722,706,1388
27.12.2018 04:00,2101,45.03,687,689,1414
27.12.2018 05:00,2133,46.02,674,667,1459
27.12.2018 06:00,2254,49.74,639,645,1615
27.12.2018 07:00,2501,51.03,611,630,1890
27.12.2018 08:00,2699,52.58,610,628,2089
27.12.2018 09:00,2886,52.77,607,637,2279
27.12.2018 10:00,2994,53.39,624,648,2370
27.12.2018 11:00,3114,53.4,674,664,2440
27.12.2018 12:00,3089,53.24,697,678,2392
27.12.2018 13:00,3033,53.44,713,693,2320
27.12.2018 14:00,3051,53.25,726,712,2325
27.12.2018 15:00,3107,53.23,767,732,2340
27.12.2018 16:00,3073,53.77,805,752,2268
27.12.2018 17:00,3122,54.45,837,770,2285
27.12.2018 18:00,3055,54.54,844,779,2211
27.12.2018 19:00,3014,53.76,848,780,2166
27.12.2018 20:00,2947,52.9,842,769,2105
27.12.2018 21:00,2818,52.09,804,749,2014
27.12.2018 22:00,2764,51.22,738,722,2026
27.12.2018 23:00,2573,50.1,713,686,1860
28.12.2018 00:00,2373,48.98,672,642,1701
28.12.2018 01:00,2337,50.04,629,606,1708
28.12.2018 02:00,2361,49.42,555,547,1806
28.12.2018 03:00,2343,49.19,478,478,1865
28.12.2018 04:00,2331,48.51,407,416,1924
28.12.2018 05:00,2364,48.07,358,373,2006
28.12.2018 06:00,2472,50.12,340,341,2132
28.12.2018 07:00,2714,51.72,297,313,2417
28.12.2018 08:00,2924,52.95,279,288,2645
28.12.2018 09:00,3101,54.37,264,265,2837
28.12.2018 10:00,3226,55.21,254,239,2972
28.12.2018 11:00,3297,55.23,231,221,3066
28.12.2018 12:00,3232,55.21,213,205,3019
28.12.2018 13:00,3170,55.39,217,197,2953
28.12.2018 14:00,3184,55.28,212,194,2972
28.12.2018 15:00,3200,55.29,222,199,2978
28.12.2018 16:00,3304,56.26,234,211,3070
28.12.2018 17:00,3396,58.61,244,218,3152
28.12.2018 18:00,3435,61.72,251,221,3184
28.12.2018 19:00,3378,56.96,242,229,3136
28.12.2018 20:00,3310,55.25,227,230,3083
28.12.2018 21:00,3223,53.1,231,231,2992
28.12.2018 22:00,3084,52.4,220,237,2864
28.12.2018 23:00,2883,51.48,252,259,2631
29.12.2018 00:00,2706,50.18,260,290,2446
29.12.2018 01:00,2572,51.08,257,269,2315
29.12.2018 02:00,2464,49.87,290,306,2174
29.12.2018 03:00,2357,48.9,341,354,2016
29.12.2018 04:00,2293,47.15,371,400,1922
29.12.2018 05:00,2312,46.79,402,434,1910
29.12.2018 06:00,2317,47.21,444,467,1873
29.12.2018 07:00,2469,48.01,455,505,2014
29.12.2018 08:00,2687,50.02,477,521,2210
29.12.2018 09:00,2834,51.12,483,519,2351
29.12.2018 10:00,2867,52,491,509,2376
29.12.2018 11:00,2957,51.73,460,493,2497
29.12.2018 12:00,2978,51.74,456,474,2522
29.12.2018 13:00,3003,52.09,452,459,2551
29.12.2018 14:00,3076,51.98,389,438,2687
29.12.2018 15:00,3057,51.14,353,408,2704
29.12.2018 16:00,3099,50.79,307,369,2792
29.12.2018 17:00,3233,51.5,258,288,2975
29.12.2018 18:00,3278,52.67,239,220,3039
29.12.2018 19:00,3173,52,232,173,2941
29.12.2018 20:00,2899,50.79,256,137,2643
29.12.2018 21:00,2693,49.22,234,114,2459
29.12.2018 22:00,2679,48,166,102,2513
29.12.2018 23:00,2657,46.47,141,111,2516
30.12.2018 00:00,2557,44.45,157,141,2400
30.12.2018 01:00,2347,48.68,98,82,2249
30.12.2018 02:00,2317,48.05,114,119,2203
30.12.2018 03:00,2324,47.99,163,167,2161
30.12.2018 04:00,2240,48.03,281,212,1959
30.12.2018 05:00,2178,48.43,359,221,1819
30.12.2018 06:00,2181,48.76,401,217,1780
30.12.2018 07:00,2296,49.48,442,203,1854
30.12.2018 08:00,2386,49.84,462,183,1924
30.12.2018 09:00,2497,49.85,457,167,2040
30.12.2018 10:00,2608,49.46,449,155,2159
30.12.2018 11:00,2762,50.23,420,155,2342
30.12.2018 12:00,2814,51.16,396,156,2418
30.12.2018 13:00,2965,51.16,367,98,2598
30.12.2018 14:00,2963,50.14,358,85,2605
30.12.2018 15:00,2999,50.05,331,33,2668
30.12.2018 16:00,3044,51.09,320,34,2724
30.12.2018 17:00,3251,52.34,299,35,2952
30.12.2018 18:00,3376,54.39,302,36,3074
30.12.2018 19:00,3418,55.13,308,37,3110
30.12.2018 20:00,3341,55,300,36,3041
30.12.2018 21:00,3238,53.98,298,34,2940
30.12.2018 22:00,3132,52.98,274,33,2858
30.12.2018 23:00,2991,52.99,246,30,2745
31.12.2018 00:00,2828,51.98,219,31,2609
31.12.2018 01:00,2714,49.85,161,29,2553
31.12.2018 02:00,2601,49.13,135,26,2466
31.12.2018 03:00,2560,48.28,107,22,2453
31.12.2018 04:00,2518,45.92,82,19,2436
31.12.2018 05:00,2517,45.47,63,15,2454
31.12.2018 06:00,2599,47.11,46,13,2553
31.12.2018 07:00,2728,49.12,39,11,2689
31.12.2018 08:00,2865,49.8,46,12,2819
31.12.2018 09:00,2981,49.74,75,15,2906
31.12.2018 10:00,3053,50.06,128,19,2925
31.12.2018 11:00,3119,50.76,211,23,2908
31.12.2018 12:00,3182,50.85,309,29,2873
31.12.2018 13:00,3132,50.09,391,36,2741
31.12.2018 14:00,3108,49.97,463,42,2645
31.12.2018 15:00,3191,49.96,585,51,2606
31.12.2018 16:00,3329,50.51,670,60,2659
31.12.2018 17:00,3371,50.83,733,70,2638
31.12.2018 18:00,3249,50.11,834,80,2415
31.12.2018 19:00,3064,49.35,950,91,2114
31.12.2018 20:00,2908,47.51,1038,99,1870
31.12.2018 21:00,2730,45.82,1137,105,1593
31.12.2018 22:00,2547,43.03,1190,110,1357
31.12.2018 23:00,2488,38.54,1240,118,1248
01.01.2019 00:00,2420,25.7,1268,83,1152
