CET_TimeStamp,Actual_Total_Load,Day_Ahead_Price,Wind_Onshore_Gen_Actual,Wind_Onshore_generation_forecast,Residual_load
01.01.2017 01:00,2388,24.03,1226,1151,1162
01.01.2017 02:00,2342,24.03,1221,1151,1121
01.01.2017 03:00,2291,24.02,1228,1140,1063
01.01.2017 04:00,2189,23.19,1241,1133,948
01.01.2017 05:00,2155,24.1,1233,1113,922
01.01.2017 06:00,2159,25.01,1198,1078,961
01.01.2017 07:00,2228,25.62,1113,1032,1115
01.01.2017 08:00,2352,25.87,1031,979,1321
01.01.2017 09:00,2427,26.18,952,919,1475
01.01.2017 10:00,2470,25.74,873,856,1597
01.01.2017 11:00,2624,26.89,774,791,1850
01.01.2017 12:00,2792,27.48,636,725,2156
01.01.2017 13:00,2927,28.04,467,653,2460
01.01.2017 14:00,2922,28.7,424,569,2498
01.01.2017 15:00,2839,29.66,415,484,2424
01.01.2017 16:00,2941,30.38,362,420,2579
01.01.2017 17:00,3106,30.8,354,382,2752
01.01.2017 18:00,3168,30.93,345,360,2823
01.01.2017 19:00,3093,30.78,399,353,2694
01.01.2017 20:00,3024,30.51,427,343,2597
01.01.2017 21:00,2929,30.19,454,351,2475
01.01.2017 22:00,2815,29.94,457,358,2358
01.01.2017 23:00,2749,29.65,417,361,2332
01.02.2017 00:00,2663,29.36,411,369,2252
01.02.2017 01:00,2627,29.4,436,408,2191
01.02.2017 02:00,2544,28.91,496,422,2048
01.02.2017 03:00,2529,28.11,544,446,1985
01.02.2017 04:00,2591,27.89,531,464,2060
01.02.2017 05:00,2690,28.26,512,473,2178
01.02.2017 06:00,2867,30.43,522,477,2345
01.02.2017 07:00,3327,32.85,496,475,2831
01.02.2017 08:00,3715,33.91,517,471,3198
01.02.2017 09:00,3855,34.87,516,461,3339
01.02.2017 10:00,3957,35.22,450,454,3507
01.02.2017 11:00,4058,35.41,365,444,3693
01.02.2017 12:00,4025,35.07,352,424,3673
01.02.2017 13:00,3914,34.85,349,404,3565
01.02.2017 14:00,3941,34.7,334,407,3607
01.02.2017 15:00,3970,34.8,334,417,3636
01.02.2017 16:00,4110,35.93,326,415,3784
01.02.2017 17:00,4245,37.52,368,412,3877
01.02.2017 18:00,4266,40.01,382,389,3884
01.02.2017 19:00,4222,39.17,372,387,3850
01.02.2017 20:00,4121,35.52,361,392,3760
01.02.2017 21:00,3959,35.23,350,354,3609
01.02.2017 22:00,3773,34.74,346,330,3427
01.02.2017 23:00,3585,32.99,317,310,3268
01.03.2017 00:00,3405,30.94,306,295,3099
01.03.2017 01:00,3154,30.65,353,222,2801
01.03.2017 02:00,3095,30.37,318,207,2777
01.03.2017 03:00,3071,30.15,319,197,2752
01.03.2017 04:00,3034,30.14,365,207,2669
01.03.2017 05:00,3080,30.4,340,201,2740
01.03.2017 06:00,3234,32.24,347,222,2887
01.03.2017 07:00,3566,33.5,385,243,3181
01.03.2017 08:00,3939,35.8,407,251,3532
01.03.2017 09:00,4109,36.78,385,277,3724
01.03.2017 10:00,4031,36.17,469,316,3562
01.03.2017 11:00,4102,35.4,477,359,3625
01.03.2017 12:00,4101,34.92,519,408,3582
01.03.2017 13:00,4067,34.81,509,455,3558
01.03.2017 14:00,4162,34.09,543,557,3619
01.03.2017 15:00,4132,34.25,674,691,3458
01.03.2017 16:00,4108,34.51,887,819,3221
01.03.2017 17:00,4016,34.94,1140,989,2876
01.03.2017 18:00,4020,34.59,1228,1119,2792
01.03.2017 19:00,3841,34.06,1328,1213,2513
01.03.2017 20:00,3786,32.93,1363,1295,2423
01.03.2017 21:00,3636,31.8,1387,1339,2249
01.03.2017 22:00,3428,30.51,1401,1350,2027
01.03.2017 23:00,3296,29.27,1367,1357,1929
01.04.2017 00:00,3136,28.46,1346,1355,1790
01.04.2017 01:00,2983,25.93,1347,1337,1636
01.04.2017 02:00,2883,25.41,1352,1312,1531
01.04.2017 03:00,2815,25.35,1354,1269,1461
01.04.2017 04:00,2825,25.45,1286,1215,1539
01.04.2017 05:00,2926,25.97,1218,1175,1708
01.04.2017 06:00,3128,27.87,1156,1146,1972
01.04.2017 07:00,3441,28.92,1205,1147,2236
01.04.2017 08:00,3758,30.65,1281,1184,2477
01.04.2017 09:00,3928,32.13,1266,1210,2662
01.04.2017 10:00,4101,33.27,1200,1228,2901
01.04.2017 11:00,4215,33.52,1172,1228,3043
01.04.2017 12:00,4178,33.93,1198,1219,2980
01.04.2017 13:00,4120,33.93,1172,1190,2948
01.04.2017 14:00,4177,33.94,1102,1170,3075
01.04.2017 15:00,4173,34.15,1080,1129,3093
01.04.2017 16:00,4170,35.3,1109,1094,3061
01.04.2017 17:00,4239,36.28,1147,1105,3092
01.04.2017 18:00,4280,36.81,1181,1116,3099
01.04.2017 19:00,4232,35.55,1201,1138,3031
01.04.2017 20:00,4182,34.5,1193,1141,2989
01.04.2017 21:00,4042,33.89,1184,1127,2858
01.04.2017 22:00,3928,33.02,1113,1101,2815
01.04.2017 23:00,3748,32.33,1078,1062,2670
01.05.2017 00:00,3608,30.44,1022,1023,2586
01.05.2017 01:00,3557,30.51,958,1008,2599
01.05.2017 02:00,3482,30.23,968,989,2514
01.05.2017 03:00,3488,30,951,972,2537
01.05.2017 04:00,3516,30.06,935,953,2581
01.05.2017 05:00,3602,30.61,911,936,2691
01.05.2017 06:00,3821,32.45,869,918,2952
01.05.2017 07:00,4105,34.87,966,902,3139
01.05.2017 08:00,4435,42.07,961,863,3474
01.05.2017 09:00,4632,43.38,946,843,3686
01.05.2017 10:00,4717,42.04,889,843,3828
01.05.2017 11:00,4762,43.04,849,824,3913
01.05.2017 12:00,4676,44.54,850,804,3826
01.05.2017 13:00,4562,44.56,865,781,3697
01.05.2017 14:00,4467,44.66,836,744,3631
01.05.2017 15:00,4509,44.99,730,697,3779
01.05.2017 16:00,4607,56.1,666,676,3941
01.05.2017 17:00,4713,69.7,669,641,4044
01.05.2017 18:00,4749,73.92,682,607,4067
01.05.2017 19:00,4690,71.99,651,574,4039
01.05.2017 20:00,4644,50.08,593,543,4051
01.05.2017 21:00,4494,44.89,583,515,3911
01.05.2017 22:00,4326,42.05,562,478,3764
01.05.2017 23:00,4178,37.22,496,447,3682
01.06.2017 00:00,4008,34.65,464,405,3544
01.06.2017 01:00,3867,35.84,449,372,3418
01.06.2017 02:00,3809,35.54,423,316,3386
01.06.2017 03:00,3759,34.59,365,272,3394
01.06.2017 04:00,3752,34.28,323,235,3429
01.06.2017 05:00,3845,34.16,269,199,3576
01.06.2017 06:00,3945,32.59,224,172,3721
01.06.2017 07:00,4167,34.32,180,149,3987
01.06.2017 08:00,4372,48.3,140,131,4232
01.06.2017 09:00,4529,58.48,104,120,4425
01.06.2017 10:00,4630,34.05,100,122,4530
01.06.2017 11:00,4591,58.6,108,115,4483
01.06.2017 12:00,4524,56.31,101,115,4423
01.06.2017 13:00,4437,34.92,87,112,4350
01.06.2017 14:00,4356,38.82,75,116,4281
01.06.2017 15:00,4372,35.49,85,137,4287
01.06.2017 16:00,4439,36.24,125,165,4314
01.06.2017 17:00,4633,56.14,206,204,4427
01.06.2017 18:00,4699,55.62,291,257,4408
01.06.2017 19:00,4581,41.47,376,305,4205
01.06.2017 20:00,4437,35.65,452,367,3985
01.06.2017 21:00,4248,32.13,543,430,3705
01.06.2017 22:00,4044,31.56,654,488,3390
01.06.2017 23:00,3853,30.18,711,542,3142
01.07.2017 00:00,3658,29.01,759,602,2899
01.07.2017 01:00,3562,29.35,845,687,2717
01.07.2017 02:00,3476,28.88,883,758,2593
01.07.2017 03:00,3489,28.28,903,837,2586
01.07.2017 04:00,3413,27.84,957,872,2456
01.07.2017 05:00,3422,28.04,986,912,2436
01.07.2017 06:00,3495,28.64,1002,957,2493
01.07.2017 07:00,3572,29.1,1008,987,2564
01.07.2017 08:00,3713,29.49,989,991,2724
01.07.2017 09:00,3903,29.97,918,959,2985
01.07.2017 10:00,4022,30.72,787,863,3235
01.07.2017 11:00,4159,31.47,597,752,3562
01.07.2017 12:00,4179,31.9,480,621,3699
01.07.2017 13:00,4204,31.52,329,507,3875
01.07.2017 14:00,4154,31.32,206,380,3948
01.07.2017 15:00,4057,31.85,150,272,3907
01.07.2017 16:00,4049,32.83,116,209,3933
01.07.2017 17:00,4132,34.62,104,168,4028
01.07.2017 18:00,4131,35.32,136,174,3995
01.07.2017 19:00,4078,34.28,138,193,3940
01.07.2017 20:00,3973,33.35,148,210,3825
01.07.2017 21:00,3850,32.67,149,227,3701
01.07.2017 22:00,3720,32.55,154,238,3566
01.07.2017 23:00,3545,31.84,145,234,3400
01.08.2017 00:00,3397,30.6,115,219,3282
01.08.2017 01:00,3260,30.75,99,192,3161
01.08.2017 02:00,3169,30.64,80,167,3089
01.08.2017 03:00,3126,30.53,59,137,3067
01.08.2017 04:00,3106,30.54,48,113,3058
01.08.2017 05:00,3102,30.63,38,91,3064
01.08.2017 06:00,3155,30.7,30,73,3125
01.08.2017 07:00,3257,30.77,22,59,3235
01.08.2017 08:00,3373,30.58,16,48,3357
01.08.2017 09:00,3481,30.75,16,41,3465
01.08.2017 10:00,3590,31.09,11,34,3579
01.08.2017 11:00,3688,35.05,21,33,3667
01.08.2017 12:00,3752,35.51,37,35,3715
01.08.2017 13:00,3772,37.61,45,44,3727
01.08.2017 14:00,3773,36.96,56,60,3717
01.08.2017 15:00,3811,35.14,72,80,3739
01.08.2017 16:00,3852,35.16,117,116,3735
01.08.2017 17:00,4025,35.63,164,160,3861
01.08.2017 18:00,4078,35.27,220,203,3858
01.08.2017 19:00,4038,34,252,239,3786
01.08.2017 20:00,3950,32.97,285,260,3665
01.08.2017 21:00,3861,30.83,243,278,3618
01.08.2017 22:00,3675,30.95,263,281,3412
01.08.2017 23:00,3426,30.55,301,287,3125
01.09.2017 00:00,3227,29.89,312,294,2915
01.09.2017 01:00,3134,29.56,335,334,2799
01.09.2017 02:00,3046,29.11,353,339,2693
01.09.2017 03:00,3032,28.99,348,332,2684
01.09.2017 04:00,3021,29.16,335,330,2686
01.09.2017 05:00,3054,29.71,340,320,2714
01.09.2017 06:00,3217,30.41,348,313,2869
01.09.2017 07:00,3614,30.77,363,306,3251
01.09.2017 08:00,3990,43.12,368,308,3622
01.09.2017 09:00,4067,44.44,391,315,3676
01.09.2017 10:00,4010,44.92,427,321,3583
01.09.2017 11:00,4095,45.34,418,341,3677
01.09.2017 12:00,4150,45.07,393,340,3757
01.09.2017 13:00,4177,45.12,341,352,3836
01.09.2017 14:00,4182,46.41,372,358,3810
01.09.2017 15:00,4117,45.1,426,372,3691
01.09.2017 16:00,4195,42.85,428,387,3767
01.09.2017 17:00,4328,47.85,403,412,3925
01.09.2017 18:00,4345,46.41,399,434,3946
01.09.2017 19:00,4237,43.1,435,461,3802
01.09.2017 20:00,4067,31.41,506,517,3561
01.09.2017 21:00,3863,30.5,602,558,3261
01.09.2017 22:00,3646,30.07,721,617,2925
01.09.2017 23:00,3391,29.57,825,684,2566
01.10.2017 00:00,3144,28.83,900,727,2244
01.10.2017 01:00,3023,26.16,896,765,2127
01.10.2017 02:00,2981,25.57,899,788,2082
01.10.2017 03:00,2981,25.49,884,801,2097
01.10.2017 04:00,3008,25.57,881,793,2127
01.10.2017 05:00,3047,27.77,887,802,2160
01.10.2017 06:00,3279,28.93,859,807,2420
01.10.2017 07:00,3760,29.79,817,821,2943
01.10.2017 08:00,4224,31,820,833,3404
01.10.2017 09:00,4290,31.31,853,826,3437
01.10.2017 10:00,4232,31.22,862,829,3370
01.10.2017 11:00,4270,31.14,875,838,3395
01.10.2017 12:00,4319,31.06,849,849,3470
01.10.2017 13:00,4291,30.99,834,840,3457
01.10.2017 14:00,4283,31,829,826,3454
01.10.2017 15:00,4251,31.01,852,800,3399
01.10.2017 16:00,4289,31.03,849,775,3440
01.10.2017 17:00,4360,40.4,845,757,3515
01.10.2017 18:00,4386,41.44,839,759,3547
01.10.2017 19:00,4283,39.91,825,758,3458
01.10.2017 20:00,4193,30.54,798,762,3395
01.10.2017 21:00,4046,29.81,780,765,3266
01.10.2017 22:00,3862,29.55,820,780,3042
01.10.2017 23:00,3578,29.15,835,794,2743
01.11.2017 00:00,3357,28.08,850,803,2507
01.11.2017 01:00,3163,24.38,921,824,2242
01.11.2017 02:00,3064,22.78,965,856,2099
01.11.2017 03:00,3047,22.05,996,909,2051
01.11.2017 04:00,3054,22.1,1055,955,1999
01.11.2017 05:00,3109,23.6,1112,1012,1997
01.11.2017 06:00,3290,25.88,1159,1076,2131
01.11.2017 07:00,3688,27.82,1231,1138,2457
01.11.2017 08:00,4111,28.96,1304,1199,2807
01.11.2017 09:00,4221,29.14,1346,1263,2875
01.11.2017 10:00,4214,29.12,1376,1323,2838
01.11.2017 11:00,4342,29.15,1369,1370,2973
01.11.2017 12:00,4419,29.16,1358,1397,3061
01.11.2017 13:00,4421,29.17,1360,1408,3061
01.11.2017 14:00,4521,29.13,1309,1417,3212
01.11.2017 15:00,4528,29.15,1304,1399,3224
01.11.2017 16:00,4539,29.18,1273,1358,3266
01.11.2017 17:00,4471,29.4,1271,1289,3200
01.11.2017 18:00,4443,29.57,1283,1253,3160
01.11.2017 19:00,4269,29.38,1308,1225,2961
01.11.2017 20:00,4094,29.13,1293,1217,2801
01.11.2017 21:00,3888,28.6,1265,1211,2623
01.11.2017 22:00,3662,27.91,1270,1212,2392
01.11.2017 23:00,3451,26.27,1243,1221,2208
01.12.2017 00:00,3218,24.29,1260,1221,1958
01.12.2017 01:00,3123,22.17,1261,1244,1862
01.12.2017 02:00,3058,18.07,1256,1242,1802
01.12.2017 03:00,3033,17.38,1243,1242,1790
01.12.2017 04:00,3050,17.43,1233,1239,1817
01.12.2017 05:00,3081,23.49,1242,1244,1839
01.12.2017 06:00,3261,24.98,1265,1247,1996
01.12.2017 07:00,3698,28.29,1255,1251,2443
01.12.2017 08:00,4095,29.41,1264,1244,2831
01.12.2017 09:00,4182,29.78,1286,1260,2896
01.12.2017 10:00,4205,29.5,1267,1265,2938
01.12.2017 11:00,4219,29.54,1271,1274,2948
01.12.2017 12:00,4177,29.5,1306,1292,2871
01.12.2017 13:00,4069,29.47,1347,1306,2722
01.12.2017 14:00,4030,29.5,1340,1317,2690
01.12.2017 15:00,3998,29.55,1338,1319,2660
01.12.2017 16:00,4006,29.64,1348,1300,2658
01.12.2017 17:00,4112,30.23,1319,1275,2793
01.12.2017 18:00,4189,30.52,1264,1235,2925
01.12.2017 19:00,4141,30.28,1201,1192,2940
01.12.2017 20:00,4032,29.88,1140,1133,2892
01.12.2017 21:00,3933,29.5,1061,1084,2872
01.12.2017 22:00,3779,29.43,947,1019,2832
01.12.2017 23:00,3607,29.21,853,954,2754
13.01.2017 00:00,3368,28.83,811,875,2557
13.01.2017 01:00,3248,29.15,761,818,2487
13.01.2017 02:00,3156,29.01,692,735,2464
13.01.2017 03:00,3158,29.09,580,655,2578
13.01.2017 04:00,3179,29.09,451,564,2728
13.01.2017 05:00,3170,29.25,369,456,2801
13.01.2017 06:00,3385,30.64,232,359,3153
13.01.2017 07:00,3835,34.12,157,286,3678
13.01.2017 08:00,4236,41.15,113,214,4123
13.01.2017 09:00,4338,44.41,77,169,4261
13.01.2017 10:00,4242,44.39,57,138,4185
13.01.2017 11:00,4244,44.05,41,98,4203
13.01.2017 12:00,4246,44.02,31,76,4215
13.01.2017 13:00,4151,41.11,41,65,4110
13.01.2017 14:00,4073,41.05,48,61,4025
13.01.2017 15:00,4021,40.97,44,69,3977
13.01.2017 16:00,4030,41.03,48,84,3982
13.01.2017 17:00,4135,43.79,57,99,4078
13.01.2017 18:00,4216,47.55,64,111,4152
13.01.2017 19:00,4081,44.09,82,120,3999
13.01.2017 20:00,3916,40.82,93,127,3823
13.01.2017 21:00,3740,31.38,117,139,3623
13.01.2017 22:00,3546,31.12,146,148,3400
13.01.2017 23:00,3368,30.78,150,156,3218
14.01.2017 00:00,3205,29.92,145,158,3060
14.01.2017 01:00,3070,29.82,145,178,2925
14.01.2017 02:00,2981,28.98,168,193,2813
14.01.2017 03:00,2964,28.64,178,207,2786
14.01.2017 04:00,2944,28.5,192,220,2752
14.01.2017 05:00,2990,28.61,189,228,2801
14.01.2017 06:00,3062,28.74,181,223,2881
14.01.2017 07:00,3149,29.49,206,216,2943
14.01.2017 08:00,3324,29.77,220,212,3104
14.01.2017 09:00,3446,30.59,230,206,3216
14.01.2017 10:00,3594,31.01,197,176,3397
14.01.2017 11:00,3682,31.6,164,170,3518
14.01.2017 12:00,3700,31.59,152,150,3548
14.01.2017 13:00,3644,31.14,128,134,3516
14.01.2017 14:00,3633,30.96,88,124,3545
14.01.2017 15:00,3550,30.97,88,125,3462
14.01.2017 16:00,3615,31.13,81,127,3534
14.01.2017 17:00,3839,33.51,81,123,3758
14.01.2017 18:00,3942,35.35,86,128,3856
14.01.2017 19:00,3914,34.47,74,138,3840
14.01.2017 20:00,3821,31.98,61,153,3760
14.01.2017 21:00,3692,31.57,52,172,3640
14.01.2017 22:00,3507,30.66,102,190,3405
14.01.2017 23:00,3340,30.25,138,209,3202
15.01.2017 00:00,3200,29.55,156,223,3044
15.01.2017 01:00,3044,29.02,184,197,2860
15.01.2017 02:00,2988,28.54,220,217,2768
15.01.2017 03:00,2947,27.33,246,245,2701
15.01.2017 04:00,2946,27.09,258,271,2688
15.01.2017 05:00,2960,27.33,299,298,2661
15.01.2017 06:00,2966,28.7,367,308,2599
15.01.2017 07:00,3095,29.09,359,316,2736
15.01.2017 08:00,3264,29.33,364,345,2900
15.01.2017 09:00,3432,30.55,330,324,3102
15.01.2017 10:00,3589,31.94,317,307,3272
15.01.2017 11:00,3723,32.06,290,307,3433
15.01.2017 12:00,3739,32.15,254,286,3485
15.01.2017 13:00,3750,31.95,218,277,3532
15.01.2017 14:00,3716,31.7,210,266,3506
15.01.2017 15:00,3694,31.5,207,273,3487
15.01.2017 16:00,3757,31.7,224,288,3533
15.01.2017 17:00,3931,37.78,316,327,3615
15.01.2017 18:00,4052,42.72,377,334,3675
15.01.2017 19:00,4036,41.7,431,333,3605
15.01.2017 20:00,4002,39.63,444,328,3558
15.01.2017 21:00,3939,32.18,371,319,3568
15.01.2017 22:00,3810,31.94,339,310,3471
15.01.2017 23:00,3576,31.72,382,302,3194
16.01.2017 00:00,3398,31.11,433,293,2965
16.01.2017 01:00,3255,31.01,454,305,2801
16.01.2017 02:00,3266,30.93,414,299,2852
16.01.2017 03:00,3306,30.9,378,294,2928
16.01.2017 04:00,3394,30.93,359,290,3035
16.01.2017 05:00,3440,31.34,395,295,3045
16.01.2017 06:00,3646,31.86,420,298,3226
16.01.2017 07:00,4176,36.42,396,307,3780
16.01.2017 08:00,4589,60.04,416,302,4173
16.01.2017 09:00,4545,59.9,484,286,4061
16.01.2017 10:00,4604,56.28,379,280,4225
16.01.2017 11:00,4655,60.06,250,266,4405
16.01.2017 12:00,4597,58.14,163,226,4434
16.01.2017 13:00,4517,57.04,114,201,4403
16.01.2017 14:00,4439,60.61,118,173,4321
16.01.2017 15:00,4353,61.03,137,166,4216
16.01.2017 16:00,4401,58.71,148,161,4253
16.01.2017 17:00,4474,87.38,186,179,4288
16.01.2017 18:00,4607,117.12,196,200,4411
16.01.2017 19:00,4552,82.84,201,211,4351
16.01.2017 20:00,4414,56.4,226,209,4188
16.01.2017 21:00,4258,43.78,197,188,4061
16.01.2017 22:00,4117,33.96,142,165,3975
16.01.2017 23:00,3882,32.01,134,138,3748
17.01.2017 00:00,3626,31.11,131,124,3495
17.01.2017 01:00,3478,31.01,128,123,3350
17.01.2017 02:00,3411,30.61,131,105,3280
17.01.2017 03:00,3390,30.65,138,102,3252
17.01.2017 04:00,3425,30.68,121,91,3304
17.01.2017 05:00,3476,31.12,124,84,3352
17.01.2017 06:00,3707,32.67,92,73,3615
17.01.2017 07:00,4213,38.34,80,64,4133
17.01.2017 08:00,4612,48.24,93,58,4519
17.01.2017 09:00,4677,61.04,72,52,4605
17.01.2017 10:00,4610,67.29,59,60,4551
17.01.2017 11:00,4556,66.11,78,68,4478
17.01.2017 12:00,4480,70.68,87,81,4393
17.01.2017 13:00,4423,68.1,99,96,4324
17.01.2017 14:00,4387,65.98,152,112,4235
17.01.2017 15:00,4380,55.15,180,140,4200
17.01.2017 16:00,4442,48.52,211,170,4231
17.01.2017 17:00,4507,74.9,246,210,4261
17.01.2017 18:00,4564,98.47,286,259,4278
17.01.2017 19:00,4469,68.7,314,295,4155
17.01.2017 20:00,4339,47.02,384,336,3955
17.01.2017 21:00,4162,44.2,439,373,3723
17.01.2017 22:00,3938,30.56,493,402,3445
17.01.2017 23:00,3687,30.08,527,438,3160
18.01.2017 00:00,3462,29.71,570,476,2892
18.01.2017 01:00,3195,29.01,674,475,2521
18.01.2017 02:00,3130,28.58,700,501,2430
18.01.2017 03:00,3155,28.45,661,518,2494
18.01.2017 04:00,3205,28.54,622,547,2583
18.01.2017 05:00,3261,29.13,649,572,2612
18.01.2017 06:00,3372,29.73,710,587,2662
18.01.2017 07:00,3773,30.04,713,586,3060
18.01.2017 08:00,4167,30.79,725,582,3442
18.01.2017 09:00,4229,30.88,721,589,3508
18.01.2017 10:00,4228,30.72,687,597,3541
18.01.2017 11:00,4249,30.59,712,610,3537
18.01.2017 12:00,4257,30.43,725,608,3532
18.01.2017 13:00,4189,30.43,725,606,3464
18.01.2017 14:00,4223,30.28,710,628,3513
18.01.2017 15:00,4198,30.14,721,649,3477
18.01.2017 16:00,4247,30.12,710,663,3537
18.01.2017 17:00,4222,30.33,791,677,3431
18.01.2017 18:00,4240,30.51,838,693,3402
18.01.2017 19:00,4125,30.22,858,692,3267
18.01.2017 20:00,3986,29.82,874,720,3112
18.01.2017 21:00,3804,29.31,914,744,2890
18.01.2017 22:00,3619,29.27,924,757,2695
18.01.2017 23:00,3390,29.08,914,773,2476
19.01.2017 00:00,3164,28.79,920,754,2244
19.01.2017 01:00,3007,25.89,944,808,2063
19.01.2017 02:00,2924,27.3,928,781,1996
19.01.2017 03:00,2844,27.14,938,751,1906
19.01.2017 04:00,2846,27.42,898,725,1948
19.01.2017 05:00,2868,28.35,855,697,2013
19.01.2017 06:00,3041,29.11,805,679,2236
19.01.2017 07:00,3461,29.39,802,656,2659
19.01.2017 08:00,3882,29.86,785,629,3097
19.01.2017 09:00,3993,30.43,746,613,3247
19.01.2017 10:00,3961,30.28,748,625,3213
19.01.2017 11:00,4000,29.97,750,625,3250
19.01.2017 12:00,3997,29.82,752,639,3245
19.01.2017 13:00,3967,29.65,760,666,3207
19.01.2017 14:00,3964,29.57,794,716,3170
19.01.2017 15:00,3930,29.53,837,752,3093
19.01.2017 16:00,3958,29.53,861,781,3097
19.01.2017 17:00,4014,29.69,863,784,3151
19.01.2017 18:00,4098,29.84,883,811,3215
19.01.2017 19:00,3978,29.79,919,819,3059
19.01.2017 20:00,3850,29.53,919,801,2931
19.01.2017 21:00,3740,28.87,862,786,2878
19.01.2017 22:00,3567,28.79,823,770,2744
19.01.2017 23:00,3309,28.74,811,747,2498
20.01.2017 00:00,3090,28.41,775,707,2315
20.01.2017 01:00,2930,27.23,719,682,2211
20.01.2017 02:00,2908,27.26,655,657,2253
20.01.2017 03:00,2922,27.11,574,621,2348
20.01.2017 04:00,2930,27.34,521,588,2409
20.01.2017 05:00,2944,27.9,515,556,2429
20.01.2017 06:00,3075,28.01,552,549,2523
20.01.2017 07:00,3511,28.59,564,556,2947
20.01.2017 08:00,3864,29.73,618,559,3246
20.01.2017 09:00,3922,29.98,678,573,3244
20.01.2017 10:00,3903,29.89,708,629,3195
20.01.2017 11:00,3881,29.84,777,678,3104
20.01.2017 12:00,3789,29.72,856,703,2933
20.01.2017 13:00,3633,29.5,902,720,2731
20.01.2017 14:00,3604,29.37,868,751,2736
20.01.2017 15:00,3516,29.08,873,749,2643
20.01.2017 16:00,3489,28.92,867,746,2622
20.01.2017 17:00,3584,29.33,845,722,2739
20.01.2017 18:00,3725,29.62,793,687,2932
20.01.2017 19:00,3687,29.52,697,639,2990
20.01.2017 20:00,3577,28.9,615,587,2962
20.01.2017 21:00,3427,28.36,537,530,2890
20.01.2017 22:00,3279,28.28,477,479,2802
20.01.2017 23:00,3133,28.11,416,422,2717
21.01.2017 00:00,2984,27.69,375,368,2609
21.01.2017 01:00,2797,27.64,360,299,2437
21.01.2017 02:00,2718,27.15,336,259,2382
21.01.2017 03:00,2643,26.9,321,216,2322
21.01.2017 04:00,2667,26.93,269,182,2398
21.01.2017 05:00,2703,27.22,214,150,2489
21.01.2017 06:00,2830,27.74,123,117,2707
21.01.2017 07:00,3001,27.77,71,97,2930
21.01.2017 08:00,3208,28.24,47,82,3161
21.01.2017 09:00,3382,28.8,34,65,3348
21.01.2017 10:00,3481,29.17,29,50,3452
21.01.2017 11:00,3553,29.52,27,38,3526
21.01.2017 12:00,3551,29.51,29,31,3522
21.01.2017 13:00,3501,29.29,38,26,3463
21.01.2017 14:00,3452,29.09,37,27,3415
21.01.2017 15:00,3432,29.06,27,29,3405
21.01.2017 16:00,3439,29.51,25,33,3414
21.01.2017 17:00,3629,29.9,23,36,3606
21.01.2017 18:00,3785,30.94,19,41,3766
21.01.2017 19:00,3742,30.36,23,47,3719
21.01.2017 20:00,3620,29.82,25,54,3595
21.01.2017 21:00,3503,29.31,47,69,3456
21.01.2017 22:00,3382,28.97,83,88,3299
21.01.2017 23:00,3237,28.54,128,105,3109
22.01.2017 00:00,3099,28.13,164,128,2935
22.01.2017 01:00,2994,28.57,135,123,2859
22.01.2017 02:00,2949,28.08,101,131,2848
22.01.2017 03:00,2911,27.78,113,141,2798
22.01.2017 04:00,2917,27.71,125,152,2792
22.01.2017 05:00,2955,27.75,111,162,2844
22.01.2017 06:00,3008,28.02,111,174,2897
22.01.2017 07:00,3110,28.05,115,189,2995
22.01.2017 08:00,3239,28.44,128,197,3111
22.01.2017 09:00,3349,28.75,147,208,3202
22.01.2017 10:00,3497,29.29,153,212,3344
22.01.2017 11:00,3624,29.6,156,226,3468
22.01.2017 12:00,3707,29.59,132,220,3575
22.01.2017 13:00,3719,29.53,133,221,3586
22.01.2017 14:00,3671,29.52,151,219,3520
22.01.2017 15:00,3666,29.52,140,214,3526
22.01.2017 16:00,3682,29.62,144,205,3538
22.01.2017 17:00,3803,29.98,156,208,3647
22.01.2017 18:00,3869,30.7,186,217,3683
22.01.2017 19:00,3817,30.53,222,232,3595
22.01.2017 20:00,3683,29.95,271,242,3412
22.01.2017 21:00,3560,29.65,278,256,3282
22.01.2017 22:00,3443,29.53,263,266,3180
22.01.2017 23:00,3215,29.04,295,278,2920
23.01.2017 00:00,3086,28.05,287,286,2799
23.01.2017 01:00,2942,28.16,294,284,2648
23.01.2017 02:00,2855,26.92,305,285,2550
23.01.2017 03:00,2871,26.35,287,281,2584
23.01.2017 04:00,2853,27.13,313,283,2540
23.01.2017 05:00,2899,28.44,338,292,2561
23.01.2017 06:00,3047,28.63,385,295,2662
23.01.2017 07:00,3487,29.39,420,310,3067
23.01.2017 08:00,3976,30.31,400,324,3576
23.01.2017 09:00,4109,30.62,386,330,3723
23.01.2017 10:00,4128,30.32,333,343,3795
23.01.2017 11:00,4134,30.09,375,348,3759
23.01.2017 12:00,4123,29.96,437,382,3686
23.01.2017 13:00,4052,29.85,464,406,3588
23.01.2017 14:00,4020,29.78,493,426,3527
23.01.2017 15:00,3969,29.75,508,439,3461
23.01.2017 16:00,3971,29.85,514,441,3457
23.01.2017 17:00,4085,30.24,473,445,3612
23.01.2017 18:00,4244,31.08,463,444,3781
23.01.2017 19:00,4099,30.44,491,442,3608
23.01.2017 20:00,3960,29.91,499,436,3461
23.01.2017 21:00,3820,29.55,495,413,3325
23.01.2017 22:00,3639,29.35,488,400,3151
23.01.2017 23:00,3413,28.85,444,370,2969
24.01.2017 00:00,3175,28.45,420,335,2755
24.01.2017 01:00,3022,29.04,387,324,2635
24.01.2017 02:00,2915,28.93,376,289,2539
24.01.2017 03:00,2876,28.93,343,280,2533
24.01.2017 04:00,2881,29.03,321,263,2560
24.01.2017 05:00,2935,29.53,298,238,2637
24.01.2017 06:00,3115,29.71,261,209,2854
24.01.2017 07:00,3586,30.98,238,197,3348
24.01.2017 08:00,3994,45.89,217,175,3777
24.01.2017 09:00,4094,49.2,205,161,3889
24.01.2017 10:00,4136,48.87,140,145,3996
24.01.2017 11:00,4154,48.02,104,128,4050
24.01.2017 12:00,3395,46.33,84,117,3311
24.01.2017 13:00,4080,40.92,77,105,4003
24.01.2017 14:00,4060,37,60,98,4000
24.01.2017 15:00,4018,34.92,51,89,3967
24.01.2017 16:00,4030,34.88,52,92,3978
24.01.2017 17:00,4088,46.29,59,97,4029
24.01.2017 18:00,4167,74.42,74,113,4093
24.01.2017 19:00,4075,55.87,92,123,3983
24.01.2017 20:00,3977,31.6,83,129,3894
24.01.2017 21:00,3830,30.34,79,136,3751
24.01.2017 22:00,3634,29.91,97,135,3537
24.01.2017 23:00,3377,29.08,107,143,3270
25.01.2017 00:00,3154,28.58,137,151,3017
25.01.2017 01:00,2993,28.84,170,165,2823
25.01.2017 02:00,2913,28.47,199,176,2714
25.01.2017 03:00,2892,28.18,206,181,2686
25.01.2017 04:00,2894,28.19,208,185,2686
25.01.2017 05:00,2885,28.82,236,190,2649
25.01.2017 06:00,3029,28.7,281,197,2748
25.01.2017 07:00,3493,29.41,269,207,3224
25.01.2017 08:00,3952,31.23,266,221,3686
25.01.2017 09:00,4039,46.15,268,228,3771
25.01.2017 10:00,4049,31.4,242,237,3807
25.01.2017 11:00,4132,31.22,228,241,3904
25.01.2017 12:00,4136,30.88,250,240,3886
25.01.2017 13:00,4038,30.68,266,229,3772
25.01.2017 14:00,4026,30.51,257,227,3769
25.01.2017 15:00,4008,30.25,245,222,3763
25.01.2017 16:00,4023,30.27,238,227,3785
25.01.2017 17:00,4046,30.76,236,235,3810
25.01.2017 18:00,4145,87.97,235,238,3910
25.01.2017 19:00,4102,30.92,235,237,3867
25.01.2017 20:00,4037,29.89,212,239,3825
25.01.2017 21:00,3869,29.19,213,233,3656
25.01.2017 22:00,3712,28.93,212,241,3500
25.01.2017 23:00,3490,28.22,215,252,3275
26.01.2017 00:00,3238,27.37,270,270,2968
26.01.2017 01:00,3075,26.1,317,285,2758
26.01.2017 02:00,2988,25.52,369,299,2619
26.01.2017 03:00,2937,25.32,418,314,2519
26.01.2017 04:00,2967,25.37,420,321,2547
26.01.2017 05:00,3041,27.46,427,332,2614
26.01.2017 06:00,3217,28.35,416,341,2801
26.01.2017 07:00,3704,29.25,418,347,3286
26.01.2017 08:00,4119,45.25,403,349,3716
26.01.2017 09:00,4228,46.88,386,354,3842
26.01.2017 10:00,4171,46.88,424,346,3747
26.01.2017 11:00,4195,47.82,432,353,3763
26.01.2017 12:00,4171,52.2,394,336,3777
26.01.2017 13:00,4063,50.53,356,316,3707
26.01.2017 14:00,4062,47.47,301,312,3761
26.01.2017 15:00,4084,46.88,260,288,3824
26.01.2017 16:00,4057,46.76,273,264,3784
26.01.2017 17:00,4141,48.23,233,246,3908
26.01.2017 18:00,4327,52.72,200,233,4127
26.01.2017 19:00,4270,46.83,159,223,4111
26.01.2017 20:00,4146,44.65,139,221,4007
26.01.2017 21:00,4073,35.21,103,214,3970
26.01.2017 22:00,3885,30.03,106,198,3779
26.01.2017 23:00,3625,29.21,95,179,3530
27.01.2017 00:00,3411,28.83,89,173,3322
27.01.2017 01:00,3230,28.52,83,153,3147
27.01.2017 02:00,3157,28.13,74,137,3083
27.01.2017 03:00,3134,28.07,62,122,3072
27.01.2017 04:00,3163,28.3,54,110,3109
27.01.2017 05:00,3194,28.69,61,105,3133
27.01.2017 06:00,3389,29.58,46,99,3343
27.01.2017 07:00,3866,30.88,42,102,3824
27.01.2017 08:00,4271,45.09,45,109,4226
27.01.2017 09:00,4326,46.26,60,112,4266
27.01.2017 10:00,4326,45.04,66,123,4260
27.01.2017 11:00,4282,43.47,80,121,4202
27.01.2017 12:00,4200,44.14,81,122,4119
27.01.2017 13:00,4087,43.3,75,120,4012
27.01.2017 14:00,3985,44.1,79,133,3906
27.01.2017 15:00,3881,43.88,104,157,3777
27.01.2017 16:00,3853,43.53,138,186,3715
27.01.2017 17:00,3931,44.78,195,222,3736
27.01.2017 18:00,4047,51.53,292,249,3755
27.01.2017 19:00,3945,44.76,367,274,3578
27.01.2017 20:00,3777,42.57,416,294,3361
27.01.2017 21:00,3631,30.07,388,292,3243
27.01.2017 22:00,3582,29.88,297,272,3285
27.01.2017 23:00,3464,29.53,247,267,3217
28.01.2017 00:00,3311,28.89,230,243,3081
28.01.2017 01:00,3098,28.84,240,205,2858
28.01.2017 02:00,3026,28.47,225,180,2801
28.01.2017 03:00,2991,28.25,201,159,2790
28.01.2017 04:00,3011,28.14,150,149,2861
28.01.2017 05:00,3090,28.18,102,144,2988
28.01.2017 06:00,3151,28.42,103,146,3048
28.01.2017 07:00,3274,28.67,130,158,3144
28.01.2017 08:00,3444,28.91,151,167,3293
28.01.2017 09:00,3543,29.35,167,167,3376
28.01.2017 10:00,3642,34.77,181,165,3461
28.01.2017 11:00,3667,38.64,171,157,3496
28.01.2017 12:00,3648,30.1,128,144,3520
28.01.2017 13:00,3616,30.03,83,137,3533
28.01.2017 14:00,3557,29.75,72,140,3485
28.01.2017 15:00,3487,29.65,85,149,3402
28.01.2017 16:00,3503,29.89,119,172,3384
28.01.2017 17:00,3667,31.16,156,211,3511
28.01.2017 18:00,3871,34.97,192,257,3679
28.01.2017 19:00,3819,30.97,252,297,3567
28.01.2017 20:00,3714,30.18,299,332,3415
28.01.2017 21:00,3592,29.75,334,342,3258
28.01.2017 22:00,3397,29.55,429,354,2968
28.01.2017 23:00,3221,29.08,433,358,2788
29.01.2017 00:00,3110,28.72,420,367,2690
29.01.2017 01:00,3112,28.82,369,371,2743
29.01.2017 02:00,3125,28.22,311,380,2814
29.01.2017 03:00,3103,27.87,317,395,2786
29.01.2017 04:00,3098,27.72,331,394,2767
29.01.2017 05:00,3079,27.68,370,405,2709
29.01.2017 06:00,3086,27.79,375,417,2711
29.01.2017 07:00,3194,27.76,394,433,2800
29.01.2017 08:00,3272,28.02,447,451,2825
29.01.2017 09:00,3418,28.6,416,464,3002
29.01.2017 10:00,3668,28.9,365,486,3303
29.01.2017 11:00,3792,29.34,357,499,3435
29.01.2017 12:00,3821,29.23,353,503,3468
29.01.2017 13:00,3791,28.93,339,500,3452
29.01.2017 14:00,3753,28.87,344,488,3409
29.01.2017 15:00,3712,28.85,360,494,3352
29.01.2017 16:00,3748,28.97,347,499,3401
29.01.2017 17:00,3873,29.55,371,515,3502
29.01.2017 18:00,4040,29.93,379,558,3661
29.01.2017 19:00,4027,29.82,404,580,3623
29.01.2017 20:00,3891,29.43,456,613,3435
29.01.2017 21:00,3741,28.97,491,632,3250
29.01.2017 22:00,3574,28.85,489,638,3085
29.01.2017 23:00,3379,28.62,498,632,2881
30.01.2017 00:00,3225,28.11,498,624,2727
30.01.2017 01:00,3028,27.32,462,520,2566
30.01.2017 02:00,2986,27.46,430,482,2556
30.01.2017 03:00,2997,27.39,361,444,2636
30.01.2017 04:00,3018,28,297,405,2721
30.01.2017 05:00,3106,28.73,221,360,2885
30.01.2017 06:00,3239,29.71,188,328,3051
30.01.2017 07:00,3745,31.03,153,294,3592
30.01.2017 08:00,4191,42.07,104,259,4087
30.01.2017 09:00,4252,47.9,86,221,4166
30.01.2017 10:00,4227,48.33,59,199,4168
30.01.2017 11:00,4251,48.1,41,168,4210
30.01.2017 12:00,4252,48.35,34,170,4218
30.01.2017 13:00,4171,47.08,31,159,4140
30.01.2017 14:00,4106,48.3,45,143,4061
30.01.2017 15:00,3939,46.82,59,140,3880
30.01.2017 16:00,3928,42.66,88,148,3840
30.01.2017 17:00,3928,46.81,132,161,3796
30.01.2017 18:00,4007,50.08,179,179,3828
30.01.2017 19:00,3917,44.88,218,202,3699
30.01.2017 20:00,3819,42.02,238,223,3581
30.01.2017 21:00,3614,31.21,289,242,3325
30.01.2017 22:00,3379,30.58,356,267,3023
30.01.2017 23:00,3173,30.1,375,287,2798
31.01.2017 00:00,2949,29.62,396,307,2553
31.01.2017 01:00,2977,28.78,469,458,2508
31.01.2017 02:00,2884,28.65,524,480,2360
31.01.2017 03:00,2852,28.66,569,499,2283
31.01.2017 04:00,2866,28.75,582,515,2284
31.01.2017 05:00,2930,29.4,603,520,2327
31.01.2017 06:00,3143,30.2,593,526,2550
31.01.2017 07:00,3640,33.28,524,525,3116
31.01.2017 08:00,4043,40.85,517,511,3526
31.01.2017 09:00,4105,44.91,556,508,3549
31.01.2017 10:00,4076,44.96,545,481,3531
31.01.2017 11:00,4146,43.07,498,452,3648
31.01.2017 12:00,4199,42.08,430,420,3769
31.01.2017 13:00,4197,42.03,337,378,3860
31.01.2017 14:00,4210,42.03,282,353,3928
31.01.2017 15:00,4189,39.11,258,339,3931
31.01.2017 16:00,4097,41.63,251,322,3846
31.01.2017 17:00,4127,44.96,238,316,3889
31.01.2017 18:00,4231,46.86,239,313,3992
31.01.2017 19:00,4149,45.03,232,313,3917
31.01.2017 20:00,4033,33.52,223,305,3810
31.01.2017 21:00,3883,31.77,199,276,3684
31.01.2017 22:00,3693,31.41,175,252,3518
31.01.2017 23:00,3418,30.53,173,230,3245
02.01.2017 00:00,3183,30.01,150,194,3033
02.01.2017 01:00,3021,29.25,102,157,2919
02.01.2017 02:00,2991,28.99,75,142,2916
02.01.2017 03:00,2975,28.91,69,137,2906
02.01.2017 04:00,2989,29.01,65,133,2924
02.01.2017 05:00,3044,29.62,65,138,2979
02.01.2017 06:00,3233,31.03,62,149,3171
02.01.2017 07:00,3711,31.89,72,163,3639
02.01.2017 08:00,4063,45.26,79,171,3984
02.01.2017 09:00,4142,48.19,91,164,4051
02.01.2017 10:00,4140,50.72,98,170,4042
02.01.2017 11:00,4200,49.57,109,172,4091
02.01.2017 12:00,4216,46.81,120,175,4096
02.01.2017 13:00,4147,46.8,123,177,4024
02.01.2017 14:00,4152,44.06,127,176,4025
02.01.2017 15:00,4082,44.59,145,179,3937
02.01.2017 16:00,4096,45.03,158,186,3938
02.01.2017 17:00,4123,47.65,161,196,3962
02.01.2017 18:00,4227,50.76,183,228,4044
02.01.2017 19:00,4171,44.75,214,271,3957
02.01.2017 20:00,4077,42.08,252,303,3825
02.01.2017 21:00,3905,30.86,293,323,3612
02.01.2017 22:00,3694,30.33,331,349,3363
02.01.2017 23:00,3463,29.83,374,370,3089
02.02.2017 00:00,3225,28.99,398,376,2827
02.02.2017 01:00,3019,29.03,413,361,2606
02.02.2017 02:00,2946,28.73,406,357,2540
02.02.2017 03:00,2940,28.6,391,351,2549
02.02.2017 04:00,2943,28.64,401,352,2542
02.02.2017 05:00,2990,29.15,407,350,2583
02.02.2017 06:00,3153,29.88,431,365,2722
02.02.2017 07:00,3639,31.05,425,376,3214
02.02.2017 08:00,4060,42.42,435,389,3625
02.02.2017 09:00,4149,46.95,405,402,3744
02.02.2017 10:00,4128,46.96,421,395,3707
02.02.2017 11:00,4163,46.95,405,383,3758
02.02.2017 12:00,4194,42,362,365,3832
02.02.2017 13:00,4175,35.03,338,346,3837
02.02.2017 14:00,4185,35.02,305,334,3880
02.02.2017 15:00,4166,44.89,277,324,3889
02.02.2017 16:00,4149,42.08,299,325,3850
02.02.2017 17:00,4121,44.88,325,333,3796
02.02.2017 18:00,4238,47.63,348,347,3890
02.02.2017 19:00,4157,46.28,336,364,3821
02.02.2017 20:00,4086,44.01,319,371,3767
02.02.2017 21:00,3936,32,336,373,3600
02.02.2017 22:00,3777,31.53,301,364,3476
02.02.2017 23:00,3515,30.84,298,355,3217
02.03.2017 00:00,3312,30.06,271,345,3041
02.03.2017 01:00,3138,30,230,320,2908
02.03.2017 02:00,3088,29.7,211,312,2877
02.03.2017 03:00,3108,29.6,187,322,2921
02.03.2017 04:00,3110,29.68,188,321,2922
02.03.2017 05:00,3166,30.26,203,343,2963
02.03.2017 06:00,3346,31.1,227,361,3119
02.03.2017 07:00,3790,31.93,272,394,3518
02.03.2017 08:00,4208,47.22,298,413,3910
02.03.2017 09:00,4291,48.31,273,412,4018
02.03.2017 10:00,4266,49.27,278,412,3988
02.03.2017 11:00,4241,49.03,303,385,3938
02.03.2017 12:00,4235,42.02,292,355,3943
02.03.2017 13:00,4159,34.72,279,338,3880
02.03.2017 14:00,4148,40.25,277,356,3871
02.03.2017 15:00,4042,33.3,331,377,3711
02.03.2017 16:00,3943,33.37,383,393,3560
02.03.2017 17:00,4003,47.08,370,419,3633
02.03.2017 18:00,4158,50.08,340,432,3818
02.03.2017 19:00,4070,48.31,333,445,3737
02.03.2017 20:00,3874,34.11,343,452,3531
02.03.2017 21:00,3660,32,372,454,3288
02.03.2017 22:00,3492,31.36,388,457,3104
02.03.2017 23:00,3289,30.99,414,454,2875
02.04.2017 00:00,3118,30.68,416,463,2702
02.04.2017 01:00,3031,30.84,397,497,2634
02.04.2017 02:00,2994,30.38,376,513,2618
02.04.2017 03:00,2920,30.14,414,528,2506
02.04.2017 04:00,2868,30.03,443,536,2425
02.04.2017 05:00,2890,30.21,460,548,2430
02.04.2017 06:00,2922,30.4,470,555,2452
02.04.2017 07:00,3090,30.74,452,557,2638
02.04.2017 08:00,3295,31.06,440,560,2855
02.04.2017 09:00,3404,31.54,470,554,2934
02.04.2017 10:00,3549,32.39,466,531,3083
02.04.2017 11:00,3648,33.02,438,489,3210
02.04.2017 12:00,3648,33.11,421,463,3227
02.04.2017 13:00,3578,32.71,445,425,3133
02.04.2017 14:00,3524,32.55,431,400,3093
02.04.2017 15:00,3520,32.36,374,372,3146
02.04.2017 16:00,3518,32.79,338,352,3180
02.04.2017 17:00,3574,33.67,342,337,3232
02.04.2017 18:00,3671,38.44,369,312,3302
02.04.2017 19:00,3598,35.09,379,307,3219
02.04.2017 20:00,3479,33.66,358,302,3121
02.04.2017 21:00,3370,32.65,293,299,3077
02.04.2017 22:00,3285,31.94,253,295,3032
02.04.2017 23:00,3158,31.45,241,295,2917
02.05.2017 00:00,3019,30.9,233,292,2786
02.05.2017 01:00,2926,31,235,310,2691
02.05.2017 02:00,2831,30.85,239,315,2592
02.05.2017 03:00,2782,30.64,265,326,2517
02.05.2017 04:00,2759,30.43,294,335,2465
02.05.2017 05:00,2768,30.47,313,352,2455
02.05.2017 06:00,2834,30.62,320,383,2514
02.05.2017 07:00,2941,30.9,341,408,2600
02.05.2017 08:00,3082,31.43,368,445,2714
02.05.2017 09:00,3222,31.39,408,483,2814
02.05.2017 10:00,3383,31.88,445,514,2938
02.05.2017 11:00,3485,32.16,531,554,2954
02.05.2017 12:00,3600,32.29,558,604,3042
02.05.2017 13:00,3641,32.1,573,632,3068
02.05.2017 14:00,3615,32.01,607,657,3008
02.05.2017 15:00,3558,31.91,650,682,2908
02.05.2017 16:00,3481,31.96,733,673,2748
02.05.2017 17:00,3561,32.8,784,676,2777
02.05.2017 18:00,3757,33.79,787,713,2970
02.05.2017 19:00,3837,33.73,736,752,3101
02.05.2017 20:00,3721,32.91,778,790,2943
02.05.2017 21:00,3558,31.93,819,794,2739
02.05.2017 22:00,3420,31.76,757,750,2663
02.05.2017 23:00,3263,31.25,714,741,2549
02.06.2017 00:00,3124,30.74,678,720,2446
02.06.2017 01:00,2976,30.59,607,659,2369
02.06.2017 02:00,2923,30.02,580,626,2343
02.06.2017 03:00,2924,29.82,560,604,2364
02.06.2017 04:00,2908,30.1,574,584,2334
02.06.2017 05:00,2915,30.92,633,581,2282
02.06.2017 06:00,3124,31.44,635,579,2489
02.06.2017 07:00,3640,32.6,611,587,3029
02.06.2017 08:00,4095,41.41,592,588,3503
02.06.2017 09:00,4136,46.28,594,587,3542
02.06.2017 10:00,4212,48.98,575,601,3637
02.06.2017 11:00,4220,46.5,616,604,3604
02.06.2017 12:00,4220,42.01,633,624,3587
02.06.2017 13:00,4156,35.01,688,649,3468
02.06.2017 14:00,4115,39.93,741,658,3374
02.06.2017 15:00,4072,34.98,780,678,3292
02.06.2017 16:00,4098,35.19,830,700,3268
02.06.2017 17:00,4130,41.98,833,729,3297
02.06.2017 18:00,4215,53.11,928,756,3287
02.06.2017 19:00,4230,49.94,882,779,3348
02.06.2017 20:00,4147,35.17,875,782,3272
02.06.2017 21:00,4007,33.31,860,779,3147
02.06.2017 22:00,3768,32.13,866,743,2902
02.06.2017 23:00,3593,31.62,807,717,2786
02.07.2017 00:00,3432,31.02,774,701,2658
02.07.2017 01:00,3270,31.11,731,678,2539
02.07.2017 02:00,3206,30.96,727,671,2479
02.07.2017 03:00,3162,30.9,763,681,2399
02.07.2017 04:00,3197,30.94,744,697,2453
02.07.2017 05:00,3343,31.43,702,726,2641
02.07.2017 06:00,3509,32.71,776,767,2733
02.07.2017 07:00,3847,35.05,915,797,2932
02.07.2017 08:00,4202,59.81,1011,824,3191
02.07.2017 09:00,4267,55.13,1054,868,3213
02.07.2017 10:00,4388,56.22,1024,914,3364
02.07.2017 11:00,4442,49.7,1058,955,3384
02.07.2017 12:00,4466,45.07,1079,986,3387
02.07.2017 13:00,4442,40.49,1078,997,3364
02.07.2017 14:00,4480,45.63,1057,1003,3423
02.07.2017 15:00,4448,41,1043,984,3405
02.07.2017 16:00,4448,39.88,1060,990,3388
02.07.2017 17:00,4449,47.29,1037,1000,3412
02.07.2017 18:00,4554,63.86,1054,996,3500
02.07.2017 19:00,4458,61,1076,992,3382
02.07.2017 20:00,4347,44.79,1077,992,3270
02.07.2017 21:00,4181,37.89,1076,959,3105
02.07.2017 22:00,4020,35.33,1042,957,2978
02.07.2017 23:00,3764,33.04,1043,934,2721
02.08.2017 00:00,3524,31.88,1051,911,2473
02.08.2017 01:00,3359,31.54,1045,916,2314
02.08.2017 02:00,3249,31.24,1089,920,2160
02.08.2017 03:00,3259,31.16,1073,931,2186
02.08.2017 04:00,3309,31.19,1043,925,2266
02.08.2017 05:00,3363,31.77,1058,930,2305
02.08.2017 06:00,3565,33.85,1022,921,2543
02.08.2017 07:00,4066,34.43,978,910,3088
02.08.2017 08:00,4443,52.5,967,917,3476
02.08.2017 09:00,4546,67.51,925,931,3621
02.08.2017 10:00,4540,61.01,938,944,3602
02.08.2017 11:00,4560,57.47,959,949,3601
02.08.2017 12:00,4566,50.09,937,926,3629
02.08.2017 13:00,4491,45.01,951,907,3540
02.08.2017 14:00,4481,49.11,957,886,3524
02.08.2017 15:00,4413,46.76,950,854,3463
02.08.2017 16:00,4321,46.9,967,830,3354
02.08.2017 17:00,4316,51.49,956,822,3360
02.08.2017 18:00,4430,70.2,979,801,3451
02.08.2017 19:00,4384,70.19,962,788,3422
02.08.2017 20:00,4339,50.06,887,758,3452
02.08.2017 21:00,4181,43.74,813,706,3368
02.08.2017 22:00,3986,40.5,770,651,3216
02.08.2017 23:00,3755,35.52,704,602,3051
02.09.2017 00:00,3544,33.17,658,560,2886
02.09.2017 01:00,3357,32.49,633,510,2724
02.09.2017 02:00,3305,32.34,592,476,2713
02.09.2017 03:00,3282,32.25,558,453,2724
02.09.2017 04:00,3321,32.37,510,431,2811
02.09.2017 05:00,3397,33.24,480,413,2917
02.09.2017 06:00,3619,33.42,439,395,3180
02.09.2017 07:00,4069,37.08,392,382,3677
02.09.2017 08:00,4444,57.17,329,357,4115
02.09.2017 09:00,4535,65.42,278,340,4257
02.09.2017 10:00,4569,64.91,214,313,4355
02.09.2017 11:00,4626,64.67,155,293,4471
02.09.2017 12:00,4582,51.14,122,269,4460
02.09.2017 13:00,4516,50.19,100,252,4416
02.09.2017 14:00,4503,55.83,94,235,4409
02.09.2017 15:00,4507,50.72,105,238,4402
02.09.2017 16:00,4476,50,110,227,4366
02.09.2017 17:00,4465,57.13,119,228,4346
02.09.2017 18:00,4626,68.74,135,244,4491
02.09.2017 19:00,4583,62.04,135,255,4448
02.09.2017 20:00,4495,45.35,147,263,4348
02.09.2017 21:00,4270,39.55,162,269,4108
02.09.2017 22:00,4125,36.6,153,258,3972
02.09.2017 23:00,3873,33.58,149,266,3724
02.10.2017 00:00,3635,32.63,154,283,3481
02.10.2017 01:00,3493,33.08,175,277,3318
02.10.2017 02:00,3420,32.67,190,304,3230
02.10.2017 03:00,3399,32.43,210,338,3189
02.10.2017 04:00,3423,32.31,228,358,3195
02.10.2017 05:00,3443,32.55,276,390,3167
02.10.2017 06:00,3602,33.4,349,434,3253
02.10.2017 07:00,4019,34.9,374,475,3645
02.10.2017 08:00,4455,53.05,380,514,4075
02.10.2017 09:00,4466,58.96,426,541,4040
02.10.2017 10:00,4546,53.05,458,568,4088
02.10.2017 11:00,4488,53.05,569,581,3919
02.10.2017 12:00,4474,44.42,592,624,3882
02.10.2017 13:00,4324,41.63,608,640,3716
02.10.2017 14:00,4256,38.59,619,659,3637
02.10.2017 15:00,4132,37.75,651,682,3481
02.10.2017 16:00,4013,36.66,728,718,3285
02.10.2017 17:00,3921,37.64,846,758,3075
02.10.2017 18:00,4069,40.39,937,796,3132
02.10.2017 19:00,4031,38.32,1016,826,3015
02.10.2017 20:00,3818,35,1066,854,2752
02.10.2017 21:00,3629,33.46,1067,857,2562
02.10.2017 22:00,3499,33.2,1044,864,2455
02.10.2017 23:00,3329,32.85,1040,861,2289
02.11.2017 00:00,3203,32.11,1009,842,2194
02.11.2017 01:00,3054,32.03,997,838,2057
02.11.2017 02:00,2992,31.7,991,826,2001
02.11.2017 03:00,2991,31.42,963,820,2028
02.11.2017 04:00,3004,31.26,973,831,2031
02.11.2017 05:00,2983,31.35,1019,829,1964
02.11.2017 06:00,3043,31.66,1036,837,2007
02.11.2017 07:00,3169,31.87,1042,842,2127
02.11.2017 08:00,3273,32.03,1050,843,2223
02.11.2017 09:00,3434,32.19,1013,823,2421
02.11.2017 10:00,3585,32.75,964,830,2621
02.11.2017 11:00,3603,32.94,949,811,2654
02.11.2017 12:00,3615,32.61,924,825,2691
02.11.2017 13:00,3569,32.3,924,815,2645
02.11.2017 14:00,3512,32.13,917,796,2595
02.11.2017 15:00,3379,32.01,956,753,2423
02.11.2017 16:00,3372,32.07,974,742,2398
02.11.2017 17:00,3497,32.32,953,728,2544
02.11.2017 18:00,3717,33.91,951,733,2766
02.11.2017 19:00,3742,33.93,920,734,2822
02.11.2017 20:00,3609,32.97,910,732,2699
02.11.2017 21:00,3439,32.5,900,708,2539
02.11.2017 22:00,3323,32.46,826,671,2497
02.11.2017 23:00,3157,32.2,803,631,2354
02.12.2017 00:00,3054,31.86,730,592,2324
02.12.2017 01:00,2940,31.43,714,608,2226
02.12.2017 02:00,2819,31.06,745,580,2074
02.12.2017 03:00,2758,30.4,772,561,1986
02.12.2017 04:00,2754,30.41,766,558,1988
02.12.2017 05:00,2757,29.78,755,537,2002
02.12.2017 06:00,2871,29.9,681,530,2190
02.12.2017 07:00,2989,30.36,628,510,2361
02.12.2017 08:00,3124,30.99,586,496,2538
02.12.2017 09:00,3190,31.69,627,473,2563
02.12.2017 10:00,3317,32.29,621,469,2696
02.12.2017 11:00,3383,32.57,607,448,2776
02.12.2017 12:00,3378,32.5,624,445,2754
02.12.2017 13:00,3356,31.57,598,417,2758
02.12.2017 14:00,3306,30.96,532,390,2774
02.12.2017 15:00,3354,30.91,412,334,2942
02.12.2017 16:00,3420,31.27,327,303,3093
02.12.2017 17:00,3573,32.14,250,255,3323
02.12.2017 18:00,3832,35.14,231,223,3601
02.12.2017 19:00,3956,35.56,201,202,3755
02.12.2017 20:00,3891,35.53,163,168,3728
02.12.2017 21:00,3788,32.92,129,150,3659
02.12.2017 22:00,3659,32.32,89,127,3570
02.12.2017 23:00,3505,32.39,79,109,3426
13.02.2017 00:00,3333,31.35,53,92,3280
13.02.2017 01:00,3244,28.83,36,70,3208
13.02.2017 02:00,3187,29.68,30,64,3157
13.02.2017 03:00,3231,30.37,25,60,3206
13.02.2017 04:00,3248,29.83,24,59,3224
13.02.2017 05:00,3282,30.76,29,58,3253
13.02.2017 06:00,3470,32.22,42,62,3428
13.02.2017 07:00,3978,36.58,58,64,3920
13.02.2017 08:00,4344,45.09,91,70,4253
13.02.2017 09:00,4379,49.54,122,69,4257
13.02.2017 10:00,4320,49.59,109,66,4211
13.02.2017 11:00,4308,49.65,69,60,4239
13.02.2017 12:00,4222,45.06,58,53,4164
13.02.2017 13:00,4146,37.24,51,51,4095
13.02.2017 14:00,4078,34.22,49,54,4029
13.02.2017 15:00,4023,38.23,60,63,3963
13.02.2017 16:00,4010,42.47,91,80,3919
13.02.2017 17:00,3995,45.63,153,106,3842
13.02.2017 18:00,4155,51.76,256,137,3899
13.02.2017 19:00,4172,52.83,313,157,3859
13.02.2017 20:00,4083,45.29,359,170,3724
13.02.2017 21:00,3946,42.08,374,176,3572
13.02.2017 22:00,3778,32.84,362,173,3416
13.02.2017 23:00,3564,32.19,354,169,3210
14.02.2017 00:00,3389,31.51,358,171,3031
14.02.2017 01:00,3254,30.49,367,182,2887
14.02.2017 02:00,3192,30.03,398,190,2794
14.02.2017 03:00,3146,30.1,425,199,2721
14.02.2017 04:00,3228,30.14,398,208,2830
14.02.2017 05:00,3279,30.62,410,219,2869
14.02.2017 06:00,3476,31.66,401,233,3075
14.02.2017 07:00,3937,34.74,394,229,3543
14.02.2017 08:00,4227,46.83,418,221,3809
14.02.2017 09:00,4261,49.42,399,203,3862
14.02.2017 10:00,4187,46.89,290,178,3897
14.02.2017 11:00,4177,38.39,119,130,4058
14.02.2017 12:00,4064,36.64,34,92,4030
14.02.2017 13:00,3904,35.86,16,81,3888
14.02.2017 14:00,3799,38.33,8,60,3791
14.02.2017 15:00,3705,37.31,9,42,3696
14.02.2017 16:00,3684,41.88,16,42,3668
14.02.2017 17:00,3683,47.68,25,49,3658
14.02.2017 18:00,4002,54.58,38,53,3964
14.02.2017 19:00,4084,51.69,37,54,4047
14.02.2017 20:00,4013,46.33,30,52,3983
14.02.2017 21:00,3887,45.03,27,46,3860
14.02.2017 22:00,3729,34.91,24,43,3705
14.02.2017 23:00,3499,33.04,25,42,3474
15.02.2017 00:00,3339,32.17,28,42,3311
15.02.2017 01:00,3168,32.11,20,38,3148
15.02.2017 02:00,3132,32.21,13,36,3119
15.02.2017 03:00,3125,32.32,7,32,3118
15.02.2017 04:00,3160,32.44,7,30,3153
15.02.2017 05:00,3261,33.92,9,29,3252
15.02.2017 06:00,3431,37.08,14,30,3417
15.02.2017 07:00,3931,43.64,26,35,3905
15.02.2017 08:00,4202,61.48,60,44,4142
15.02.2017 09:00,4200,63.32,98,62,4102
15.02.2017 10:00,4071,59.3,117,85,3954
15.02.2017 11:00,3974,55.69,109,105,3865
15.02.2017 12:00,3838,39.66,80,96,3758
15.02.2017 13:00,3731,37.35,68,106,3663
15.02.2017 14:00,3661,38.08,72,98,3589
15.02.2017 15:00,3661,44.13,63,101,3598
15.02.2017 16:00,3567,43.02,78,110,3489
15.02.2017 17:00,3607,49.08,120,140,3487
15.02.2017 18:00,3858,59.16,179,170,3679
15.02.2017 19:00,3861,62.05,306,195,3555
15.02.2017 20:00,3754,43.81,386,218,3368
15.02.2017 21:00,3598,38.07,442,237,3156
15.02.2017 22:00,3442,35.28,446,242,2996
15.02.2017 23:00,3224,32.45,452,233,2772
16.02.2017 00:00,3090,31.38,400,212,2690
16.02.2017 01:00,3076,30.5,322,240,2754
16.02.2017 02:00,3110,30.33,282,229,2828
16.02.2017 03:00,3109,30.24,252,223,2857
16.02.2017 04:00,3107,30.5,271,218,2836
16.02.2017 05:00,3234,30.55,232,227,3002
16.02.2017 06:00,3463,31.21,214,247,3249
16.02.2017 07:00,3860,31.63,298,290,3562
16.02.2017 08:00,4128,41.82,397,338,3731
16.02.2017 09:00,4105,44.04,450,367,3655
16.02.2017 10:00,3980,32.52,574,435,3406
16.02.2017 11:00,3998,32.27,487,458,3511
16.02.2017 12:00,3948,32.03,466,513,3482
16.02.2017 13:00,3711,31.95,604,575,3107
16.02.2017 14:00,3695,31.94,690,629,3005
16.02.2017 15:00,3693,31.88,722,668,2971
16.02.2017 16:00,3786,31.76,720,710,3066
16.02.2017 17:00,3794,31.91,758,734,3036
16.02.2017 18:00,3926,32.44,794,748,3132
16.02.2017 19:00,3828,32.42,856,744,2972
16.02.2017 20:00,3741,31.97,825,740,2916
16.02.2017 21:00,3636,31.57,755,724,2881
16.02.2017 22:00,3437,31.3,736,695,2701
16.02.2017 23:00,3157,30.93,744,651,2413
17.02.2017 00:00,2920,30.1,683,595,2237
17.02.2017 01:00,2868,29.42,600,599,2268
17.02.2017 02:00,2867,28.63,525,554,2342
17.02.2017 03:00,2802,28.09,514,512,2288
17.02.2017 04:00,2808,28.45,477,463,2331
17.02.2017 05:00,2887,30,377,417,2510
17.02.2017 06:00,3058,30.75,330,387,2728
17.02.2017 07:00,3468,31.61,309,353,3159
17.02.2017 08:00,3853,32.24,263,299,3590
17.02.2017 09:00,3951,32.83,208,245,3743
17.02.2017 10:00,3960,32.51,153,206,3807
17.02.2017 11:00,3967,32.42,131,181,3836
17.02.2017 12:00,3927,32.18,128,169,3799
17.02.2017 13:00,3880,32.04,100,168,3780
17.02.2017 14:00,3807,32,87,151,3720
17.02.2017 15:00,3717,31.89,83,146,3634
17.02.2017 16:00,3647,31.57,89,142,3558
17.02.2017 17:00,3601,31.71,103,147,3498
17.02.2017 18:00,3762,32.08,116,151,3646
17.02.2017 19:00,3728,32.2,151,154,3577
17.02.2017 20:00,3490,31.81,187,147,3303
17.02.2017 21:00,3348,31.1,172,143,3176
17.02.2017 22:00,3178,30.85,167,130,3011
17.02.2017 23:00,3005,30.82,158,116,2847
18.02.2017 00:00,2925,30.47,115,100,2810
18.02.2017 01:00,2756,30.1,92,81,2664
18.02.2017 02:00,2695,30.01,60,72,2635
18.02.2017 03:00,2676,29.54,49,63,2627
18.02.2017 04:00,2674,29.86,48,61,2626
18.02.2017 05:00,2688,30.04,46,58,2642
18.02.2017 06:00,2752,30.25,40,58,2712
18.02.2017 07:00,2903,30.16,43,61,2860
18.02.2017 08:00,3056,30.5,47,61,3009
18.02.2017 09:00,3232,30.77,47,64,3185
18.02.2017 10:00,3426,31.09,40,73,3386
18.02.2017 11:00,3507,31.33,60,93,3447
18.02.2017 12:00,3502,31.09,81,108,3421
18.02.2017 13:00,3431,30.78,117,135,3314
18.02.2017 14:00,3381,30.58,159,175,3222
18.02.2017 15:00,3308,30.26,210,222,3098
18.02.2017 16:00,3235,30.12,297,274,2938
18.02.2017 17:00,3211,30.4,454,337,2757
18.02.2017 18:00,3422,30.92,489,412,2933
18.02.2017 19:00,3555,30.94,498,507,3057
18.02.2017 20:00,3406,30.67,601,597,2805
18.02.2017 21:00,3280,30.06,647,655,2633
18.02.2017 22:00,3079,29.7,754,731,2325
18.02.2017 23:00,2915,28.91,841,798,2074
19.02.2017 00:00,2850,25.64,899,898,1951
19.02.2017 01:00,2698,23.51,945,921,1753
19.02.2017 02:00,2654,21.74,972,970,1682
19.02.2017 03:00,2635,21,1019,1023,1616
19.02.2017 04:00,2637,19.99,1040,1065,1597
19.02.2017 05:00,2704,19.97,999,1082,1705
19.02.2017 06:00,2765,21.3,971,1079,1794
19.02.2017 07:00,2851,21.33,950,1062,1901
19.02.2017 08:00,2903,21.93,946,1032,1957
19.02.2017 09:00,2995,25.47,915,980,2080
19.02.2017 10:00,3101,29.59,931,935,2170
19.02.2017 11:00,3194,29.82,883,877,2311
19.02.2017 12:00,3242,30.67,845,831,2397
19.02.2017 13:00,3299,30.17,772,811,2527
19.02.2017 14:00,3286,30.44,715,763,2571
19.02.2017 15:00,3248,30.51,651,719,2597
19.02.2017 16:00,3240,30.34,639,683,2601
19.02.2017 17:00,3197,30.79,755,692,2442
19.02.2017 18:00,3284,31.49,867,714,2417
19.02.2017 19:00,3328,31.62,880,744,2448
19.02.2017 20:00,3270,31.25,907,788,2363
19.02.2017 21:00,3115,30.86,960,831,2155
19.02.2017 22:00,3006,30.58,967,870,2039
19.02.2017 23:00,2845,29.45,1004,915,1841
20.02.2017 00:00,2685,26.74,1066,966,1619
20.02.2017 01:00,2575,23.2,1143,985,1432
20.02.2017 02:00,2518,22.6,1187,1026,1331
20.02.2017 03:00,2498,22.12,1220,1055,1278
20.02.2017 04:00,2555,22.72,1217,1082,1338
20.02.2017 05:00,2637,24.38,1204,1106,1433
20.02.2017 06:00,2737,26.86,1286,1117,1451
20.02.2017 07:00,3136,30.32,1324,1158,1812
20.02.2017 08:00,3481,30.92,1390,1211,2091
20.02.2017 09:00,3558,31.12,1432,1222,2126
20.02.2017 10:00,3617,31.05,1435,1251,2182
20.02.2017 11:00,3721,31.03,1408,1273,2313
20.02.2017 12:00,3777,30.96,1378,1275,2399
20.02.2017 13:00,3728,30.92,1337,1263,2391
20.02.2017 14:00,3736,30.88,1312,1242,2424
20.02.2017 15:00,3673,30.86,1268,1216,2405
20.02.2017 16:00,3735,30.79,1236,1205,2499
20.02.2017 17:00,3753,30.89,1166,1206,2587
20.02.2017 18:00,3826,31.19,1187,1203,2639
20.02.2017 19:00,3730,31.14,1222,1217,2508
20.02.2017 20:00,3620,30.93,1242,1247,2378
20.02.2017 21:00,3474,30.63,1218,1258,2256
20.02.2017 22:00,3253,29.55,1248,1263,2005
20.02.2017 23:00,3029,27.79,1302,1284,1727
21.02.2017 00:00,2897,25.41,1308,1311,1589
21.02.2017 01:00,2758,24.81,1319,1306,1439
21.02.2017 02:00,2696,23.44,1320,1330,1376
21.02.2017 03:00,2683,23.18,1316,1347,1367
21.02.2017 04:00,2696,23.26,1339,1370,1357
21.02.2017 05:00,2744,25.05,1374,1387,1370
21.02.2017 06:00,2912,26.65,1372,1379,1540
21.02.2017 07:00,3281,30.03,1340,1373,1941
21.02.2017 08:00,3595,30.97,1300,1322,2295
21.02.2017 09:00,3726,31,1261,1306,2465
21.02.2017 10:00,3706,30.96,1283,1291,2423
21.02.2017 11:00,3694,30.92,1287,1273,2407
21.02.2017 12:00,3681,30.79,1256,1265,2425
21.02.2017 13:00,3634,30.68,1218,1255,2416
21.02.2017 14:00,3610,30.67,1186,1218,2424
21.02.2017 15:00,3495,30.58,1174,1148,2321
21.02.2017 16:00,3469,30.7,1117,1069,2352
21.02.2017 17:00,3518,30.98,941,965,2577
21.02.2017 18:00,3772,31.9,712,818,3060
21.02.2017 19:00,3876,32.19,506,693,3370
21.02.2017 20:00,3758,31.97,456,591,3302
21.02.2017 21:00,3594,31.74,400,511,3194
21.02.2017 22:00,3399,31.34,336,415,3063
21.02.2017 23:00,3159,30.75,327,371,2832
22.02.2017 00:00,2858,29.9,398,376,2460
22.02.2017 01:00,2714,27.43,492,408,2222
22.02.2017 02:00,2624,26.16,616,499,2008
22.02.2017 03:00,2645,25.06,710,629,1935
22.02.2017 04:00,2606,25.12,894,761,1712
22.02.2017 05:00,2603,26.8,1091,899,1512
22.02.2017 06:00,2755,26.47,1259,1026,1496
22.02.2017 07:00,3095,28.64,1360,1126,1735
22.02.2017 08:00,3339,30.44,1409,1173,1930
22.02.2017 09:00,3416,30.45,1418,1194,1998
22.02.2017 10:00,3448,30.41,1391,1212,2057
22.02.2017 11:00,3460,30.26,1373,1224,2087
22.02.2017 12:00,3421,30.09,1411,1232,2010
22.02.2017 13:00,3395,30.03,1416,1257,1979
22.02.2017 14:00,3394,29.94,1425,1273,1969
22.02.2017 15:00,3400,29.94,1418,1288,1982
22.02.2017 16:00,3468,29.84,1417,1346,2051
22.02.2017 17:00,3471,29.93,1423,1368,2048
22.02.2017 18:00,3610,30.33,1443,1374,2167
22.02.2017 19:00,3636,30.44,1450,1387,2186
22.02.2017 20:00,3561,30.22,1460,1403,2101
22.02.2017 21:00,3425,29.17,1475,1417,1950
22.02.2017 22:00,3302,27.43,1463,1431,1839
22.02.2017 23:00,3109,25.66,1459,1437,1650
23.02.2017 00:00,2934,23.48,1450,1443,1484
23.02.2017 01:00,2833,23.04,1439,1450,1394
23.02.2017 02:00,2764,16.8,1438,1434,1326
23.02.2017 03:00,2752,16.54,1389,1408,1363
23.02.2017 04:00,2720,16.55,1353,1370,1367
23.02.2017 05:00,2784,22.17,1270,1310,1514
23.02.2017 06:00,2978,25.53,1136,1226,1842
23.02.2017 07:00,3361,30.29,1002,1109,2359
23.02.2017 08:00,3707,31.14,843,967,2864
23.02.2017 09:00,3819,31.84,667,793,3152
23.02.2017 10:00,3871,32.06,439,636,3432
23.02.2017 11:00,3905,32.43,241,464,3664
23.02.2017 12:00,3827,32.18,168,339,3659
23.02.2017 13:00,3676,31.85,153,238,3523
23.02.2017 14:00,3595,31.69,129,144,3466
23.02.2017 15:00,3585,31.24,107,98,3478
23.02.2017 16:00,3615,30.9,69,79,3546
23.02.2017 17:00,3593,30.95,84,85,3509
23.02.2017 18:00,3724,32.03,134,122,3590
23.02.2017 19:00,3734,32.68,245,173,3489
23.02.2017 20:00,3565,31.94,449,236,3116
23.02.2017 21:00,3320,30.52,616,333,2704
23.02.2017 22:00,3226,30.12,665,453,2561
23.02.2017 23:00,3134,29.08,722,552,2412
24.02.2017 00:00,3005,27.01,741,636,2264
24.02.2017 01:00,2950,26.38,851,779,2099
24.02.2017 02:00,2891,24.7,930,830,1961
24.02.2017 03:00,2938,24.24,892,845,2046
24.02.2017 04:00,3018,24.37,823,832,2195
24.02.2017 05:00,3125,26.52,724,776,2401
24.02.2017 06:00,3282,28.93,653,696,2629
24.02.2017 07:00,3586,30.81,616,615,2970
24.02.2017 08:00,3879,32.67,569,547,3310
24.02.2017 09:00,4057,33.48,437,452,3620
24.02.2017 10:00,4019,33.09,338,405,3681
24.02.2017 11:00,4005,32.78,261,353,3744
24.02.2017 12:00,3964,32.39,230,347,3734
24.02.2017 13:00,3845,31.71,263,377,3582
24.02.2017 14:00,3711,31.2,346,422,3365
24.02.2017 15:00,3508,30.92,459,457,3049
24.02.2017 16:00,3380,30.83,525,474,2855
24.02.2017 17:00,3361,30.98,567,492,2794
24.02.2017 18:00,3581,31.78,542,495,3039
24.02.2017 19:00,3765,32.47,550,531,3215
24.02.2017 20:00,3682,31.85,586,559,3096
24.02.2017 21:00,3499,31.26,602,568,2897
24.02.2017 22:00,3301,31,639,561,2662
24.02.2017 23:00,3171,30.93,624,551,2547
25.02.2017 00:00,3037,30.57,617,538,2420
25.02.2017 01:00,2914,29.28,638,531,2276
25.02.2017 02:00,2868,29.09,610,513,2258
25.02.2017 03:00,2885,28.94,601,494,2284
25.02.2017 04:00,2887,29.1,599,489,2288
25.02.2017 05:00,2907,29.64,564,467,2343
25.02.2017 06:00,2980,29.53,539,438,2441
25.02.2017 07:00,3138,30.71,553,413,2585
25.02.2017 08:00,3215,30.84,524,368,2691
25.02.2017 09:00,3388,31.16,376,320,3012
25.02.2017 10:00,3495,31.46,219,262,3276
25.02.2017 11:00,3393,31.31,201,224,3192
25.02.2017 12:00,3253,31.06,246,205,3007
25.02.2017 13:00,3160,30.2,259,218,2901
25.02.2017 14:00,3122,29.54,289,260,2833
25.02.2017 15:00,3094,29.47,345,300,2749
25.02.2017 16:00,3067,29.59,481,370,2586
25.02.2017 17:00,3072,30.16,668,470,2404
25.02.2017 18:00,3196,31.01,853,591,2343
25.02.2017 19:00,3277,31.08,991,730,2286
25.02.2017 20:00,3221,30.78,1094,844,2127
25.02.2017 21:00,3103,29.88,1195,936,1908
25.02.2017 22:00,3015,29.75,1237,1019,1778
25.02.2017 23:00,2904,28.8,1249,1061,1655
26.02.2017 00:00,2797,26.91,1243,1087,1554
26.02.2017 01:00,2775,26.73,1230,1163,1545
26.02.2017 02:00,2676,26.15,1218,1141,1458
26.02.2017 03:00,2635,25.1,1185,1115,1450
26.02.2017 04:00,2639,25.04,1117,1097,1522
26.02.2017 05:00,2652,26.2,1045,1051,1607
26.02.2017 06:00,2726,27.17,934,996,1792
26.02.2017 07:00,2746,27.76,920,930,1826
26.02.2017 08:00,2758,28.04,870,866,1888
26.02.2017 09:00,2854,28.9,814,787,2040
26.02.2017 10:00,2995,29.2,747,723,2248
26.02.2017 11:00,3068,29.79,680,657,2388
26.02.2017 12:00,3061,29.75,635,611,2426
26.02.2017 13:00,3007,29.52,629,574,2378
26.02.2017 14:00,2963,29.3,606,542,2357
26.02.2017 15:00,2896,29.19,593,500,2303
26.02.2017 16:00,2953,29.1,497,458,2456
26.02.2017 17:00,3045,29.65,426,434,2619
26.02.2017 18:00,3172,30.64,462,427,2710
26.02.2017 19:00,3280,31.76,506,434,2774
26.02.2017 20:00,3201,30.98,507,439,2694
26.02.2017 21:00,3133,30.41,427,454,2706
26.02.2017 22:00,2978,30.06,422,456,2556
26.02.2017 23:00,2813,29.11,439,466,2374
27.02.2017 00:00,2717,27.72,422,491,2295
27.02.2017 01:00,2612,27.48,377,463,2235
27.02.2017 02:00,2512,26.4,445,485,2067
27.02.2017 03:00,2423,25.9,552,519,1871
27.02.2017 04:00,2413,26.43,670,569,1743
27.02.2017 05:00,2430,28.44,744,613,1686
27.02.2017 06:00,2572,30.11,793,650,1779
27.02.2017 07:00,3041,30.96,820,679,2221
27.02.2017 08:00,3373,31.93,868,700,2505
27.02.2017 09:00,3508,32.59,845,691,2663
27.02.2017 10:00,3541,32.46,815,686,2726
27.02.2017 11:00,3577,32.28,786,667,2791
27.02.2017 12:00,3592,31.77,741,646,2851
27.02.2017 13:00,3566,30.91,702,633,2864
27.02.2017 14:00,3598,30.58,645,628,2953
27.02.2017 15:00,3619,30.59,614,641,3005
27.02.2017 16:00,3614,30.83,617,653,2997
27.02.2017 17:00,3563,31.26,643,675,2920
27.02.2017 18:00,3688,31.91,693,710,2995
27.02.2017 19:00,3714,32.3,714,743,3000
27.02.2017 20:00,3548,31.68,788,792,2760
27.02.2017 21:00,3323,30.62,858,827,2465
27.02.2017 22:00,3095,28.92,884,848,2211
27.02.2017 23:00,2907,27.27,871,867,2036
28.02.2017 00:00,2699,24.88,914,885,1785
28.02.2017 01:00,2611,24.17,918,899,1693
28.02.2017 02:00,2654,23.86,864,931,1790
28.02.2017 03:00,2662,23.63,880,953,1782
28.02.2017 04:00,2687,23.58,895,978,1792
28.02.2017 05:00,2706,24.8,873,959,1833
28.02.2017 06:00,2879,27.61,816,915,2063
28.02.2017 07:00,3280,29.34,745,872,2535
28.02.2017 08:00,3744,30.96,632,822,3112
28.02.2017 09:00,3778,31.23,645,763,3133
28.02.2017 10:00,3747,31.02,637,734,3110
28.02.2017 11:00,3795,30.76,644,745,3151
28.02.2017 12:00,3688,30.57,735,772,2953
28.02.2017 13:00,3598,30.62,813,795,2785
28.02.2017 14:00,3624,30.72,805,811,2819
28.02.2017 15:00,3610,30.73,810,821,2800
28.02.2017 16:00,3638,30.85,805,819,2833
28.02.2017 17:00,3595,31.12,821,807,2774
28.02.2017 18:00,3707,32.48,839,792,2868
28.02.2017 19:00,3753,32.72,856,775,2897
28.02.2017 20:00,3626,32.16,893,768,2733
28.02.2017 21:00,3377,31.14,965,740,2412
28.02.2017 22:00,3215,30.86,905,706,2310
28.02.2017 23:00,3063,30.39,815,678,2248
03.01.2017 00:00,2751,29.44,844,634,1907
03.01.2017 01:00,2753,27.6,852,732,1901
03.01.2017 02:00,2671,27.2,881,711,1790
03.01.2017 03:00,2562,26.38,932,699,1630
03.01.2017 04:00,2455,25.52,1048,692,1407
03.01.2017 05:00,2457,28.65,1108,712,1349
03.01.2017 06:00,2702,29.98,1062,743,1640
03.01.2017 07:00,3142,30.89,1077,760,2065
03.01.2017 08:00,3454,32.04,1077,737,2377
03.01.2017 09:00,3567,32.8,1038,706,2529
03.01.2017 10:00,3552,32.72,1024,688,2528
03.01.2017 11:00,3624,32.4,970,677,2654
03.01.2017 12:00,3603,32.2,970,682,2633
03.01.2017 13:00,3550,31.22,985,769,2565
03.01.2017 14:00,3464,30.74,1048,803,2416
03.01.2017 15:00,3482,30.83,1055,845,2427
03.01.2017 16:00,3492,31.5,1106,906,2386
03.01.2017 17:00,3526,32.03,1093,916,2433
03.01.2017 18:00,3656,32.48,1074,904,2582
03.01.2017 19:00,3769,34.35,1055,917,2714
03.01.2017 20:00,3712,32.4,1014,881,2698
03.01.2017 21:00,3646,32.13,897,850,2749
03.01.2017 22:00,3515,31.68,814,802,2701
03.01.2017 23:00,3191,31.16,745,720,2446
03.02.2017 00:00,3006,29.7,642,656,2364
03.02.2017 01:00,2960,29.73,523,611,2437
03.02.2017 02:00,2881,29.31,467,535,2414
03.02.2017 03:00,2822,26.51,410,471,2412
03.02.2017 04:00,2787,26.55,381,409,2406
03.02.2017 05:00,2801,28.28,369,347,2432
03.02.2017 06:00,2975,29.97,341,294,2634
03.02.2017 07:00,3417,31.04,296,258,3121
03.02.2017 08:00,3795,33.57,252,224,3543
03.02.2017 09:00,3894,34.19,197,173,3697
03.02.2017 10:00,3844,32.66,119,141,3725
03.02.2017 11:00,3860,32.41,79,108,3781
03.02.2017 12:00,3819,32.24,82,86,3737
03.02.2017 13:00,3706,32.04,92,71,3614
03.02.2017 14:00,3669,31.7,82,69,3587
03.02.2017 15:00,3645,31.18,88,81,3557
03.02.2017 16:00,3604,31.07,134,102,3470
03.02.2017 17:00,3529,31.05,167,136,3362
03.02.2017 18:00,3633,32.17,237,169,3396
03.02.2017 19:00,3813,37.06,251,215,3562
03.02.2017 20:00,3721,32.02,319,269,3402
03.02.2017 21:00,3582,31.18,399,344,3183
03.02.2017 22:00,3344,30.47,500,410,2844
03.02.2017 23:00,3091,29.25,622,506,2469
03.03.2017 00:00,2896,27.14,701,599,2195
03.03.2017 01:00,2848,27.53,759,725,2089
03.03.2017 02:00,2725,26.47,885,794,1840
03.03.2017 03:00,2673,26.03,973,860,1700
03.03.2017 04:00,2693,28.13,1016,908,1677
03.03.2017 05:00,2817,29.92,973,943,1844
03.03.2017 06:00,2969,30.79,987,941,1982
03.03.2017 07:00,3336,31.72,1041,940,2295
03.03.2017 08:00,3676,32.33,1033,931,2643
03.03.2017 09:00,3848,32.55,943,924,2905
03.03.2017 10:00,3835,32.42,946,937,2889
03.03.2017 11:00,3797,32.19,980,926,2817
03.03.2017 12:00,3792,31.96,955,914,2837
03.03.2017 13:00,3731,31.8,918,898,2813
03.03.2017 14:00,3662,31.58,833,815,2829
03.03.2017 15:00,3694,31.5,677,750,3017
03.03.2017 16:00,3612,31.46,624,663,2988
03.03.2017 17:00,3572,31.83,538,579,3034
03.03.2017 18:00,3680,38.85,450,516,3230
03.03.2017 19:00,3651,41.17,490,473,3161
03.03.2017 20:00,3468,32.83,508,423,2960
03.03.2017 21:00,3308,31.98,446,378,2862
03.03.2017 22:00,3222,31.73,358,341,2864
03.03.2017 23:00,3140,31.33,247,294,2893
03.04.2017 00:00,2957,30.87,197,228,2760
03.04.2017 01:00,2765,31.36,171,136,2594
03.04.2017 02:00,2662,30.32,146,102,2516
03.04.2017 03:00,2638,30.04,113,82,2525
03.04.2017 04:00,2665,28.61,93,75,2572
03.04.2017 05:00,2693,28.26,76,86,2617
03.04.2017 06:00,2714,29.22,125,109,2589
03.04.2017 07:00,2814,28.16,169,146,2645
03.04.2017 08:00,2940,29.86,186,184,2754
03.04.2017 09:00,3088,30.98,258,209,2830
03.04.2017 10:00,3234,31.46,285,230,2949
03.04.2017 11:00,3353,31.57,213,266,3140
03.04.2017 12:00,3370,31.15,218,321,3152
03.04.2017 13:00,3329,30.91,291,363,3038
03.04.2017 14:00,3252,30.68,392,440,2860
03.04.2017 15:00,3086,30.11,562,517,2524
03.04.2017 16:00,3008,29.93,715,604,2293
03.04.2017 17:00,3058,30.65,831,679,2227
03.04.2017 18:00,3229,31.13,903,775,2326
03.04.2017 19:00,3314,31.66,1016,872,2298
03.04.2017 20:00,3232,31.01,1082,949,2150
03.04.2017 21:00,3103,30.76,1121,1000,1982
03.04.2017 22:00,2968,30.58,1181,1039,1787
03.04.2017 23:00,2826,29.56,1223,1087,1603
03.05.2017 00:00,2712,26.13,1211,1127,1501
03.05.2017 01:00,2610,26.04,1184,1077,1426
03.05.2017 02:00,2588,25.02,1209,1135,1379
03.05.2017 03:00,2590,24.34,1232,1177,1358
03.05.2017 04:00,2589,24.29,1279,1210,1310
03.05.2017 05:00,2611,24.36,1321,1263,1290
03.05.2017 06:00,2650,24.66,1349,1306,1301
03.05.2017 07:00,2771,24.41,1346,1331,1425
03.05.2017 08:00,2822,25.47,1368,1336,1454
03.05.2017 09:00,2955,27.92,1362,1327,1593
03.05.2017 10:00,3100,29.79,1354,1306,1746
03.05.2017 11:00,3144,29.17,1368,1272,1776
03.05.2017 12:00,3186,29.15,1342,1211,1844
03.05.2017 13:00,3225,28.96,1295,1145,1930
03.05.2017 14:00,3276,28.71,1213,1073,2063
03.05.2017 15:00,3310,28.31,1059,981,2251
03.05.2017 16:00,3340,28.56,943,892,2397
03.05.2017 17:00,3378,29.46,897,822,2481
03.05.2017 18:00,3503,30.8,894,774,2609
03.05.2017 19:00,3618,32.85,900,769,2718
03.05.2017 20:00,3576,33.36,890,765,2686
03.05.2017 21:00,3421,32.45,895,748,2526
03.05.2017 22:00,3254,31.8,893,737,2361
03.05.2017 23:00,3098,31.3,856,716,2242
03.06.2017 00:00,2963,30.66,837,703,2126
03.06.2017 01:00,2950,30.4,859,802,2091
03.06.2017 02:00,2892,29.04,869,803,2023
03.06.2017 03:00,2882,27.99,871,815,2011
03.06.2017 04:00,2911,26.58,873,836,2038
03.06.2017 05:00,2978,28.5,883,854,2095
03.06.2017 06:00,3151,30.57,934,885,2217
03.06.2017 07:00,3596,33.37,975,910,2621
03.06.2017 08:00,3951,35.87,990,930,2961
03.06.2017 09:00,4078,39.44,1005,934,3073
03.06.2017 10:00,4058,38.04,1047,956,3011
03.06.2017 11:00,4078,35.43,1089,978,2989
03.06.2017 12:00,4105,34.13,1095,993,3010
03.06.2017 13:00,4060,33.84,1129,1020,2931
03.06.2017 14:00,4062,33.39,1164,1052,2898
03.06.2017 15:00,4035,33.27,1167,1070,2868
03.06.2017 16:00,4062,32.92,1140,1087,2922
03.06.2017 17:00,4037,32.81,1138,1116,2899
03.06.2017 18:00,4165,37.27,1150,1132,3015
03.06.2017 19:00,4265,38.88,1124,1137,3141
03.06.2017 20:00,4126,34.95,1131,1130,2995
03.06.2017 21:00,3999,32.76,1088,1115,2911
03.06.2017 22:00,3816,32.38,1057,1082,2759
03.06.2017 23:00,3657,31.79,962,1036,2695
03.07.2017 00:00,3398,31.16,917,978,2481
03.07.2017 01:00,3312,31.07,854,938,2458
03.07.2017 02:00,3262,30.01,751,882,2511
03.07.2017 03:00,3270,29.99,692,833,2578
03.07.2017 04:00,3203,29.64,670,785,2533
03.07.2017 05:00,3262,31.07,577,727,2685
03.07.2017 06:00,3472,32.52,537,690,2935
03.07.2017 07:00,3911,36,480,656,3431
03.07.2017 08:00,4224,48.58,477,622,3747
03.07.2017 09:00,4360,52.66,450,588,3910
03.07.2017 10:00,4362,52.37,427,575,3935
03.07.2017 11:00,4329,52.21,440,519,3889
03.07.2017 12:00,4249,49.97,419,492,3830
03.07.2017 13:00,4279,47.35,373,454,3906
03.07.2017 14:00,4210,47.32,314,414,3896
03.07.2017 15:00,4171,46.13,272,394,3899
03.07.2017 16:00,4133,43.19,273,383,3860
03.07.2017 17:00,4100,42.09,255,376,3845
03.07.2017 18:00,4115,49.1,261,351,3854
03.07.2017 19:00,4245,56.14,247,310,3998
03.07.2017 20:00,4196,47.75,235,285,3961
03.07.2017 21:00,4091,40.87,205,267,3886
03.07.2017 22:00,3911,37.08,192,248,3719
03.07.2017 23:00,3682,34.97,218,232,3464
03.08.2017 00:00,3459,32.84,224,237,3235
03.08.2017 01:00,3294,32.51,222,222,3072
03.08.2017 02:00,3218,31.98,229,225,2989
03.08.2017 03:00,3183,31.55,228,226,2955
03.08.2017 04:00,3155,31.38,248,231,2907
03.08.2017 05:00,3143,31.2,279,211,2864
03.08.2017 06:00,3346,32.06,238,202,3108
03.08.2017 07:00,3789,35,217,198,3572
03.08.2017 08:00,4113,41.57,218,194,3895
03.08.2017 09:00,4169,44.53,223,206,3946
03.08.2017 10:00,4129,40.33,232,225,3897
03.08.2017 11:00,4064,36.15,308,243,3756
03.08.2017 12:00,4025,34.18,323,270,3702
03.08.2017 13:00,3911,33.34,381,302,3530
03.08.2017 14:00,3903,32.84,367,339,3536
03.08.2017 15:00,3785,32.8,449,365,3336
03.08.2017 16:00,3816,32.62,454,387,3362
03.08.2017 17:00,3845,32.54,455,437,3390
03.08.2017 18:00,3993,32.94,535,519,3458
03.08.2017 19:00,4113,33.72,543,604,3570
03.08.2017 20:00,3962,33.24,659,653,3303
03.08.2017 21:00,3849,32.67,693,715,3156
03.08.2017 22:00,3639,31.85,661,710,2978
03.08.2017 23:00,3452,31.37,595,706,2857
03.09.2017 00:00,3212,28.97,554,652,2658
03.09.2017 01:00,3051,29.92,506,575,2545
03.09.2017 02:00,2949,29.82,489,517,2460
03.09.2017 03:00,2866,29.06,469,463,2397
03.09.2017 04:00,2874,29.3,417,405,2457
03.09.2017 05:00,2906,29.28,369,373,2537
03.09.2017 06:00,3083,31.12,356,355,2727
03.09.2017 07:00,3539,32.98,364,352,3175
03.09.2017 08:00,3798,34.21,392,338,3406
03.09.2017 09:00,3881,35.96,369,312,3512
03.09.2017 10:00,3919,34.58,294,304,3625
03.09.2017 11:00,3997,34.22,262,301,3735
03.09.2017 12:00,3993,33.56,262,308,3731
03.09.2017 13:00,3902,33.19,240,284,3662
03.09.2017 14:00,3856,32.91,239,279,3617
03.09.2017 15:00,3856,32.69,212,270,3644
03.09.2017 16:00,3866,32.69,198,264,3668
03.09.2017 17:00,3844,32.76,154,263,3690
03.09.2017 18:00,3934,33.3,133,259,3801
03.09.2017 19:00,3985,43.75,133,226,3852
03.09.2017 20:00,3910,32.86,136,211,3774
03.09.2017 21:00,3740,32.32,124,224,3616
03.09.2017 22:00,3521,32.27,130,226,3391
03.09.2017 23:00,3294,31.11,119,246,3175
03.10.2017 00:00,3070,29.24,112,251,2958
03.10.2017 01:00,2794,28.63,162,159,2632
03.10.2017 02:00,2697,28.04,220,198,2477
03.10.2017 03:00,2649,27.44,286,233,2363
03.10.2017 04:00,2681,27.65,321,276,2360
03.10.2017 05:00,2711,29.62,348,301,2363
03.10.2017 06:00,2913,30.42,343,320,2570
03.10.2017 07:00,3302,31.9,379,341,2923
03.10.2017 08:00,3636,33.47,423,355,3213
03.10.2017 09:00,3703,33.93,449,361,3254
03.10.2017 10:00,3634,32.56,500,414,3134
03.10.2017 11:00,3631,32.43,506,448,3125
03.10.2017 12:00,3542,32.09,554,466,2988
03.10.2017 13:00,3437,31.51,610,509,2827
03.10.2017 14:00,3348,31.31,656,532,2692
03.10.2017 15:00,3255,31.26,654,557,2601
03.10.2017 16:00,3260,31.59,581,543,2679
03.10.2017 17:00,3291,32.09,520,527,2771
03.10.2017 18:00,3541,33.16,396,481,3145
03.10.2017 19:00,3697,36.63,315,427,3382
03.10.2017 20:00,3644,33.33,281,373,3363
03.10.2017 21:00,3498,32.46,244,312,3254
03.10.2017 22:00,3316,32.34,216,241,3100
03.10.2017 23:00,3116,32.21,202,202,2914
03.11.2017 00:00,2957,31.92,196,178,2761
03.11.2017 01:00,2825,31.16,187,146,2638
03.11.2017 02:00,2797,30.49,132,134,2665
03.11.2017 03:00,2783,30.13,98,120,2685
03.11.2017 04:00,2755,29.64,118,112,2637
03.11.2017 05:00,2757,29.07,110,110,2647
03.11.2017 06:00,2825,30,112,111,2713
03.11.2017 07:00,2938,31.01,106,108,2832
03.11.2017 08:00,3074,31.26,90,92,2984
03.11.2017 09:00,3223,31.69,58,72,3165
03.11.2017 10:00,3251,32.36,21,52,3230
03.11.2017 11:00,3131,32.21,26,36,3105
03.11.2017 12:00,3008,31.41,34,33,2974
03.11.2017 13:00,2949,31.07,22,32,2927
03.11.2017 14:00,2860,30.19,18,32,2842
03.11.2017 15:00,2752,29.85,39,30,2713
03.11.2017 16:00,2719,29.98,49,28,2670
03.11.2017 17:00,2763,30.81,53,26,2710
03.11.2017 18:00,3023,32.68,41,30,2982
03.11.2017 19:00,3306,33.68,40,37,3266
03.11.2017 20:00,3314,33.01,50,45,3264
03.11.2017 21:00,3167,31.52,70,57,3097
03.11.2017 22:00,3052,31.23,71,74,2981
03.11.2017 23:00,2949,31.08,68,78,2881
03.12.2017 00:00,2828,30.05,96,83,2732
03.12.2017 01:00,2749,28.75,110,83,2639
03.12.2017 02:00,2736,28.21,100,80,2636
03.12.2017 03:00,2762,26.69,73,79,2689
03.12.2017 04:00,2779,26.9,68,82,2711
03.12.2017 05:00,2811,26.13,69,80,2742
03.12.2017 06:00,2875,28.51,60,86,2815
03.12.2017 07:00,2918,28.29,61,95,2857
03.12.2017 08:00,2989,28.75,75,100,2914
03.12.2017 09:00,3075,29.3,88,95,2987
03.12.2017 10:00,3144,29.59,86,92,3058
03.12.2017 11:00,3157,29.7,76,91,3081
03.12.2017 12:00,3142,29.43,91,98,3051
03.12.2017 13:00,3103,29.4,99,100,3004
03.12.2017 14:00,3054,28.98,83,99,2971
03.12.2017 15:00,3044,28.92,85,109,2959
03.12.2017 16:00,3020,28.9,71,103,2949
03.12.2017 17:00,3102,29.19,57,101,3045
03.12.2017 18:00,3225,29.7,78,110,3147
03.12.2017 19:00,3470,31.15,116,129,3354
03.12.2017 20:00,3484,31.35,156,149,3328
03.12.2017 21:00,3378,30.69,165,161,3213
03.12.2017 22:00,3242,30.62,149,169,3093
03.12.2017 23:00,3090,30.4,153,160,2937
13.03.2017 00:00,2946,29.34,152,146,2794
13.03.2017 01:00,2858,27.04,148,127,2710
13.03.2017 02:00,2826,26.82,136,120,2690
13.03.2017 03:00,2828,26.9,127,119,2701
13.03.2017 04:00,2853,27.69,134,118,2719
13.03.2017 05:00,2919,29.27,142,124,2777
13.03.2017 06:00,3087,30.79,147,128,2940
13.03.2017 07:00,3524,32.68,149,133,3375
13.03.2017 08:00,3889,40.02,141,135,3748
13.03.2017 09:00,3976,42.53,106,137,3870
13.03.2017 10:00,3928,40,71,143,3857
13.03.2017 11:00,3929,34.57,84,158,3845
13.03.2017 12:00,3842,32.89,139,182,3703
13.03.2017 13:00,3646,31.97,224,207,3422
13.03.2017 14:00,3588,32.2,278,229,3310
13.03.2017 15:00,3544,31.7,299,233,3245
13.03.2017 16:00,3565,31.78,293,242,3272
13.03.2017 17:00,3581,35.74,238,251,3343
13.03.2017 18:00,3689,40.82,224,260,3465
13.03.2017 19:00,3767,48.7,262,276,3505
13.03.2017 20:00,3708,48.2,308,300,3400
13.03.2017 21:00,3543,38.42,347,316,3196
13.03.2017 22:00,3350,31.3,360,322,2990
13.03.2017 23:00,3191,30.74,362,321,2829
14.03.2017 00:00,2997,30.18,333,317,2664
14.03.2017 01:00,2869,28.87,296,300,2573
14.03.2017 02:00,2824,27.93,299,287,2525
14.03.2017 03:00,2790,27.07,297,277,2493
14.03.2017 04:00,2838,27.08,253,269,2585
14.03.2017 05:00,2814,28.43,295,270,2519
14.03.2017 06:00,2955,29.57,313,270,2642
14.03.2017 07:00,3394,31.49,303,275,3091
14.03.2017 08:00,3745,40.05,287,269,3458
14.03.2017 09:00,3794,40.24,299,263,3495
14.03.2017 10:00,3739,40.26,349,270,3390
14.03.2017 11:00,3717,40.08,428,311,3289
14.03.2017 12:00,3672,31.2,527,384,3145
14.03.2017 13:00,3561,30.34,597,468,2964
14.03.2017 14:00,3555,29.84,648,566,2907
14.03.2017 15:00,3551,29.51,733,697,2818
14.03.2017 16:00,3548,29.43,840,778,2708
14.03.2017 17:00,3444,29.7,1026,882,2418
14.03.2017 18:00,3516,29.98,1145,990,2371
14.03.2017 19:00,3512,30.87,1271,1052,2241
14.03.2017 20:00,3482,30.31,1311,1147,2171
14.03.2017 21:00,3341,28.23,1328,1178,2013
14.03.2017 22:00,3196,25.5,1272,1181,1924
14.03.2017 23:00,3018,23.15,1245,1181,1773
15.03.2017 00:00,2831,17.31,1238,1181,1593
15.03.2017 01:00,2674,4.09,1236,1198,1438
15.03.2017 02:00,2648,4.07,1235,1222,1413
15.03.2017 03:00,2668,4.05,1210,1245,1458
15.03.2017 04:00,2663,4.06,1247,1260,1416
15.03.2017 05:00,2772,4.56,1226,1289,1546
15.03.2017 06:00,2964,23.59,1230,1296,1734
15.03.2017 07:00,3294,29.64,1300,1307,1994
15.03.2017 08:00,3601,30.85,1320,1303,2281
15.03.2017 09:00,3690,31.06,1336,1304,2354
15.03.2017 10:00,3628,30.63,1338,1319,2290
15.03.2017 11:00,3638,30.31,1327,1329,2311
15.03.2017 12:00,3570,29.87,1374,1343,2196
15.03.2017 13:00,3453,29.01,1381,1336,2072
15.03.2017 14:00,3392,28.36,1397,1336,1995
15.03.2017 15:00,3332,28.12,1401,1333,1931
15.03.2017 16:00,3332,27.89,1394,1322,1938
15.03.2017 17:00,3295,29.08,1371,1313,1924
15.03.2017 18:00,3431,30.45,1368,1312,2063
15.03.2017 19:00,3529,31.06,1396,1311,2133
15.03.2017 20:00,3565,30.95,1396,1310,2169
15.03.2017 21:00,3418,30.44,1381,1300,2037
15.03.2017 22:00,3261,30.01,1348,1290,1913
15.03.2017 23:00,3026,28.05,1318,1265,1708
16.03.2017 00:00,2826,23.6,1295,1241,1531
16.03.2017 01:00,2738,21.08,1239,1212,1499
16.03.2017 02:00,2696,21.03,1187,1161,1509
16.03.2017 03:00,2683,21.71,1118,1090,1565
16.03.2017 04:00,2683,23.1,1050,1001,1633
16.03.2017 05:00,2804,27.44,849,889,1955
16.03.2017 06:00,3040,29.7,656,753,2384
16.03.2017 07:00,3419,30.76,486,620,2933
16.03.2017 08:00,3762,32.52,340,475,3422
16.03.2017 09:00,3808,35.67,206,337,3602
16.03.2017 10:00,3733,35.28,132,249,3601
16.03.2017 11:00,3690,32.94,92,163,3598
16.03.2017 12:00,3632,31.87,63,131,3569
16.03.2017 13:00,3564,30.87,73,140,3491
16.03.2017 14:00,3517,30.45,128,179,3389
16.03.2017 15:00,3438,30.19,209,239,3229
16.03.2017 16:00,3393,30.28,302,313,3091
16.03.2017 17:00,3363,32.69,405,412,2958
16.03.2017 18:00,3433,38.95,560,518,2873
16.03.2017 19:00,3482,44.5,713,647,2769
16.03.2017 20:00,3472,37.27,832,771,2640
16.03.2017 21:00,3268,29.89,1011,886,2257
16.03.2017 22:00,3029,28.58,1109,958,1920
16.03.2017 23:00,2806,25.81,1184,1044,1622
17.03.2017 00:00,2562,22.97,1275,1100,1287
17.03.2017 01:00,2493,17.18,1279,1179,1214
17.03.2017 02:00,2459,17.02,1295,1184,1164
17.03.2017 03:00,2391,17.06,1324,1169,1067
17.03.2017 04:00,2399,18.71,1298,1140,1101
17.03.2017 05:00,2552,21.64,1152,1103,1400
17.03.2017 06:00,2873,25.99,996,1066,1877
17.03.2017 07:00,3262,29.17,949,1029,2313
17.03.2017 08:00,3549,30.63,961,986,2588
17.03.2017 09:00,3582,30.64,998,951,2584
17.03.2017 10:00,3423,30.2,1110,959,2313
17.03.2017 11:00,3328,29.88,1193,999,2135
17.03.2017 12:00,3314,29.33,1213,1045,2101
17.03.2017 13:00,3285,28.21,1249,1105,2036
17.03.2017 14:00,3316,27.31,1206,1138,2110
17.03.2017 15:00,3313,27.04,1175,1143,2138
17.03.2017 16:00,3271,26.85,1153,1127,2118
17.03.2017 17:00,3279,27.13,1086,1101,2193
17.03.2017 18:00,3453,29.6,940,1068,2513
17.03.2017 19:00,3572,30.1,893,1007,2679
17.03.2017 20:00,3577,29.97,900,974,2677
17.03.2017 21:00,3386,29.39,876,922,2510
17.03.2017 22:00,3174,27.91,852,867,2322
17.03.2017 23:00,2929,24.5,816,790,2113
18.03.2017 00:00,2804,20.44,694,725,2110
18.03.2017 01:00,2742,22.07,535,627,2207
18.03.2017 02:00,2676,22.05,453,538,2223
18.03.2017 03:00,2656,21.03,354,445,2302
18.03.2017 04:00,2622,20.94,267,375,2355
18.03.2017 05:00,2587,22.62,246,302,2341
18.03.2017 06:00,2523,22.05,298,243,2225
18.03.2017 07:00,2571,23.11,315,218,2256
18.03.2017 08:00,2710,26.32,304,220,2406
18.03.2017 09:00,3025,28.53,172,206,2853
18.03.2017 10:00,3309,28.91,68,226,3241
18.03.2017 11:00,3430,28.32,54,263,3376
18.03.2017 12:00,3366,27.67,181,309,3185
18.03.2017 13:00,3275,27.12,367,428,2908
18.03.2017 14:00,3134,26.56,533,514,2601
18.03.2017 15:00,3045,26.19,639,602,2406
18.03.2017 16:00,2938,25.57,720,642,2218
18.03.2017 17:00,2923,26.59,738,657,2185
18.03.2017 18:00,3045,29,678,651,2367
18.03.2017 19:00,3208,30.75,663,643,2545
18.03.2017 20:00,3230,31.04,689,618,2541
18.03.2017 21:00,2930,30.52,796,581,2134
18.03.2017 22:00,2811,30.15,762,536,2049
18.03.2017 23:00,2711,30,701,493,2010
19.03.2017 00:00,2583,29.06,645,438,1938
19.03.2017 01:00,2652,25.93,592,552,2060
19.03.2017 02:00,2676,25.04,494,484,2182
19.03.2017 03:00,2628,25.15,434,417,2194
19.03.2017 04:00,2636,26.82,382,342,2254
19.03.2017 05:00,2677,27.97,310,271,2367
19.03.2017 06:00,2753,29.08,228,209,2525
19.03.2017 07:00,2804,28.17,153,161,2651
19.03.2017 08:00,2985,28.42,102,113,2883
19.03.2017 09:00,3236,28.74,56,82,3180
19.03.2017 10:00,3701,29.25,51,78,3650
19.03.2017 11:00,4009,29.46,51,74,3958
19.03.2017 12:00,3964,29.53,85,111,3879
19.03.2017 13:00,3192,28.93,117,176,3075
19.03.2017 14:00,3103,27.99,162,241,2941
19.03.2017 15:00,3090,27.72,230,311,2860
19.03.2017 16:00,3130,27.67,289,394,2841
19.03.2017 17:00,3239,28.1,361,475,2878
19.03.2017 18:00,3464,29.08,363,569,3101
19.03.2017 19:00,3671,30.12,387,645,3284
19.03.2017 20:00,3650,30.02,445,673,3205
19.03.2017 21:00,3451,28.59,487,650,2964
19.03.2017 22:00,3261,28.49,502,618,2759
19.03.2017 23:00,3085,26.73,447,563,2638
20.03.2017 00:00,3040,23.01,303,523,2737
20.03.2017 01:00,2820,23.05,246,385,2574
20.03.2017 02:00,2743,22.35,208,322,2535
20.03.2017 03:00,2733,22.05,154,265,2579
20.03.2017 04:00,2771,23.03,124,261,2647
20.03.2017 05:00,2842,25.03,107,248,2735
20.03.2017 06:00,2969,29.65,151,259,2818
20.03.2017 07:00,3331,31.41,206,262,3125
20.03.2017 08:00,3659,37.6,228,237,3431
20.03.2017 09:00,3706,40.97,242,203,3464
20.03.2017 10:00,3717,38.4,200,187,3517
20.03.2017 11:00,3706,36.07,186,178,3520
20.03.2017 12:00,3695,32.93,182,181,3513
20.03.2017 13:00,3590,32.29,164,192,3426
20.03.2017 14:00,3561,31.96,163,219,3398
20.03.2017 15:00,3480,31.16,160,215,3320
20.03.2017 16:00,3513,30.82,140,233,3373
20.03.2017 17:00,3506,30.56,148,269,3358
20.03.2017 18:00,3686,31.16,180,364,3506
20.03.2017 19:00,3768,31.72,313,479,3455
20.03.2017 20:00,3605,31.04,533,579,3072
20.03.2017 21:00,3398,30.56,671,676,2727
20.03.2017 22:00,3121,28.3,805,747,2316
20.03.2017 23:00,2764,25.65,994,815,1770
21.03.2017 00:00,2532,22.21,1098,885,1434
21.03.2017 01:00,2291,18.76,1209,887,1082
21.03.2017 02:00,2218,17.48,1230,891,988
21.03.2017 03:00,2254,15.92,1146,869,1108
21.03.2017 04:00,2299,18.02,1097,835,1202
21.03.2017 05:00,2369,22.06,1053,788,1316
21.03.2017 06:00,2542,23.99,981,735,1561
21.03.2017 07:00,2863,29.93,956,711,1907
21.03.2017 08:00,3138,31.17,972,694,2166
21.03.2017 09:00,3193,31.56,1000,720,2193
21.03.2017 10:00,3136,30.84,1031,752,2105
21.03.2017 11:00,3154,29.97,1046,800,2108
21.03.2017 12:00,3161,29.69,1091,840,2070
21.03.2017 13:00,3107,29.08,1099,852,2008
21.03.2017 14:00,3144,28.86,1090,899,2054
21.03.2017 15:00,3131,28.94,1137,947,1994
21.03.2017 16:00,3150,29.37,1185,1011,1965
21.03.2017 17:00,3125,29.63,1247,1062,1878
21.03.2017 18:00,3272,30.35,1238,1091,2034
21.03.2017 19:00,3486,30.78,1138,1109,2348
21.03.2017 20:00,3609,30.67,1085,1120,2524
21.03.2017 21:00,3400,29.02,1179,1133,2221
21.03.2017 22:00,3164,28.14,1235,1140,1929
21.03.2017 23:00,2973,26.93,1234,1140,1739
22.03.2017 00:00,2812,22.76,1222,1141,1590
22.03.2017 01:00,2762,18.1,1183,1187,1579
22.03.2017 02:00,2712,18.01,1177,1179,1535
22.03.2017 03:00,2674,18.06,1193,1172,1481
22.03.2017 04:00,2674,20.79,1196,1153,1478
22.03.2017 05:00,2736,26.99,1167,1129,1569
22.03.2017 06:00,2862,29.23,1179,1093,1683
22.03.2017 07:00,3205,30.46,1143,1060,2062
22.03.2017 08:00,3597,31.51,1039,1017,2558
22.03.2017 09:00,3643,32.22,990,988,2653
22.03.2017 10:00,3540,31.63,1002,980,2538
22.03.2017 11:00,3478,31.38,1005,951,2473
22.03.2017 12:00,3431,31.16,965,926,2466
22.03.2017 13:00,3360,31.09,919,895,2441
22.03.2017 14:00,3288,30.84,912,849,2376
22.03.2017 15:00,3225,30.6,885,788,2340
22.03.2017 16:00,3191,30.44,849,730,2342
22.03.2017 17:00,3132,30.9,757,643,2375
22.03.2017 18:00,3245,31.26,655,562,2590
22.03.2017 19:00,3460,32.25,611,526,2849
22.03.2017 20:00,3406,31.97,572,485,2834
22.03.2017 21:00,3219,31.25,618,460,2601
22.03.2017 22:00,3020,30.11,619,433,2401
22.03.2017 23:00,2817,29.18,589,380,2228
23.03.2017 00:00,2686,28.47,503,347,2183
23.03.2017 01:00,2636,27.34,402,305,2234
23.03.2017 02:00,2662,26.23,295,250,2367
23.03.2017 03:00,2705,26.58,225,197,2480
23.03.2017 04:00,2743,27.82,202,167,2541
23.03.2017 05:00,2769,28.53,199,136,2570
23.03.2017 06:00,2967,29.99,165,114,2802
23.03.2017 07:00,3341,31.34,146,99,3195
23.03.2017 08:00,3693,38.12,119,89,3574
23.03.2017 09:00,3646,39.53,61,62,3585
23.03.2017 10:00,3500,35.73,48,52,3452
23.03.2017 11:00,3418,33.12,60,50,3358
23.03.2017 12:00,3348,31.73,78,56,3270
23.03.2017 13:00,3242,30.97,98,64,3144
23.03.2017 14:00,3217,30.99,124,70,3093
23.03.2017 15:00,3162,30.79,135,77,3027
23.03.2017 16:00,3158,30.83,117,80,3041
23.03.2017 17:00,3110,30.9,115,80,2995
23.03.2017 18:00,3190,31.75,93,93,3097
23.03.2017 19:00,3316,33.99,107,106,3209
23.03.2017 20:00,3408,32.8,148,121,3260
23.03.2017 21:00,3362,31.52,144,130,3218
23.03.2017 22:00,3275,31.12,108,140,3167
23.03.2017 23:00,3113,30.62,106,143,3007
24.03.2017 00:00,2931,29.59,120,148,2811
24.03.2017 01:00,2782,29.04,130,131,2652
24.03.2017 02:00,2714,28.99,165,130,2549
24.03.2017 03:00,2704,29.21,190,125,2514
24.03.2017 04:00,2702,28.87,217,118,2485
24.03.2017 05:00,2759,29,231,110,2528
24.03.2017 06:00,2993,30.14,170,103,2823
24.03.2017 07:00,3397,33.08,139,101,3258
24.03.2017 08:00,3610,41.13,150,87,3460
24.03.2017 09:00,3651,43.79,80,81,3571
24.03.2017 10:00,3535,41.09,56,65,3479
24.03.2017 11:00,3465,35.71,109,84,3356
24.03.2017 12:00,3350,33.01,166,105,3184
24.03.2017 13:00,3232,31.31,195,136,3037
24.03.2017 14:00,3127,30.29,235,176,2892
24.03.2017 15:00,2976,29.9,307,224,2669
24.03.2017 16:00,2897,30.07,360,271,2537
24.03.2017 17:00,2974,30.31,345,315,2629
24.03.2017 18:00,3164,30.84,325,355,2839
24.03.2017 19:00,3237,31.38,447,398,2790
24.03.2017 20:00,3183,30.66,573,456,2610
24.03.2017 21:00,3062,30.05,608,502,2454
24.03.2017 22:00,2880,29.83,642,552,2238
24.03.2017 23:00,2743,29.5,669,579,2074
25.03.2017 00:00,2676,28.89,653,619,2023
25.03.2017 01:00,2598,27.85,664,680,1934
25.03.2017 02:00,2552,27.13,701,723,1851
25.03.2017 03:00,2463,26.17,771,750,1692
25.03.2017 04:00,2441,26.18,801,767,1640
25.03.2017 05:00,2436,26.37,811,766,1625
25.03.2017 06:00,2445,26.9,810,758,1635
25.03.2017 07:00,2572,27.87,719,736,1853
25.03.2017 08:00,2757,28.86,634,685,2123
25.03.2017 09:00,2889,29.18,572,626,2317
25.03.2017 10:00,2866,28.9,594,572,2272
25.03.2017 11:00,2858,28.28,525,522,2333
25.03.2017 12:00,2827,26.38,425,462,2402
25.03.2017 13:00,2762,26.25,413,449,2349
25.03.2017 14:00,2589,25.83,476,407,2113
25.03.2017 15:00,2549,26.03,444,393,2105
25.03.2017 16:00,2597,26.6,372,360,2225
25.03.2017 17:00,2629,27.68,361,328,2268
25.03.2017 18:00,2790,28.65,286,298,2504
25.03.2017 19:00,3010,30.19,238,270,2772
25.03.2017 20:00,3017,30.67,285,252,2732
25.03.2017 21:00,2905,29.96,290,231,2615
25.03.2017 22:00,2796,29.65,278,211,2518
25.03.2017 23:00,2710,29.33,245,180,2465
26.03.2017 00:00,2566,28.34,215,145,2351
26.03.2017 01:00,2496,28.74,146,89,2350
26.03.2017 02:00,2515,27.94,68,60,2447
26.03.2017 03:00,2761.949947,36.96376226,446.1037531,443.144979,2315.846194
26.03.2017 04:00,2542,26.97,35,50,2507
26.03.2017 05:00,2582,26.62,15,35,2567
26.03.2017 06:00,2667,24.65,17,34,2650
26.03.2017 07:00,2671,26.87,52,54,2619
26.03.2017 08:00,2643,27.64,153,84,2490
26.03.2017 09:00,2661,28.24,234,125,2427
26.03.2017 10:00,2716,28.58,216,129,2500
26.03.2017 11:00,2793,28.44,146,129,2647
26.03.2017 12:00,2788,27.89,158,157,2630
26.03.2017 13:00,2717,27.31,219,207,2498
26.03.2017 14:00,2594,24.29,299,255,2295
26.03.2017 15:00,2497,23.46,376,304,2121
26.03.2017 16:00,2406,23.2,440,333,1966
26.03.2017 17:00,2392,23.36,502,359,1890
26.03.2017 18:00,2478,24.01,506,379,1972
26.03.2017 19:00,2622,28.53,518,410,2104
26.03.2017 20:00,2784,29.48,552,435,2232
26.03.2017 21:00,2860,29.66,594,445,2266
26.03.2017 22:00,2661,28.57,650,440,2011
26.03.2017 23:00,2433,27.99,701,433,1732
27.03.2017 00:00,2254,25.97,701,411,1553
27.03.2017 01:00,2211,25.47,633,404,1578
27.03.2017 02:00,2200,24.06,560,348,1640
27.03.2017 03:00,2248,24.1,447,302,1801
27.03.2017 04:00,2325,25.16,338,262,1987
27.03.2017 05:00,2401,26.71,249,213,2152
27.03.2017 06:00,2611,29.38,178,174,2433
27.03.2017 07:00,3077,30.69,121,156,2956
27.03.2017 08:00,3413,34.28,98,144,3315
27.03.2017 09:00,3563,36.54,67,131,3496
27.03.2017 10:00,3552,35.65,71,135,3481
27.03.2017 11:00,3565,34.09,81,152,3484
27.03.2017 12:00,3529,32.44,123,187,3406
27.03.2017 13:00,3373,30.44,241,250,3132
27.03.2017 14:00,3276,29.67,388,339,2888
27.03.2017 15:00,3196,29.11,496,414,2700
27.03.2017 16:00,3150,28.92,569,472,2581
27.03.2017 17:00,3168,29.18,549,521,2619
27.03.2017 18:00,3227,29.69,537,562,2690
27.03.2017 19:00,3182,29.91,546,574,2636
27.03.2017 20:00,3209,30.09,570,584,2639
27.03.2017 21:00,3256,29.89,596,573,2660
27.03.2017 22:00,3097,29.8,567,542,2530
27.03.2017 23:00,2885,29.51,508,482,2377
28.03.2017 00:00,2612,28.5,496,411,2116
28.03.2017 01:00,2451,24.17,434,341,2017
28.03.2017 02:00,2419,24.28,367,289,2052
28.03.2017 03:00,2427,24.65,299,244,2128
28.03.2017 04:00,2425,26.03,252,196,2173
28.03.2017 05:00,2475,27.72,192,163,2283
28.03.2017 06:00,2653,29.06,135,122,2518
28.03.2017 07:00,3109,31.93,113,107,2996
28.03.2017 08:00,3410,40.85,112,102,3298
28.03.2017 09:00,3512,48.61,76,95,3436
28.03.2017 10:00,3504,42,39,77,3465
28.03.2017 11:00,3496,38.98,33,80,3463
28.03.2017 12:00,3450,36.5,21,64,3429
28.03.2017 13:00,3408,32.29,19,74,3389
28.03.2017 14:00,3344,30.71,25,77,3319
28.03.2017 15:00,3307,29.98,36,78,3271
28.03.2017 16:00,3250,30,42,86,3208
28.03.2017 17:00,3174,30.05,49,83,3125
28.03.2017 18:00,3217,31.39,57,82,3160
28.03.2017 19:00,3214,36.55,69,92,3145
28.03.2017 20:00,3253,40.41,83,107,3170
28.03.2017 21:00,3330,36.98,99,117,3231
28.03.2017 22:00,3146,32.65,120,123,3026
28.03.2017 23:00,2949,30.46,94,117,2855
29.03.2017 00:00,2726,28.9,88,121,2638
29.03.2017 01:00,2546,28.06,90,109,2456
29.03.2017 02:00,2500,27.37,95,121,2405
29.03.2017 03:00,2511,27.12,75,124,2436
29.03.2017 04:00,2568,26.89,56,134,2512
29.03.2017 05:00,2605,27.2,84,151,2521
29.03.2017 06:00,2780,29.2,106,159,2674
29.03.2017 07:00,3201,34.16,88,166,3113
29.03.2017 08:00,3483,39.56,135,165,3348
29.03.2017 09:00,3545,40.76,201,165,3344
29.03.2017 10:00,3576,41.01,187,184,3389
29.03.2017 11:00,3649,38.88,222,215,3427
29.03.2017 12:00,3610,37.83,281,254,3329
29.03.2017 13:00,3507,37.96,328,288,3179
29.03.2017 14:00,3508,37.94,342,331,3166
29.03.2017 15:00,3459,35.85,348,354,3111
29.03.2017 16:00,3419,33.41,370,360,3049
29.03.2017 17:00,3377,32.52,342,357,3035
29.03.2017 18:00,3437,33.01,273,335,3164
29.03.2017 19:00,3438,34.64,221,299,3217
29.03.2017 20:00,3470,39.5,164,252,3306
29.03.2017 21:00,3468,40.63,130,209,3338
29.03.2017 22:00,3250,37.62,94,169,3156
29.03.2017 23:00,3032,34.32,59,133,2973
30.03.2017 00:00,2791,29.99,36,109,2755
30.03.2017 01:00,2699,28.7,32,85,2667
30.03.2017 02:00,2590,28.02,25,70,2565
30.03.2017 03:00,2546,27.3,24,58,2522
30.03.2017 04:00,2556,27.25,23,57,2533
30.03.2017 05:00,2613,27.69,21,56,2592
30.03.2017 06:00,2810,28.81,29,60,2781
30.03.2017 07:00,3175,35.71,41,71,3134
30.03.2017 08:00,3478,43.06,68,86,3410
30.03.2017 09:00,3580,47.14,83,101,3497
30.03.2017 10:00,3593,43.91,97,128,3496
30.03.2017 11:00,3644,40.07,144,167,3500
30.03.2017 12:00,3618,38.42,215,226,3403
30.03.2017 13:00,3544,33.82,301,300,3243
30.03.2017 14:00,3464,31.3,434,365,3030
30.03.2017 15:00,3404,30.3,566,437,2838
30.03.2017 16:00,3460,29.65,584,505,2876
30.03.2017 17:00,3452,29.55,568,550,2884
30.03.2017 18:00,3433,31.18,606,579,2827
30.03.2017 19:00,3269,35.07,729,618,2540
30.03.2017 20:00,3156,39.49,846,642,2310
30.03.2017 21:00,3216,31.88,800,690,2416
30.03.2017 22:00,3115,29.87,753,741,2362
30.03.2017 23:00,2867,28.76,741,755,2126
31.03.2017 00:00,2600,28.01,774,760,1826
31.03.2017 01:00,2503,26.91,686,750,1817
31.03.2017 02:00,2450,24.77,636,709,1814
31.03.2017 03:00,2419,24.45,610,658,1809
31.03.2017 04:00,2450,24.55,509,589,1941
31.03.2017 05:00,2507,25.73,413,534,2094
31.03.2017 06:00,2659,28.03,354,472,2305
31.03.2017 07:00,3022,32.3,299,401,2723
31.03.2017 08:00,3308,37.04,243,338,3065
31.03.2017 09:00,3404,38.99,184,260,3220
31.03.2017 10:00,3365,37.97,131,211,3234
31.03.2017 11:00,3340,35.93,120,171,3220
31.03.2017 12:00,3262,33.32,86,141,3176
31.03.2017 13:00,3117,30.75,81,118,3036
31.03.2017 14:00,2984,29.94,91,115,2893
31.03.2017 15:00,2870,29.26,96,106,2774
31.03.2017 16:00,2791,28.99,90,105,2701
31.03.2017 17:00,2712,28.86,87,121,2625
31.03.2017 18:00,2723,30.43,106,145,2617
31.03.2017 19:00,2739,33.84,162,197,2577
31.03.2017 20:00,2778,33.9,257,265,2521
31.03.2017 21:00,2756,29.87,359,323,2397
31.03.2017 22:00,2609,29.38,412,357,2197
31.03.2017 23:00,2467,28.66,420,384,2047
04.01.2017 00:00,2346,28.34,401,374,1945
04.01.2017 01:00,2186,26.43,411,349,1775
04.01.2017 02:00,2111,27.31,402,322,1709
04.01.2017 03:00,2063,26.62,377,291,1686
04.01.2017 04:00,2078,25.57,334,257,1744
04.01.2017 05:00,2179,26.35,218,231,1961
04.01.2017 06:00,2286,27.31,160,222,2126
04.01.2017 07:00,2317,27.68,213,220,2104
04.01.2017 08:00,2339,27.42,261,207,2078
04.01.2017 09:00,2509,27.98,245,181,2264
04.01.2017 10:00,2659,28.47,222,167,2437
04.01.2017 11:00,2716,28.26,151,164,2565
04.01.2017 12:00,2653,27.27,172,178,2481
04.01.2017 13:00,2523,26.48,219,184,2304
04.01.2017 14:00,2455,26.07,255,198,2200
04.01.2017 15:00,2383,25.29,253,204,2130
04.01.2017 16:00,2368,24.81,220,198,2148
04.01.2017 17:00,2381,26.28,186,191,2195
04.01.2017 18:00,2485,27.36,144,164,2341
04.01.2017 19:00,2557,28.32,105,143,2452
04.01.2017 20:00,2586,28.41,101,135,2485
04.01.2017 21:00,2655,28.28,122,140,2533
04.01.2017 22:00,2527,28.23,159,133,2368
04.01.2017 23:00,2392,28.08,161,125,2231
04.02.2017 00:00,2288,27.56,139,126,2149
04.02.2017 01:00,2185,27.55,129,104,2056
04.02.2017 02:00,2146,26.84,107,97,2039
04.02.2017 03:00,2103,26.12,107,89,1996
04.02.2017 04:00,2109,26.03,89,78,2020
04.02.2017 05:00,2122,26.49,84,69,2038
04.02.2017 06:00,2139,26.42,77,63,2062
04.02.2017 07:00,2179,26.65,68,56,2111
04.02.2017 08:00,2218,27.14,86,58,2132
04.02.2017 09:00,2412,28.19,80,54,2332
04.02.2017 10:00,2599,28.85,55,50,2544
04.02.2017 11:00,2707,28.54,41,56,2666
04.02.2017 12:00,2754,28.2,20,62,2734
04.02.2017 13:00,2696,27.45,27,71,2669
04.02.2017 14:00,2631,26.82,29,90,2602
04.02.2017 15:00,2578,26.36,48,117,2530
04.02.2017 16:00,2530,26.02,72,133,2458
04.02.2017 17:00,2468,25.87,105,146,2363
04.02.2017 18:00,2512,27.17,142,152,2370
04.02.2017 19:00,2657,28.36,121,157,2536
04.02.2017 20:00,2723,29.55,152,169,2571
04.02.2017 21:00,2808,29.4,177,184,2631
04.02.2017 22:00,2656,28.78,215,195,2441
04.02.2017 23:00,2497,28.26,222,207,2275
04.03.2017 00:00,2300,27.56,233,216,2067
04.03.2017 01:00,2206,28.14,231,168,1975
04.03.2017 02:00,2149,28.01,238,164,1911
04.03.2017 03:00,2130,27.95,239,167,1891
04.03.2017 04:00,2191,27.83,183,151,2008
04.03.2017 05:00,2239,28.16,165,138,2074
04.03.2017 06:00,2408,29.14,157,119,2251
04.03.2017 07:00,2842,35.96,128,103,2714
04.03.2017 08:00,3210,43.12,115,92,3095
04.03.2017 09:00,3365,50.59,65,83,3300
04.03.2017 10:00,3387,48.8,41,66,3346
04.03.2017 11:00,3406,47.27,26,49,3380
04.03.2017 12:00,3360,43.87,18,48,3342
04.03.2017 13:00,3272,38,17,42,3255
04.03.2017 14:00,3174,35.8,24,40,3150
04.03.2017 15:00,3106,31.45,31,38,3075
04.03.2017 16:00,3054,29.98,33,41,3021
04.03.2017 17:00,2910,30.96,39,48,2871
04.03.2017 18:00,2918,31.42,34,49,2884
04.03.2017 19:00,2890,34.94,26,50,2864
04.03.2017 20:00,2896,36.07,34,49,2862
04.03.2017 21:00,3026,36.04,49,53,2977
04.03.2017 22:00,2955,29.37,52,61,2903
04.03.2017 23:00,2795,28.59,59,67,2736
04.04.2017 00:00,2626,28.15,51,72,2575
04.04.2017 01:00,2500,27.49,43,65,2457
04.04.2017 02:00,2469,26.07,44,65,2425
04.04.2017 03:00,2473,26.02,38,66,2435
04.04.2017 04:00,2470,26.08,44,70,2426
04.04.2017 05:00,2507,27.41,56,71,2451
04.04.2017 06:00,2696,28.14,69,73,2627
04.04.2017 07:00,3062,28.9,72,72,2990
04.04.2017 08:00,3390,41.53,73,73,3317
04.04.2017 09:00,3430,49.71,59,71,3371
04.04.2017 10:00,3427,49.72,37,78,3390
04.04.2017 11:00,3431,42.26,45,88,3386
04.04.2017 12:00,3346,41.32,78,110,3268
04.04.2017 13:00,3256,38.22,88,135,3168
04.04.2017 14:00,3194,36.81,123,165,3071
04.04.2017 15:00,3135,28.19,160,211,2975
04.04.2017 16:00,3089,28.12,204,241,2885
04.04.2017 17:00,2992,28.15,256,271,2736
04.04.2017 18:00,3030,28.31,271,294,2759
04.04.2017 19:00,3026,28.63,284,310,2742
04.04.2017 20:00,3088,37.01,315,348,2773
04.04.2017 21:00,3094,28.72,439,378,2655
04.04.2017 22:00,2937,28.47,530,417,2407
04.04.2017 23:00,2744,28.11,577,449,2167
04.05.2017 00:00,2543,26.93,608,476,1935
04.05.2017 01:00,2422,24.26,663,548,1759
04.05.2017 02:00,2360,24.05,716,575,1644
04.05.2017 03:00,2306,23.88,740,578,1566
04.05.2017 04:00,2299,24.06,733,566,1566
04.05.2017 05:00,2358,25.1,683,546,1675
04.05.2017 06:00,2552,26.72,607,512,1945
04.05.2017 07:00,2900,28.11,583,493,2317
04.05.2017 08:00,3292,43.14,521,478,2771
04.05.2017 09:00,3369,46.94,566,497,2803
04.05.2017 10:00,3354,42.97,621,567,2733
04.05.2017 11:00,3367,38.08,732,668,2635
04.05.2017 12:00,3298,28.17,894,810,2404
04.05.2017 13:00,3175,27.99,1038,942,2137
04.05.2017 14:00,3115,27.68,1150,1049,1965
04.05.2017 15:00,3094,27.39,1218,1149,1876
04.05.2017 16:00,3111,27.3,1243,1225,1868
04.05.2017 17:00,3020,27.29,1303,1256,1717
04.05.2017 18:00,3036,27.47,1340,1264,1696
04.05.2017 19:00,3082,27.67,1282,1233,1800
04.05.2017 20:00,3182,27.63,1188,1204,1994
04.05.2017 21:00,3253,27.74,1076,1133,2177
04.05.2017 22:00,3124,27.46,1020,1077,2104
04.05.2017 23:00,2874,25.93,986,1023,1888
04.06.2017 00:00,2700,22.69,921,973,1779
04.06.2017 01:00,2556,20.88,900,958,1656
04.06.2017 02:00,2506,18.58,919,936,1587
04.06.2017 03:00,2492,19.73,905,923,1587
04.06.2017 04:00,2575,21.76,826,904,1749
04.06.2017 05:00,2568,23.73,830,841,1738
04.06.2017 06:00,2778,26.71,754,764,2024
04.06.2017 07:00,3183,28.26,633,669,2550
04.06.2017 08:00,3579,38.28,484,576,3095
04.06.2017 09:00,3626,39.83,321,461,3305
04.06.2017 10:00,3514,37.34,223,369,3291
04.06.2017 11:00,3397,37.59,227,302,3170
04.06.2017 12:00,3211,35.46,327,284,2884
04.06.2017 13:00,3136,31.07,366,313,2770
04.06.2017 14:00,3115,29.35,444,387,2671
04.06.2017 15:00,3040,28.33,549,451,2491
04.06.2017 16:00,2964,28.19,659,482,2305
04.06.2017 17:00,2865,28.08,769,547,2096
04.06.2017 18:00,2957,29.95,772,585,2185
04.06.2017 19:00,3013,30.38,753,621,2260
04.06.2017 20:00,3066,30.37,749,640,2317
04.06.2017 21:00,3033,29.82,794,636,2239
04.06.2017 22:00,2897,28.1,769,676,2128
04.06.2017 23:00,2744,27.58,635,657,2109
04.07.2017 00:00,2643,26.96,522,640,2121
04.07.2017 01:00,2517,25.01,433,614,2084
04.07.2017 02:00,2437,23.8,396,559,2041
04.07.2017 03:00,2377,23.74,360,498,2017
04.07.2017 04:00,2339,24.07,358,450,1981
04.07.2017 05:00,2360,25.5,332,395,2028
04.07.2017 06:00,2497,27.3,332,364,2165
04.07.2017 07:00,2836,28.5,336,358,2500
04.07.2017 08:00,3159,38.1,351,354,2808
04.07.2017 09:00,3291,41.57,310,354,2981
04.07.2017 10:00,3261,40.94,341,369,2920
04.07.2017 11:00,3338,39.98,352,364,2986
04.07.2017 12:00,3268,39.06,346,369,2922
04.07.2017 13:00,3145,37.22,347,384,2798
04.07.2017 14:00,3088,34.44,326,389,2762
04.07.2017 15:00,2919,29.29,344,392,2575
04.07.2017 16:00,2831,28.37,339,385,2492
04.07.2017 17:00,2749,28.11,318,376,2431
04.07.2017 18:00,2747,28.31,301,362,2446
04.07.2017 19:00,2673,35.67,327,323,2346
04.07.2017 20:00,2642,36.91,311,282,2331
04.07.2017 21:00,2680,28.64,304,243,2376
04.07.2017 22:00,2601,28.55,295,232,2306
04.07.2017 23:00,2437,27.93,274,210,2163
04.08.2017 00:00,2333,27.36,237,184,2096
04.08.2017 01:00,2167,27.98,223,135,1944
04.08.2017 02:00,2120,27.85,197,113,1923
04.08.2017 03:00,2100,27.83,168,90,1932
04.08.2017 04:00,2139,27.92,157,95,1982
04.08.2017 05:00,2176,27.99,143,104,2033
04.08.2017 06:00,2233,28.3,150,118,2083
04.08.2017 07:00,2297,28.24,191,140,2106
04.08.2017 08:00,2371,28.65,265,162,2106
04.08.2017 09:00,2619,28.72,236,170,2383
04.08.2017 10:00,2784,29.08,207,194,2577
04.08.2017 11:00,2850,29.12,196,200,2654
04.08.2017 12:00,2832,28.95,212,230,2620
04.08.2017 13:00,2842,28.68,233,282,2609
04.08.2017 14:00,2784,28.38,263,308,2521
04.08.2017 15:00,2698,27.81,327,375,2371
04.08.2017 16:00,2624,27.44,403,442,2221
04.08.2017 17:00,2688,27.66,440,492,2248
04.08.2017 18:00,2783,28.13,468,562,2315
04.08.2017 19:00,2805,28.35,500,569,2305
04.08.2017 20:00,2772,28.43,499,561,2273
04.08.2017 21:00,2738,28.52,566,546,2172
04.08.2017 22:00,2593,28.53,655,550,1938
04.08.2017 23:00,2445,28.51,672,548,1773
04.09.2017 00:00,2341,28.08,655,566,1686
04.09.2017 01:00,2234,26.28,620,548,1614
04.09.2017 02:00,2150,25.05,649,550,1501
04.09.2017 03:00,2067,24.8,706,544,1361
04.09.2017 04:00,2074,24.5,707,531,1367
04.09.2017 05:00,2091,24.55,693,519,1398
04.09.2017 06:00,2143,24.7,673,500,1470
04.09.2017 07:00,2183,23.86,667,489,1516
04.09.2017 08:00,2310,24.38,625,469,1685
04.09.2017 09:00,2470,27.14,593,453,1877
04.09.2017 10:00,2544,28.25,629,453,1915
04.09.2017 11:00,2583,27.6,630,469,1953
04.09.2017 12:00,2584,26.59,556,455,2028
04.09.2017 13:00,2630,25.06,458,455,2172
04.09.2017 14:00,2587,23.92,426,457,2161
04.09.2017 15:00,2494,22.97,430,449,2064
04.09.2017 16:00,2459,22.93,422,447,2037
04.09.2017 17:00,2474,23.67,398,450,2076
04.09.2017 18:00,2536,25.07,390,451,2146
04.09.2017 19:00,2647,27.21,392,457,2255
04.09.2017 20:00,2711,27.73,429,467,2282
04.09.2017 21:00,2737,27.87,577,507,2160
04.09.2017 22:00,2607,27.58,707,551,1900
04.09.2017 23:00,2438,26.42,748,588,1690
04.10.2017 00:00,2292,24.08,793,625,1499
04.10.2017 01:00,2209,24.45,813,660,1396
04.10.2017 02:00,2167,23.02,810,695,1357
04.10.2017 03:00,2165,20.36,866,751,1299
04.10.2017 04:00,2170,17.84,936,809,1234
04.10.2017 05:00,2154,20.51,1022,853,1132
04.10.2017 06:00,2286,25.46,1119,900,1167
04.10.2017 07:00,2535,27.67,1199,931,1336
04.10.2017 08:00,2904,28.73,1212,954,1692
04.10.2017 09:00,3087,28.79,1136,983,1951
04.10.2017 10:00,3097,28.56,1183,1006,1914
04.10.2017 11:00,3134,28.15,1214,1026,1920
04.10.2017 12:00,3083,27.57,1290,1071,1793
04.10.2017 13:00,2965,26.58,1346,1115,1619
04.10.2017 14:00,2984,26.2,1366,1189,1618
04.10.2017 15:00,2986,24.7,1378,1234,1608
04.10.2017 16:00,2963,24.62,1389,1255,1574
04.10.2017 17:00,2930,24.26,1388,1288,1542
04.10.2017 18:00,2949,26.2,1369,1261,1580
04.10.2017 19:00,2943,26.65,1337,1237,1606
04.10.2017 20:00,3008,27,1270,1214,1738
04.10.2017 21:00,3096,26.83,1236,1206,1860
04.10.2017 22:00,2994,26.35,1259,1224,1735
04.10.2017 23:00,2790,22.1,1279,1231,1511
04.11.2017 00:00,2608,6.76,1281,1232,1327
04.11.2017 01:00,2498,4.97,1291,1266,1207
04.11.2017 02:00,2485,4.92,1260,1266,1225
04.11.2017 03:00,2499,4.1,1249,1263,1250
04.11.2017 04:00,2501,5.64,1243,1243,1258
04.11.2017 05:00,2566,10.38,1211,1210,1355
04.11.2017 06:00,2716,18.02,1143,1161,1573
04.11.2017 07:00,3068,24.88,1051,1101,2017
04.11.2017 08:00,3408,27.54,988,1043,2420
04.11.2017 09:00,3471,27.7,962,1000,2509
04.11.2017 10:00,3355,27.55,997,975,2358
04.11.2017 11:00,3338,27.49,958,959,2380
04.11.2017 12:00,3299,27.32,971,977,2328
04.11.2017 13:00,3091,27.15,1138,999,1953
04.11.2017 14:00,3042,27.15,1179,1014,1863
04.11.2017 15:00,3009,26.79,1184,1043,1825
04.11.2017 16:00,3049,26.62,1153,1064,1896
04.11.2017 17:00,3002,26.9,1116,1044,1886
04.11.2017 18:00,2997,27.41,1074,991,1923
04.11.2017 19:00,3066,27.78,876,877,2190
04.11.2017 20:00,3262,28.3,607,749,2655
04.11.2017 21:00,3291,28.18,495,606,2796
04.11.2017 22:00,3030,27.86,555,530,2475
04.11.2017 23:00,2751,26.92,570,497,2181
04.12.2017 00:00,2538,25.87,588,512,1950
04.12.2017 01:00,2421,25.99,545,519,1876
04.12.2017 02:00,2400,24.42,555,538,1845
04.12.2017 03:00,2346,24.18,649,568,1697
04.12.2017 04:00,2349,24.47,695,615,1654
04.12.2017 05:00,2399,24.81,714,663,1685
04.12.2017 06:00,2538,25.98,773,712,1765
04.12.2017 07:00,2839,28.13,883,754,1956
04.12.2017 08:00,3199,28.79,918,790,2281
04.12.2017 09:00,3356,28.84,923,830,2433
04.12.2017 10:00,3416,28.79,944,877,2472
04.12.2017 11:00,3368,28.62,1015,883,2353
04.12.2017 12:00,3309,28.02,1073,915,2236
04.12.2017 13:00,3228,27.86,1086,926,2142
04.12.2017 14:00,3236,27.76,1098,949,2138
04.12.2017 15:00,3191,27.54,1081,960,2110
04.12.2017 16:00,3202,27.46,1055,978,2147
04.12.2017 17:00,3158,27.11,994,952,2164
04.12.2017 18:00,3129,27.56,909,892,2220
04.12.2017 19:00,3169,28.3,818,842,2351
04.12.2017 20:00,3112,28.45,796,764,2316
04.12.2017 21:00,3155,28.46,738,696,2417
04.12.2017 22:00,3072,28.22,662,697,2410
04.12.2017 23:00,2803,27.32,677,679,2126
13.04.2017 00:00,2508,24.25,709,651,1799
13.04.2017 01:00,2409,24.09,647,605,1762
13.04.2017 02:00,2326,23.46,624,582,1702
13.04.2017 03:00,2357,23.05,566,551,1791
13.04.2017 04:00,2366,23.08,520,522,1846
13.04.2017 05:00,2441,24.16,475,501,1966
13.04.2017 06:00,2582,26.76,463,472,2119
13.04.2017 07:00,2911,27.81,434,446,2477
13.04.2017 08:00,3326,28.06,338,420,2988
13.04.2017 09:00,3391,28.38,361,384,3030
13.04.2017 10:00,3370,28.46,354,362,3016
13.04.2017 11:00,3365,28.47,351,316,3014
13.04.2017 12:00,3373,28.29,312,300,3061
13.04.2017 13:00,3236,27.67,310,263,2926
13.04.2017 14:00,3180,27.42,286,246,2894
13.04.2017 15:00,3103,27.34,264,227,2839
13.04.2017 16:00,3094,27.22,228,228,2866
13.04.2017 17:00,3050,27.59,212,226,2838
13.04.2017 18:00,3083,28.06,201,215,2882
13.04.2017 19:00,3054,28.18,214,209,2840
13.04.2017 20:00,3001,28.18,243,224,2758
13.04.2017 21:00,2934,28.28,278,224,2656
13.04.2017 22:00,2810,28.07,332,253,2478
13.04.2017 23:00,2622,27.77,356,312,2266
14.04.2017 00:00,2378,27.46,481,381,1897
14.04.2017 01:00,2284,27.42,541,468,1743
14.04.2017 02:00,2203,26.78,608,534,1595
14.04.2017 03:00,2178,26.65,670,606,1508
14.04.2017 04:00,2117,26.73,760,645,1357
14.04.2017 05:00,2144,26.69,778,669,1366
14.04.2017 06:00,2218,26.76,789,681,1429
14.04.2017 07:00,2281,26.93,782,699,1499
14.04.2017 08:00,2453,27.7,759,710,1694
14.04.2017 09:00,2558,28.46,819,728,1739
14.04.2017 10:00,2613,28.23,874,749,1739
14.04.2017 11:00,2646,27.82,878,760,1768
14.04.2017 12:00,2623,27.88,918,807,1705
14.04.2017 13:00,2573,27.31,900,789,1673
14.04.2017 14:00,2537,27.69,842,762,1695
14.04.2017 15:00,2600,27.65,707,736,1893
14.04.2017 16:00,2557,27.79,612,654,1945
14.04.2017 17:00,2557,28.34,557,589,2000
14.04.2017 18:00,2630,28.95,464,473,2166
14.04.2017 19:00,2651,29.49,324,361,2327
14.04.2017 20:00,2682,30.72,230,273,2452
14.04.2017 21:00,2727,32.14,179,195,2548
14.04.2017 22:00,2714,30.4,150,156,2564
14.04.2017 23:00,2591,29.87,150,134,2441
15.04.2017 00:00,2456,28.99,151,131,2305
15.04.2017 01:00,2333,30.01,139,114,2194
15.04.2017 02:00,2263,29.25,131,110,2132
15.04.2017 03:00,2181,28.65,145,117,2036
15.04.2017 04:00,2188,27.51,154,123,2034
15.04.2017 05:00,2204,27.82,181,133,2023
15.04.2017 06:00,2220,27.6,222,153,1998
15.04.2017 07:00,2233,27.88,270,188,1963
15.04.2017 08:00,2343,27.87,336,228,2007
15.04.2017 09:00,2582,28.36,383,284,2199
15.04.2017 10:00,2785,28.73,428,360,2357
15.04.2017 11:00,2948,28.77,478,448,2470
15.04.2017 12:00,2895,28.57,627,505,2268
15.04.2017 13:00,2870,28.24,746,578,2124
15.04.2017 14:00,2882,27.97,779,633,2103
15.04.2017 15:00,2930,27.57,766,694,2164
15.04.2017 16:00,2968,27.29,727,712,2241
15.04.2017 17:00,2886,27.22,783,691,2103
15.04.2017 18:00,2802,27.66,866,679,1936
15.04.2017 19:00,2736,27.91,852,633,1884
15.04.2017 20:00,2742,28.15,783,599,1959
15.04.2017 21:00,2763,28.48,746,551,2017
15.04.2017 22:00,2730,28.39,666,504,2064
15.04.2017 23:00,2686,27.79,565,459,2121
16.04.2017 00:00,2611,27.58,501,434,2110
16.04.2017 01:00,2627,28.37,418,458,2209
16.04.2017 02:00,2575,28.19,357,397,2218
16.04.2017 03:00,2500,28.13,353,340,2147
16.04.2017 04:00,2457,28.07,360,294,2097
16.04.2017 05:00,2497,28.13,326,261,2171
16.04.2017 06:00,2519,28.32,293,229,2226
16.04.2017 07:00,2517,28.32,251,199,2266
16.04.2017 08:00,2645,28.21,148,175,2497
16.04.2017 09:00,2719,28.46,66,141,2653
16.04.2017 10:00,2758,28.45,61,121,2697
16.04.2017 11:00,2757,28.56,56,96,2701
16.04.2017 12:00,2706,28.74,67,88,2639
16.04.2017 13:00,2630,28.51,61,83,2569
16.04.2017 14:00,2560,28.33,66,81,2494
16.04.2017 15:00,2511,27.96,72,72,2439
16.04.2017 16:00,2471,27.7,72,74,2399
16.04.2017 17:00,2471,27.74,76,70,2395
16.04.2017 18:00,2521,28.08,78,72,2443
16.04.2017 19:00,2591,29.17,63,76,2528
16.04.2017 20:00,2667,30.32,63,81,2604
16.04.2017 21:00,2806,31.99,67,93,2739
16.04.2017 22:00,2788,31.76,85,104,2703
16.04.2017 23:00,2676,30.9,100,114,2576
17.04.2017 00:00,2505,29.73,121,127,2384
17.04.2017 01:00,2363,29.21,132,131,2231
17.04.2017 02:00,2358,27.26,127,141,2231
17.04.2017 03:00,2366,27.11,125,146,2241
17.04.2017 04:00,2362,27.28,159,158,2203
17.04.2017 05:00,2367,27.67,221,172,2146
17.04.2017 06:00,2405,27.95,257,190,2148
17.04.2017 07:00,2480,28.21,272,213,2208
17.04.2017 08:00,2628,28.12,238,234,2390
17.04.2017 09:00,2729,29.4,255,258,2474
17.04.2017 10:00,2770,30.17,348,307,2422
17.04.2017 11:00,2788,29.6,391,345,2397
17.04.2017 12:00,2825,29.06,408,376,2417
17.04.2017 13:00,2825,28.33,398,404,2427
17.04.2017 14:00,2811,28.16,378,410,2433
17.04.2017 15:00,2777,27.89,373,417,2404
17.04.2017 16:00,2713,28,389,402,2324
17.04.2017 17:00,2684,28.05,420,399,2264
17.04.2017 18:00,2729,27.95,427,403,2302
17.04.2017 19:00,2706,28.21,447,395,2259
17.04.2017 20:00,2842,29.8,394,391,2448
17.04.2017 21:00,3018,31,327,372,2691
17.04.2017 22:00,3031,30.85,280,366,2751
17.04.2017 23:00,2876,29.79,283,359,2593
18.04.2017 00:00,2745,29.34,283,358,2462
18.04.2017 01:00,2598,29.05,328,361,2270
18.04.2017 02:00,2611,28.36,325,369,2286
18.04.2017 03:00,2629,27.77,333,378,2296
18.04.2017 04:00,2646,27.26,388,389,2258
18.04.2017 05:00,2663,27.94,426,393,2237
18.04.2017 06:00,2832,29.94,459,398,2373
18.04.2017 07:00,3235,33.01,443,400,2792
18.04.2017 08:00,3606,42.31,342,401,3264
18.04.2017 09:00,3676,45.39,299,399,3377
18.04.2017 10:00,3527,41.05,383,402,3144
18.04.2017 11:00,3541,39.88,381,408,3160
18.04.2017 12:00,3545,37.97,365,399,3180
18.04.2017 13:00,3506,35.9,312,382,3194
18.04.2017 14:00,3507,33.83,271,342,3236
18.04.2017 15:00,3433,31.04,242,302,3191
18.04.2017 16:00,3430,30.72,211,278,3219
18.04.2017 17:00,3331,30.1,214,255,3117
18.04.2017 18:00,3319,30.86,204,240,3115
18.04.2017 19:00,3294,33.1,208,223,3086
18.04.2017 20:00,3335,36.62,178,198,3157
18.04.2017 21:00,3416,36.73,172,186,3244
18.04.2017 22:00,3340,34.59,202,186,3138
18.04.2017 23:00,3179,31.89,206,167,2973
19.04.2017 00:00,3004,30.07,182,158,2822
19.04.2017 01:00,2855,30.35,150,146,2705
19.04.2017 02:00,2858,30.02,116,138,2742
19.04.2017 03:00,2839,29.94,107,129,2732
19.04.2017 04:00,2871,30.25,105,124,2766
19.04.2017 05:00,2928,30.83,114,126,2814
19.04.2017 06:00,3099,31.81,131,124,2968
19.04.2017 07:00,3441,38.9,117,120,3324
19.04.2017 08:00,3687,46.88,75,110,3612
19.04.2017 09:00,3713,48.38,40,96,3673
19.04.2017 10:00,3655,43.67,32,78,3623
19.04.2017 11:00,3598,38.97,30,68,3568
19.04.2017 12:00,3530,37.4,23,64,3507
19.04.2017 13:00,3447,37.1,25,55,3422
19.04.2017 14:00,3369,36.61,52,52,3317
19.04.2017 15:00,3252,34.47,94,48,3158
19.04.2017 16:00,3176,33.07,127,56,3049
19.04.2017 17:00,3052,33.73,167,77,2885
19.04.2017 18:00,3045,36,184,99,2861
19.04.2017 19:00,3034,37.63,186,102,2848
19.04.2017 20:00,3064,38.31,187,99,2877
19.04.2017 21:00,3179,39.91,178,103,3001
19.04.2017 22:00,3174,35.75,189,132,2985
19.04.2017 23:00,2942,32.24,276,150,2666
20.04.2017 00:00,2733,30.51,306,168,2427
20.04.2017 01:00,2617,29.2,338,187,2279
20.04.2017 02:00,2562,28.98,353,193,2209
20.04.2017 03:00,2603,28.99,330,199,2273
20.04.2017 04:00,2646,28.98,320,209,2326
20.04.2017 05:00,2735,29.04,324,215,2411
20.04.2017 06:00,2920,29.33,346,230,2574
20.04.2017 07:00,3194,31.25,395,237,2799
20.04.2017 08:00,3486,41,351,246,3135
20.04.2017 09:00,3523,41.07,351,287,3172
20.04.2017 10:00,3364,41.04,503,347,2861
20.04.2017 11:00,3364,37.55,590,443,2774
20.04.2017 12:00,3413,30.46,642,532,2771
20.04.2017 13:00,3372,30.1,690,605,2682
20.04.2017 14:00,3362,29.67,760,668,2602
20.04.2017 15:00,3335,29.37,822,726,2513
20.04.2017 16:00,3363,29.17,872,787,2491
20.04.2017 17:00,3332,29.15,883,828,2449
20.04.2017 18:00,3458,29.19,847,879,2611
20.04.2017 19:00,3362,29.05,896,916,2466
20.04.2017 20:00,3264,28.96,945,924,2319
20.04.2017 21:00,3228,28.91,997,953,2231
20.04.2017 22:00,3161,29.05,1051,979,2110
20.04.2017 23:00,2842,28.38,1178,1013,1664
21.04.2017 00:00,2614,26.14,1245,1060,1369
21.04.2017 01:00,2504,21.55,1226,1120,1278
21.04.2017 02:00,2411,19.93,1249,1132,1162
21.04.2017 03:00,2411,19.71,1269,1133,1142
21.04.2017 04:00,2403,20.43,1270,1137,1133
21.04.2017 05:00,2481,22.16,1240,1141,1241
21.04.2017 06:00,2665,23.3,1231,1140,1434
21.04.2017 07:00,3034,23.62,1206,1143,1828
21.04.2017 08:00,3375,28.78,1208,1155,2167
21.04.2017 09:00,3407,29.14,1257,1157,2150
21.04.2017 10:00,3363,26.79,1279,1167,2084
21.04.2017 11:00,3414,24.2,1294,1216,2120
21.04.2017 12:00,3381,22.45,1318,1252,2063
21.04.2017 13:00,3271,22.03,1343,1289,1928
21.04.2017 14:00,3229,20.64,1344,1323,1885
21.04.2017 15:00,3135,20.29,1343,1344,1792
21.04.2017 16:00,3201,18.55,1235,1370,1966
21.04.2017 17:00,3133,16.09,1295,1384,1838
21.04.2017 18:00,3140,18.09,1338,1387,1802
21.04.2017 19:00,3099,18.97,1353,1390,1746
21.04.2017 20:00,3038,19.38,1353,1399,1685
21.04.2017 21:00,2984,20.89,1359,1408,1625
21.04.2017 22:00,2923,20.02,1382,1402,1541
21.04.2017 23:00,2765,4.29,1395,1377,1370
22.04.2017 00:00,2625,1.7,1389,1365,1236
22.04.2017 01:00,2590,3.74,1309,1346,1281
22.04.2017 02:00,2518,2.7,1311,1294,1207
22.04.2017 03:00,2471,1.88,1301,1244,1170
22.04.2017 04:00,2503,2.35,1225,1200,1278
22.04.2017 05:00,2526,2.82,1151,1137,1375
22.04.2017 06:00,2543,3.79,1082,1073,1461
22.04.2017 07:00,2611,9.19,1008,1040,1603
22.04.2017 08:00,2699,10.72,956,1012,1743
22.04.2017 09:00,2675,13.09,1075,995,1600
22.04.2017 10:00,2703,19.41,1090,987,1613
22.04.2017 11:00,2710,20.25,1045,958,1665
22.04.2017 12:00,2704,20.3,1015,939,1689
22.04.2017 13:00,2631,19.56,1082,938,1549
22.04.2017 14:00,2549,18.68,1118,956,1431
22.04.2017 15:00,2424,16.4,1204,986,1220
22.04.2017 16:00,2408,12.91,1225,1021,1183
22.04.2017 17:00,2434,15.13,1211,1039,1223
22.04.2017 18:00,2514,10.99,1138,1014,1376
22.04.2017 19:00,2500,20.79,1072,921,1428
22.04.2017 20:00,2589,23.01,848,810,1741
22.04.2017 21:00,2832,24.5,557,704,2275
22.04.2017 22:00,2892,24.2,452,599,2440
22.04.2017 23:00,2672,24,501,531,2171
23.04.2017 00:00,2449,20.36,570,455,1879
23.04.2017 01:00,2291,24.08,569,403,1722
23.04.2017 02:00,2271,23.56,535,381,1736
23.04.2017 03:00,2285,22.98,508,373,1777
23.04.2017 04:00,2303,23.77,500,365,1803
23.04.2017 05:00,2383,23.86,443,356,1940
23.04.2017 06:00,2405,23.7,397,347,2008
23.04.2017 07:00,2428,19.97,362,329,2066
23.04.2017 08:00,2529,24.01,286,331,2243
23.04.2017 09:00,2642,26.88,248,351,2394
23.04.2017 10:00,2794,28.56,274,394,2520
23.04.2017 11:00,2722,28.59,411,442,2311
23.04.2017 12:00,2683,28.56,542,499,2141
23.04.2017 13:00,2585,28.33,698,580,1887
23.04.2017 14:00,2551,27.12,819,650,1732
23.04.2017 15:00,2507,26.15,886,712,1621
23.04.2017 16:00,2568,25.4,867,772,1701
23.04.2017 17:00,2622,26.39,880,799,1742
23.04.2017 18:00,2694,25.82,840,786,1854
23.04.2017 19:00,2670,26.16,806,729,1864
23.04.2017 20:00,2729,29.29,691,636,2038
23.04.2017 21:00,2924,30.73,487,538,2437
23.04.2017 22:00,2921,30.86,493,504,2428
23.04.2017 23:00,2654,30.42,647,518,2007
24.04.2017 00:00,2453,29.33,682,491,1771
24.04.2017 01:00,2361,28.87,674,509,1687
24.04.2017 02:00,2330,27.65,605,459,1725
24.04.2017 03:00,2371,27.42,526,421,1845
24.04.2017 04:00,2390,26.48,511,401,1879
24.04.2017 05:00,2415,27.46,510,403,1905
24.04.2017 06:00,2469,29.53,606,431,1863
24.04.2017 07:00,2840,33.42,706,498,2134
24.04.2017 08:00,3336,40.08,659,577,2677
24.04.2017 09:00,3505,41.67,720,670,2785
24.04.2017 10:00,3425,37.98,957,792,2468
24.04.2017 11:00,3399,36.17,1146,904,2253
24.04.2017 12:00,3516,34.36,1206,1032,2310
24.04.2017 13:00,3473,32.94,1274,1133,2199
24.04.2017 14:00,3434,32.55,1336,1162,2098
24.04.2017 15:00,3411,31.91,1348,1210,2063
24.04.2017 16:00,3387,31.39,1362,1262,2025
24.04.2017 17:00,3301,30.43,1330,1267,1971
24.04.2017 18:00,3268,31.42,1295,1260,1973
24.04.2017 19:00,3201,32.72,1305,1249,1896
24.04.2017 20:00,3159,32.89,1289,1221,1870
24.04.2017 21:00,3179,32.99,1267,1198,1912
24.04.2017 22:00,3255,32.41,1197,1178,2058
24.04.2017 23:00,3140,30.83,1095,1138,2045
25.04.2017 00:00,2981,29.06,1044,1116,1937
25.04.2017 01:00,2911,29.13,974,1105,1937
25.04.2017 02:00,2867,29.08,941,1063,1926
25.04.2017 03:00,2833,28.99,935,1031,1898
25.04.2017 04:00,2815,29.02,925,999,1890
25.04.2017 05:00,2887,29.12,865,969,2022
25.04.2017 06:00,3016,29.77,827,932,2189
25.04.2017 07:00,3411,36.14,730,908,2681
25.04.2017 08:00,3698,41.17,705,889,2993
25.04.2017 09:00,3639,43,775,883,2864
25.04.2017 10:00,3505,41.94,868,883,2637
25.04.2017 11:00,3467,39.8,887,868,2580
25.04.2017 12:00,3398,38.1,934,893,2464
25.04.2017 13:00,3283,35.09,1007,930,2276
25.04.2017 14:00,3233,33.91,1061,954,2172
25.04.2017 15:00,3107,32.01,1147,951,1960
25.04.2017 16:00,3128,31.59,1097,936,2031
25.04.2017 17:00,3034,32.46,1120,916,1914
25.04.2017 18:00,3043,36.55,1115,886,1928
25.04.2017 19:00,3105,38.97,974,816,2131
25.04.2017 20:00,3097,41.92,869,739,2228
25.04.2017 21:00,3112,41.91,793,674,2319
25.04.2017 22:00,3076,40.82,747,606,2329
25.04.2017 23:00,2907,37.5,657,570,2250
26.04.2017 00:00,2734,32.59,637,543,2097
26.04.2017 01:00,2638,30.54,606,572,2032
26.04.2017 02:00,2618,30.25,539,523,2079
26.04.2017 03:00,2654,30.2,471,483,2183
26.04.2017 04:00,2657,30.06,426,445,2231
26.04.2017 05:00,2705,30.44,387,390,2318
26.04.2017 06:00,2818,33.1,344,322,2474
26.04.2017 07:00,3120,42.3,273,265,2847
26.04.2017 08:00,3431,45.82,193,234,3238
26.04.2017 09:00,3410,52.18,169,196,3241
26.04.2017 10:00,3356,46.98,132,178,3224
26.04.2017 11:00,3398,45.61,118,154,3280
26.04.2017 12:00,3367,44.75,125,147,3242
26.04.2017 13:00,3307,44.01,129,152,3178
26.04.2017 14:00,3233,42,188,164,3045
26.04.2017 15:00,3132,39.11,250,178,2882
26.04.2017 16:00,3072,38.64,294,179,2778
26.04.2017 17:00,3009,38.61,292,193,2717
26.04.2017 18:00,3003,40.92,305,186,2698
26.04.2017 19:00,2998,39.74,269,178,2729
26.04.2017 20:00,2963,40.21,234,157,2729
26.04.2017 21:00,3053,37.21,179,129,2874
26.04.2017 22:00,3027,39.4,209,117,2818
26.04.2017 23:00,2887,36.61,156,112,2731
27.04.2017 00:00,2730,32.58,135,97,2595
27.04.2017 01:00,2635,31.42,142,128,2493
27.04.2017 02:00,2586,30.49,143,120,2443
27.04.2017 03:00,2563,30.31,132,103,2431
27.04.2017 04:00,2591,30.3,153,99,2438
27.04.2017 05:00,2616,30.76,177,98,2439
27.04.2017 06:00,2781,32.48,137,96,2644
27.04.2017 07:00,3130,41.05,122,86,3008
27.04.2017 08:00,3387,44.97,103,79,3284
27.04.2017 09:00,3419,45.93,53,70,3366
27.04.2017 10:00,3350,43.67,65,69,3285
27.04.2017 11:00,3267,42.92,155,96,3112
27.04.2017 12:00,3203,40.95,223,117,2980
27.04.2017 13:00,3081,36.71,277,156,2804
27.04.2017 14:00,3006,35.85,361,187,2645
27.04.2017 15:00,2987,35.29,359,220,2628
27.04.2017 16:00,3078,34.82,293,243,2785
27.04.2017 17:00,2972,33.69,321,246,2651
27.04.2017 18:00,2970,35.56,314,238,2656
27.04.2017 19:00,2949,37.04,326,222,2623
27.04.2017 20:00,2960,40.96,269,185,2691
27.04.2017 21:00,2967,40.18,224,154,2743
27.04.2017 22:00,2993,39.63,209,150,2784
27.04.2017 23:00,2794,34.87,209,173,2585
28.04.2017 00:00,2536,32,266,189,2270
28.04.2017 01:00,2388,31.38,304,231,2084
28.04.2017 02:00,2301,31.03,350,242,1951
28.04.2017 03:00,2285,30.61,330,243,1955
28.04.2017 04:00,2352,30.68,325,258,2027
28.04.2017 05:00,2358,31.02,359,277,1999
28.04.2017 06:00,2512,32.72,359,292,2153
28.04.2017 07:00,2887,35.42,362,306,2525
28.04.2017 08:00,3219,41.54,384,314,2835
28.04.2017 09:00,3326,44.78,357,335,2969
28.04.2017 10:00,3326,43.9,390,377,2936
28.04.2017 11:00,3290,41.87,473,406,2817
28.04.2017 12:00,3257,40.9,542,446,2715
28.04.2017 13:00,3144,38.06,605,478,2539
28.04.2017 14:00,3122,34.61,566,486,2556
28.04.2017 15:00,3039,32.82,512,484,2527
28.04.2017 16:00,2951,32.26,505,464,2446
28.04.2017 17:00,2854,31.97,506,450,2348
28.04.2017 18:00,2847,32.84,531,458,2316
28.04.2017 19:00,2825,33.52,554,478,2271
28.04.2017 20:00,2800,33.26,569,484,2231
28.04.2017 21:00,2879,33.59,508,495,2371
28.04.2017 22:00,2892,33.8,520,526,2372
28.04.2017 23:00,2626,31.87,598,506,2028
29.04.2017 00:00,2421,30.34,628,510,1793
29.04.2017 01:00,2326,32.24,650,531,1676
29.04.2017 02:00,2317,29.71,579,528,1738
29.04.2017 03:00,2338,29.88,499,509,1839
29.04.2017 04:00,2355,29.86,488,491,1867
29.04.2017 05:00,2350,30.16,514,487,1836
29.04.2017 06:00,2345,30.58,520,469,1825
29.04.2017 07:00,2426,31.42,532,474,1894
29.04.2017 08:00,2649,32.64,494,476,2155
29.04.2017 09:00,2855,32.69,401,470,2454
29.04.2017 10:00,2961,32.56,362,465,2599
29.04.2017 11:00,2958,30.59,336,436,2622
29.04.2017 12:00,2880,30.13,352,422,2528
29.04.2017 13:00,2812,30.07,359,400,2453
29.04.2017 14:00,2768,29.69,329,388,2439
29.04.2017 15:00,2692,29.05,329,358,2363
29.04.2017 16:00,2590,28.77,395,323,2195
29.04.2017 17:00,2697,28.36,287,282,2410
29.04.2017 18:00,2754,29.93,221,230,2533
29.04.2017 19:00,2819,31.8,166,184,2653
29.04.2017 20:00,2805,33.81,136,151,2669
29.04.2017 21:00,2838,33.68,82,125,2756
29.04.2017 22:00,2813,33.78,112,128,2701
29.04.2017 23:00,2714,32.14,103,152,2611
30.04.2017 00:00,2626,30.47,100,189,2526
30.04.2017 01:00,2493,30.01,87,152,2406
30.04.2017 02:00,2395,29.38,118,143,2277
30.04.2017 03:00,2400,28.81,127,140,2273
30.04.2017 04:00,2430,28.35,111,134,2319
30.04.2017 05:00,2470,28.06,90,126,2380
30.04.2017 06:00,2428,28.07,90,110,2338
30.04.2017 07:00,2446,27.85,75,88,2371
30.04.2017 08:00,2498,28.6,45,70,2453
30.04.2017 09:00,2543,28.86,13,59,2530
30.04.2017 10:00,2622,29.85,22,56,2600
30.04.2017 11:00,2590,30.21,55,63,2535
30.04.2017 12:00,2565,30.01,75,79,2490
30.04.2017 13:00,2516,29.81,99,98,2417
30.04.2017 14:00,2457,29.73,139,122,2318
30.04.2017 15:00,2431,28.9,174,145,2257
30.04.2017 16:00,2386,28.39,210,168,2176
30.04.2017 17:00,2367,28.37,242,188,2125
30.04.2017 18:00,2417,28.39,261,203,2156
30.04.2017 19:00,2357,28.7,284,217,2073
30.04.2017 20:00,2318,29.04,298,221,2020
30.04.2017 21:00,2376,29.43,292,236,2084
30.04.2017 22:00,2443,29.55,364,264,2079
30.04.2017 23:00,2395,28.33,422,308,1973
05.01.2017 00:00,2302,27.55,466,342,1836
05.01.2017 01:00,2216,26.94,489,370,1727
05.01.2017 02:00,2135,24.38,544,399,1591
05.01.2017 03:00,2092,24.33,572,414,1520
05.01.2017 04:00,2155,23.9,537,414,1618
05.01.2017 05:00,2218,23.78,523,425,1695
05.01.2017 06:00,2191,23.19,548,422,1643
05.01.2017 07:00,2218,23.69,570,428,1648
05.01.2017 08:00,2322,27.87,508,437,1814
05.01.2017 09:00,2405,28.85,551,486,1854
05.01.2017 10:00,2334,29.42,706,543,1628
05.01.2017 11:00,2366,29.59,779,624,1587
05.01.2017 12:00,2389,29.3,816,667,1573
05.01.2017 13:00,2436,28.96,793,709,1643
05.01.2017 14:00,2376,28.62,807,719,1569
05.01.2017 15:00,2292,26.83,848,729,1444
05.01.2017 16:00,2264,24.89,851,735,1413
05.01.2017 17:00,2294,24.22,839,737,1455
05.01.2017 18:00,2367,25.47,797,724,1570
05.01.2017 19:00,2441,28.17,732,704,1709
05.01.2017 20:00,2485,28.76,650,662,1835
05.01.2017 21:00,2574,29.51,575,622,1999
05.01.2017 22:00,2630,29.82,588,591,2042
05.01.2017 23:00,2458,29.22,612,578,1846
05.02.2017 00:00,2349,25.2,632,567,1717
05.02.2017 01:00,2275,25.93,627,555,1648
05.02.2017 02:00,2248,23.67,635,548,1613
05.02.2017 03:00,2236,24.13,653,549,1583
05.02.2017 04:00,2259,24.21,662,542,1597
05.02.2017 05:00,2318,27.95,669,535,1649
05.02.2017 06:00,2396,28.89,659,514,1737
05.02.2017 07:00,2823,33.13,574,485,2249
05.02.2017 08:00,3269,36.67,362,460,2907
05.02.2017 09:00,3365,37.3,261,460,3104
05.02.2017 10:00,3176,35.12,416,509,2760
05.02.2017 11:00,2918,34.01,687,512,2231
05.02.2017 12:00,2928,32.67,722,602,2206
05.02.2017 13:00,2908,31.7,713,635,2195
05.02.2017 14:00,2900,31.54,728,674,2172
05.02.2017 15:00,2841,30.44,747,683,2094
05.02.2017 16:00,2757,30.41,764,681,1993
05.02.2017 17:00,2647,30.43,793,687,1854
05.02.2017 18:00,2671,30.99,775,668,1896
05.02.2017 19:00,2626,31.26,744,637,1882
05.02.2017 20:00,2691,31.77,632,594,2059
05.02.2017 21:00,2771,31.55,567,564,2204
05.02.2017 22:00,2751,31.74,580,546,2171
05.02.2017 23:00,2514,30.57,648,555,1866
05.03.2017 00:00,2338,28.46,648,559,1690
05.03.2017 01:00,2245,28.59,639,587,1606
05.03.2017 02:00,2246,27.43,614,601,1632
05.03.2017 03:00,2241,27.48,619,600,1622
05.03.2017 04:00,2268,27.81,608,605,1660
05.03.2017 05:00,2269,28.92,655,594,1614
05.03.2017 06:00,2325,30.06,680,588,1645
05.03.2017 07:00,2710,31.87,668,570,2042
05.03.2017 08:00,3034,33.7,643,561,2391
05.03.2017 09:00,3025,35.07,680,556,2345
05.03.2017 10:00,2919,34.27,730,563,2189
05.03.2017 11:00,2961,33.73,718,595,2243
05.03.2017 12:00,2896,32.44,803,636,2093
05.03.2017 13:00,2755,31.96,902,668,1853
05.03.2017 14:00,2680,31.81,940,698,1740
05.03.2017 15:00,2699,31.07,945,718,1754
05.03.2017 16:00,2685,30.86,949,731,1736
05.03.2017 17:00,2624,30.77,936,740,1688
05.03.2017 18:00,2673,31.25,902,758,1771
05.03.2017 19:00,2637,31.47,885,744,1752
05.03.2017 20:00,2670,31.51,802,707,1868
05.03.2017 21:00,2726,31.57,732,667,1994
05.03.2017 22:00,2782,31.56,711,665,2071
05.03.2017 23:00,2694,30.52,658,672,2036
05.04.2017 00:00,2461,28.6,731,706,1730
05.04.2017 01:00,2295,28.08,803,762,1492
05.04.2017 02:00,2217,26.26,878,795,1339
05.04.2017 03:00,2204,24.57,938,837,1266
05.04.2017 04:00,2200,24.82,997,877,1203
05.04.2017 05:00,2236,25.8,1039,912,1197
05.04.2017 06:00,2333,27.57,1059,924,1274
05.04.2017 07:00,2715,30.42,1031,937,1684
05.04.2017 08:00,3075,32.28,955,938,2120
05.04.2017 09:00,3172,33.04,936,940,2236
05.04.2017 10:00,3084,32.02,1018,986,2066
05.04.2017 11:00,2918,31.6,1164,1008,1754
05.04.2017 12:00,2852,31.18,1222,1061,1630
05.04.2017 13:00,2777,30.85,1233,1098,1544
05.04.2017 14:00,2761,30.56,1238,1127,1523
05.04.2017 15:00,2786,30.11,1249,1142,1537
05.04.2017 16:00,2811,29.9,1252,1149,1559
05.04.2017 17:00,2758,29.79,1240,1148,1518
05.04.2017 18:00,2734,30.12,1232,1130,1502
05.04.2017 19:00,2701,30.41,1194,1089,1507
05.04.2017 20:00,2685,30.47,1159,1050,1526
05.04.2017 21:00,2661,30.26,1108,1001,1553
05.04.2017 22:00,2643,30.3,1093,969,1550
05.04.2017 23:00,2521,29.72,1069,967,1452
05.05.2017 00:00,2328,26.59,1052,956,1276
05.05.2017 01:00,2314,26.25,1050,1055,1264
05.05.2017 02:00,2229,24.76,1067,1043,1162
05.05.2017 03:00,2256,24.62,1019,1032,1237
05.05.2017 04:00,2306,24.89,1013,1015,1293
05.05.2017 05:00,2325,25.88,985,994,1340
05.05.2017 06:00,2402,29.73,972,946,1430
05.05.2017 07:00,2755,30.59,909,908,1846
05.05.2017 08:00,3169,32.8,805,858,2364
05.05.2017 09:00,3247,33.45,752,794,2495
05.05.2017 10:00,3253,32.42,711,776,2542
05.05.2017 11:00,3143,31.96,741,731,2402
05.05.2017 12:00,3093,31.35,726,714,2367
05.05.2017 13:00,3026,30.98,672,672,2354
05.05.2017 14:00,2938,31,638,629,2300
05.05.2017 15:00,2814,30.71,603,566,2211
05.05.2017 16:00,2771,30.39,552,499,2219
05.05.2017 17:00,2770,30.46,452,443,2318
05.05.2017 18:00,2808,30.98,361,380,2447
05.05.2017 19:00,2846,31.02,228,338,2618
05.05.2017 20:00,2769,30.9,146,272,2623
05.05.2017 21:00,2661,30.45,116,200,2545
05.05.2017 22:00,2657,30.31,90,161,2567
05.05.2017 23:00,2533,30.24,74,139,2459
05.06.2017 00:00,2382,28.87,56,124,2326
05.06.2017 01:00,2278,27.04,34,102,2244
05.06.2017 02:00,2193,26.31,24,80,2169
05.06.2017 03:00,2158,26.27,31,67,2127
05.06.2017 04:00,2151,26.55,41,61,2110
05.06.2017 05:00,2092,26.93,83,64,2009
05.06.2017 06:00,2028,27.86,140,67,1888
05.06.2017 07:00,2060,29.27,133,68,1927
05.06.2017 08:00,2224,30.14,81,53,2143
05.06.2017 09:00,2397,30.93,15,44,2382
05.06.2017 10:00,2470,32,6,40,2464
05.06.2017 11:00,2470,31.53,19,35,2451
05.06.2017 12:00,2373,30.64,60,44,2313
05.06.2017 13:00,2243,30.79,134,59,2109
05.06.2017 14:00,2179,30.1,172,86,2007
05.06.2017 15:00,2145,29.6,187,105,1958
05.06.2017 16:00,2093,28.93,226,125,1867
05.06.2017 17:00,2134,28.93,227,147,1907
05.06.2017 18:00,2225,30.37,216,173,2009
05.06.2017 19:00,2316,31.19,196,210,2120
05.06.2017 20:00,2326,31,181,210,2145
05.06.2017 21:00,2341,30.98,164,202,2177
05.06.2017 22:00,2400,31.72,161,187,2239
05.06.2017 23:00,2331,30.81,174,201,2157
05.07.2017 00:00,2142,30.17,219,234,1923
05.07.2017 01:00,1941,28.31,313,240,1628
05.07.2017 02:00,1912,26.73,305,254,1607
05.07.2017 03:00,1899,26.48,308,264,1591
05.07.2017 04:00,1911,26.17,280,262,1631
05.07.2017 05:00,1944,26.83,264,262,1680
05.07.2017 06:00,1925,26.25,246,249,1679
05.07.2017 07:00,1974,25.43,199,231,1775
05.07.2017 08:00,2063,26.66,188,209,1875
05.07.2017 09:00,2205,28.66,178,198,2027
05.07.2017 10:00,2308,30.06,204,193,2104
05.07.2017 11:00,2383,30.33,204,201,2179
05.07.2017 12:00,2413,30.18,218,208,2195
05.07.2017 13:00,2334,29.5,247,205,2087
05.07.2017 14:00,2277,28.53,256,203,2021
05.07.2017 15:00,2204,27.31,277,200,1927
05.07.2017 16:00,2180,26.88,270,195,1910
05.07.2017 17:00,2197,26.68,262,192,1935
05.07.2017 18:00,2329,27.48,205,181,2124
05.07.2017 19:00,2446,29.8,152,170,2294
05.07.2017 20:00,2526,30.43,105,165,2421
05.07.2017 21:00,2578,31.1,97,171,2481
05.07.2017 22:00,2509,31.24,170,183,2339
05.07.2017 23:00,2314,30.51,224,190,2090
05.08.2017 00:00,2179,27,202,206,1977
05.08.2017 01:00,2121,26.83,194,209,1927
05.08.2017 02:00,2089,25.47,186,214,1903
05.08.2017 03:00,2145,24.96,165,229,1980
05.08.2017 04:00,2187,24.14,175,269,2012
05.08.2017 05:00,2218,24.54,276,330,1942
05.08.2017 06:00,2292,27.24,397,396,1895
05.08.2017 07:00,2699,30.01,469,469,2230
05.08.2017 08:00,3018,30.8,625,558,2393
05.08.2017 09:00,3140,31.5,713,632,2427
05.08.2017 10:00,3101,31.75,825,676,2276
05.08.2017 11:00,3095,31.71,872,700,2223
05.08.2017 12:00,3133,31.4,830,707,2303
05.08.2017 13:00,3229,31.18,724,722,2505
05.08.2017 14:00,3165,31.05,639,709,2526
05.08.2017 15:00,3208,30.9,630,672,2578
05.08.2017 16:00,3234,30.56,560,658,2674
05.08.2017 17:00,3087,30.3,562,633,2525
05.08.2017 18:00,3103,31.12,517,579,2586
05.08.2017 19:00,3079,31.41,440,549,2639
05.08.2017 20:00,2988,32.01,423,487,2565
05.08.2017 21:00,2924,32.83,382,420,2542
05.08.2017 22:00,2959,33.88,285,331,2674
05.08.2017 23:00,2848,32.99,197,271,2651
05.09.2017 00:00,2644,30.97,141,220,2503
05.09.2017 01:00,2478,30.5,125,163,2353
05.09.2017 02:00,2456,29.83,125,136,2331
05.09.2017 03:00,2422,29.24,177,131,2245
05.09.2017 04:00,2428,28.94,202,131,2226
05.09.2017 05:00,2462,29.74,220,138,2242
05.09.2017 06:00,2536,31.04,238,139,2298
05.09.2017 07:00,2887,32.96,180,103,2707
05.09.2017 08:00,3229,39.36,73,85,3156
05.09.2017 09:00,3274,42.99,58,95,3216
05.09.2017 10:00,3142,43.9,100,92,3042
05.09.2017 11:00,3093,42.1,137,105,2956
05.09.2017 12:00,3223,42.11,154,132,3069
05.09.2017 13:00,3143,39.65,193,165,2950
05.09.2017 14:00,3133,38,222,207,2911
05.09.2017 15:00,3137,35.57,213,240,2924
05.09.2017 16:00,3112,35.34,229,265,2883
05.09.2017 17:00,3067,33.34,197,239,2870
05.09.2017 18:00,3039,34.55,204,221,2835
05.09.2017 19:00,3047,34.12,157,183,2890
05.09.2017 20:00,3058,33.86,141,155,2917
05.09.2017 21:00,3053,34.9,103,131,2950
05.09.2017 22:00,3046,35.35,82,119,2964
05.09.2017 23:00,2800,34.15,119,118,2681
05.10.2017 00:00,2587,31.77,160,128,2427
05.10.2017 01:00,2447,31.29,171,142,2276
05.10.2017 02:00,2402,30.62,194,164,2208
05.10.2017 03:00,2381,30.27,187,181,2194
05.10.2017 04:00,2433,30.31,182,191,2251
05.10.2017 05:00,2476,30.77,194,210,2282
05.10.2017 06:00,2592,32.39,232,225,2360
05.10.2017 07:00,3016,37.41,214,250,2802
05.10.2017 08:00,3465,43.39,196,310,3269
05.10.2017 09:00,3550,47.89,221,311,3329
05.10.2017 10:00,3459,42.93,252,317,3207
05.10.2017 11:00,3426,39.16,269,319,3157
05.10.2017 12:00,3368,39.22,286,307,3082
05.10.2017 13:00,3281,36.13,298,308,2983
05.10.2017 14:00,3230,36.12,319,300,2911
05.10.2017 15:00,3211,34.52,311,311,2900
05.10.2017 16:00,3186,34.12,335,313,2851
05.10.2017 17:00,3028,35.01,369,314,2659
05.10.2017 18:00,3035,40.27,397,310,2638
05.10.2017 19:00,3026,41.06,416,320,2610
05.10.2017 20:00,3033,42.64,434,331,2599
05.10.2017 21:00,3007,39.7,411,330,2596
05.10.2017 22:00,3026,39.52,376,322,2650
05.10.2017 23:00,2882,36.91,370,335,2512
05.11.2017 00:00,2672,32.6,347,329,2325
05.11.2017 01:00,2519,31.16,346,337,2173
05.11.2017 02:00,2440,30.41,353,337,2087
05.11.2017 03:00,2402,29.5,376,330,2026
05.11.2017 04:00,2398,29.26,390,331,2008
05.11.2017 05:00,2422,29.59,409,338,2013
05.11.2017 06:00,2510,30.89,409,338,2101
05.11.2017 07:00,2916,34.91,392,352,2524
05.11.2017 08:00,3296,43.1,390,368,2906
05.11.2017 09:00,3365,44.49,406,361,2959
05.11.2017 10:00,3373,41.93,410,376,2963
05.11.2017 11:00,3432,38.54,394,387,3038
05.11.2017 12:00,3431,37.47,387,393,3044
05.11.2017 13:00,3360,36.03,378,385,2982
05.11.2017 14:00,3326,35.23,354,372,2972
05.11.2017 15:00,3293,33.44,324,358,2969
05.11.2017 16:00,3299,33.82,290,345,3009
05.11.2017 17:00,3238,33.19,273,357,2965
05.11.2017 18:00,3212,34.8,283,335,2929
05.11.2017 19:00,3127,35.75,293,310,2834
05.11.2017 20:00,3114,34.94,285,323,2829
05.11.2017 21:00,3073,32.98,264,343,2809
05.11.2017 22:00,3054,31.64,276,360,2778
05.11.2017 23:00,2887,30.52,306,379,2581
05.12.2017 00:00,2668,28.76,339,401,2329
05.12.2017 01:00,2505,29.88,358,373,2147
05.12.2017 02:00,2468,27.99,355,393,2113
05.12.2017 03:00,2460,27.46,372,413,2088
05.12.2017 04:00,2479,27.27,407,438,2072
05.12.2017 05:00,2449,27.09,475,457,1974
05.12.2017 06:00,2493,29.96,516,467,1977
05.12.2017 07:00,2877,33.1,501,471,2376
05.12.2017 08:00,3153,36.38,522,473,2631
05.12.2017 09:00,3208,41.16,557,494,2651
05.12.2017 10:00,3110,36.38,617,522,2493
05.12.2017 11:00,3047,34.96,698,561,2349
05.12.2017 12:00,2969,35.03,735,603,2234
05.12.2017 13:00,2909,35.16,736,617,2173
05.12.2017 14:00,2818,31.62,749,635,2069
05.12.2017 15:00,2724,30.86,745,656,1979
05.12.2017 16:00,2689,30.45,732,683,1957
05.12.2017 17:00,2665,30.51,726,706,1939
05.12.2017 18:00,2658,31.21,739,709,1919
05.12.2017 19:00,2625,31.43,746,717,1879
05.12.2017 20:00,2559,31.45,737,715,1822
05.12.2017 21:00,2531,31.3,710,714,1821
05.12.2017 22:00,2513,31.31,744,730,1769
05.12.2017 23:00,2424,30.8,811,754,1613
13.05.2017 00:00,2248,30.2,872,763,1376
13.05.2017 01:00,2085,29.42,905,752,1180
13.05.2017 02:00,2008,28.95,899,734,1109
13.05.2017 03:00,1956,28.72,897,709,1059
13.05.2017 04:00,1974,28.52,858,676,1116
13.05.2017 05:00,1963,28.12,830,647,1133
13.05.2017 06:00,1960,28.73,765,600,1195
13.05.2017 07:00,2103,29.05,614,543,1489
13.05.2017 08:00,2335,30.17,456,495,1879
13.05.2017 09:00,2536,32.21,365,452,2171
13.05.2017 10:00,2638,33.28,333,432,2305
13.05.2017 11:00,2602,31.97,345,418,2257
13.05.2017 12:00,2494,31.04,376,401,2118
13.05.2017 13:00,2421,30.28,395,404,2026
13.05.2017 14:00,2314,29.14,404,397,1910
13.05.2017 15:00,2279,28.44,384,394,1895
13.05.2017 16:00,2273,28.48,343,381,1930
13.05.2017 17:00,2285,28.88,320,376,1965
13.05.2017 18:00,2320,29.9,311,362,2009
13.05.2017 19:00,2414,32.2,267,353,2147
13.05.2017 20:00,2424,32.42,254,366,2170
13.05.2017 21:00,2395,31.85,260,370,2135
13.05.2017 22:00,2392,31.66,294,377,2098
13.05.2017 23:00,2300,31.4,347,387,1953
14.05.2017 00:00,2196,30.34,371,398,1825
14.05.2017 01:00,2045,27.66,390,399,1655
14.05.2017 02:00,1967,26.54,376,383,1591
14.05.2017 03:00,1952,25.65,331,363,1621
14.05.2017 04:00,1965,25.63,290,343,1675
14.05.2017 05:00,1952,25.82,281,317,1671
14.05.2017 06:00,1890,25.83,263,273,1627
14.05.2017 07:00,1896,26.41,238,221,1658
14.05.2017 08:00,2001,27.11,191,183,1810
14.05.2017 09:00,2140,27.99,137,134,2003
14.05.2017 10:00,2297,29.11,75,111,2222
14.05.2017 11:00,2361,29.41,47,92,2314
14.05.2017 12:00,2394,29.25,31,87,2363
14.05.2017 13:00,2384,29.1,24,96,2360
14.05.2017 14:00,2335,28.42,43,95,2292
14.05.2017 15:00,2274,27.97,48,113,2226
14.05.2017 16:00,2246,28.06,62,119,2184
14.05.2017 17:00,2250,28.78,71,129,2179
14.05.2017 18:00,2300,29.46,92,133,2208
14.05.2017 19:00,2346,30.65,111,129,2235
14.05.2017 20:00,2365,31.63,95,136,2270
14.05.2017 21:00,2366,31.99,93,124,2273
14.05.2017 22:00,2370,31.94,115,136,2255
14.05.2017 23:00,2264,31.45,142,145,2122
15.05.2017 00:00,2132,30.37,140,160,1992
15.05.2017 01:00,1977,29.59,154,167,1823
15.05.2017 02:00,1917,27.43,178,175,1739
15.05.2017 03:00,1888,27.18,202,175,1686
15.05.2017 04:00,1907,26.7,212,180,1695
15.05.2017 05:00,1951,27.16,182,184,1769
15.05.2017 06:00,2057,29.77,171,162,1886
15.05.2017 07:00,2436,32.99,138,135,2298
15.05.2017 08:00,2861,35.46,62,110,2799
15.05.2017 09:00,2975,40.05,34,102,2941
15.05.2017 10:00,2942,40.03,53,97,2889
15.05.2017 11:00,2973,36.8,66,97,2907
15.05.2017 12:00,2955,36.37,84,111,2871
15.05.2017 13:00,2873,34.81,123,124,2750
15.05.2017 14:00,2815,34.2,159,137,2656
15.05.2017 15:00,2797,32.68,191,160,2606
15.05.2017 16:00,2814,32.18,219,189,2595
15.05.2017 17:00,2755,32.35,226,207,2529
15.05.2017 18:00,2752,36.84,200,205,2552
15.05.2017 19:00,2694,40.14,171,191,2523
15.05.2017 20:00,2637,38.91,172,183,2465
15.05.2017 21:00,2570,33.02,142,161,2428
15.05.2017 22:00,2560,32.94,133,145,2427
15.05.2017 23:00,2459,31.79,119,138,2340
16.05.2017 00:00,2275,30.25,117,130,2158
16.05.2017 01:00,2084,29.03,89,105,1995
16.05.2017 02:00,2046,28.01,57,90,1989
16.05.2017 03:00,2006,27.35,52,90,1954
16.05.2017 04:00,2014,27.18,51,90,1963
16.05.2017 05:00,2039,27.03,64,96,1975
16.05.2017 06:00,2100,28.18,82,104,2018
16.05.2017 07:00,2485,31.04,75,109,2410
16.05.2017 08:00,2890,39,51,109,2839
16.05.2017 09:00,2982,42.37,44,99,2938
16.05.2017 10:00,2969,39.37,47,103,2922
16.05.2017 11:00,2994,35.78,47,105,2947
16.05.2017 12:00,2964,34.85,75,121,2889
16.05.2017 13:00,2883,32.66,108,131,2775
16.05.2017 14:00,2894,31.11,141,164,2753
16.05.2017 15:00,2835,30.83,192,184,2643
16.05.2017 16:00,2812,30.63,227,197,2585
16.05.2017 17:00,2717,30.39,252,213,2465
16.05.2017 18:00,2734,30.8,276,231,2458
16.05.2017 19:00,2758,30.9,266,259,2492
16.05.2017 20:00,2707,30.78,267,285,2440
16.05.2017 21:00,2657,30.2,297,327,2360
16.05.2017 22:00,2641,29.65,311,368,2330
16.05.2017 23:00,2557,29.04,309,390,2248
17.05.2017 00:00,2346,27.03,315,397,2031
17.05.2017 01:00,2187,25.01,347,405,1840
17.05.2017 02:00,2119,24.43,346,395,1773
17.05.2017 03:00,2074,24.26,350,379,1724
17.05.2017 04:00,2078,24.33,342,366,1736
17.05.2017 05:00,2097,24.8,341,354,1756
17.05.2017 06:00,2090,25.24,393,342,1697
17.05.2017 07:00,2417,27.94,423,324,1994
17.05.2017 08:00,2782,33.51,405,308,2377
17.05.2017 09:00,2914,36,368,299,2546
17.05.2017 10:00,2907,34.62,325,269,2582
17.05.2017 11:00,2932,33.53,290,263,2642
17.05.2017 12:00,2929,32.94,247,236,2682
17.05.2017 13:00,2899,32.41,187,220,2712
17.05.2017 14:00,2924,32.74,139,204,2785
17.05.2017 15:00,2854,29.85,131,187,2723
17.05.2017 16:00,2811,28.91,120,169,2691
17.05.2017 17:00,2746,29.48,111,151,2635
17.05.2017 18:00,2741,33.94,97,138,2644
17.05.2017 19:00,2717,37.25,73,135,2644
17.05.2017 20:00,2681,36.18,54,146,2627
17.05.2017 21:00,2608,32.47,69,148,2539
17.05.2017 22:00,2471,31.79,178,180,2293
17.05.2017 23:00,2294,28.04,257,220,2037
18.05.2017 00:00,2059,26.68,293,247,1766
18.05.2017 01:00,1935,25.41,363,329,1572
18.05.2017 02:00,1795,23.72,470,364,1325
18.05.2017 03:00,1741,22.43,534,384,1207
18.05.2017 04:00,1705,20.68,592,405,1113
18.05.2017 05:00,1717,22.63,606,417,1111
18.05.2017 06:00,1795,24.61,616,436,1179
18.05.2017 07:00,2178,26.93,558,418,1620
18.05.2017 08:00,2652,31.03,420,399,2232
18.05.2017 09:00,2772,32.41,372,395,2400
18.05.2017 10:00,2710,30.38,466,415,2244
18.05.2017 11:00,2740,29.56,568,483,2172
18.05.2017 12:00,2788,30.65,638,577,2150
18.05.2017 13:00,2707,29.7,725,651,1982
18.05.2017 14:00,2729,29.27,761,709,1968
18.05.2017 15:00,2703,29.12,775,734,1928
18.05.2017 16:00,2658,28.97,830,745,1828
18.05.2017 17:00,2615,29.03,815,740,1800
18.05.2017 18:00,2655,31.6,739,704,1916
18.05.2017 19:00,2669,31.95,617,650,2052
18.05.2017 20:00,2724,31.03,458,577,2266
18.05.2017 21:00,2685,28.38,361,512,2324
18.05.2017 22:00,2598,28.08,355,452,2243
18.05.2017 23:00,2387,27.7,373,400,2014
19.05.2017 00:00,2231,26.81,287,373,1944
19.05.2017 01:00,1994,25.66,254,271,1740
19.05.2017 02:00,1903,25.01,250,245,1653
19.05.2017 03:00,1903,24.71,239,224,1664
19.05.2017 04:00,1879,25,245,215,1634
19.05.2017 05:00,1893,25.13,211,206,1682
19.05.2017 06:00,1955,26.72,203,188,1752
19.05.2017 07:00,2295,30.38,160,155,2135
19.05.2017 08:00,2722,38.96,85,127,2637
19.05.2017 09:00,2847,41.55,25,110,2822
19.05.2017 10:00,2858,39.9,35,107,2823
19.05.2017 11:00,2894,38.95,57,109,2837
19.05.2017 12:00,2883,39.8,62,118,2821
19.05.2017 13:00,2837,37.72,77,132,2760
19.05.2017 14:00,2785,36.38,98,132,2687
19.05.2017 15:00,2672,34.21,96,147,2576
19.05.2017 16:00,2585,33.76,105,139,2480
19.05.2017 17:00,2509,30.31,109,137,2400
19.05.2017 18:00,2520,35.14,97,122,2423
19.05.2017 19:00,2425,37.04,103,123,2322
19.05.2017 20:00,2329,33.82,117,122,2212
19.05.2017 21:00,2207,30.13,144,132,2063
19.05.2017 22:00,2141,28.64,176,148,1965
19.05.2017 23:00,2106,26.97,224,178,1882
20.05.2017 00:00,1938,25.06,264,202,1674
20.05.2017 01:00,1847,23.44,271,272,1576
20.05.2017 02:00,1760,23.04,284,282,1476
20.05.2017 03:00,1689,22.18,291,280,1398
20.05.2017 04:00,1662,20.94,289,278,1373
20.05.2017 05:00,1626,20.84,297,266,1329
20.05.2017 06:00,1618,22.57,249,234,1369
20.05.2017 07:00,1718,23.26,195,190,1523
20.05.2017 08:00,1904,23.78,112,146,1792
20.05.2017 09:00,2089,24.93,104,117,1985
20.05.2017 10:00,2140,25.04,166,115,1974
20.05.2017 11:00,2066,24.25,281,165,1785
20.05.2017 12:00,2037,24.11,390,227,1647
20.05.2017 13:00,2051,23.83,444,283,1607
20.05.2017 14:00,2057,22.83,489,355,1568
20.05.2017 15:00,2004,21.97,545,426,1459
20.05.2017 16:00,1966,22.27,587,455,1379
20.05.2017 17:00,1963,23.87,666,519,1297
20.05.2017 18:00,1991,25.03,706,548,1285
20.05.2017 19:00,2065,27.37,677,548,1388
20.05.2017 20:00,2137,27.17,546,528,1591
20.05.2017 21:00,2185,25.66,392,493,1793
20.05.2017 22:00,2251,26.49,286,441,1965
20.05.2017 23:00,2221,26.31,266,392,1955
21.05.2017 00:00,2046,25.19,301,366,1745
21.05.2017 01:00,1875,23.09,340,378,1535
21.05.2017 02:00,1767,18.12,358,377,1409
21.05.2017 03:00,1730,14.12,362,379,1368
21.05.2017 04:00,1742,12.18,342,374,1400
21.05.2017 05:00,1696,11.65,344,366,1352
21.05.2017 06:00,1625,11.52,353,344,1272
21.05.2017 07:00,1743,11.98,263,331,1480
21.05.2017 08:00,1859,12.36,221,312,1638
21.05.2017 09:00,1967,14.04,249,308,1718
21.05.2017 10:00,2008,18.79,326,295,1682
21.05.2017 11:00,2046,20.66,354,313,1692
21.05.2017 12:00,2105,20.8,393,358,1712
21.05.2017 13:00,2034,18.92,454,376,1580
21.05.2017 14:00,2005,17.88,489,389,1516
21.05.2017 15:00,1968,16.14,486,392,1482
21.05.2017 16:00,1927,17.19,487,369,1440
21.05.2017 17:00,1997,18.84,461,379,1536
21.05.2017 18:00,2032,23.05,424,349,1608
21.05.2017 19:00,2107,24.42,379,316,1728
21.05.2017 20:00,2166,25.81,302,272,1864
21.05.2017 21:00,2197,25.15,234,238,1963
21.05.2017 22:00,2135,25.39,253,218,1882
21.05.2017 23:00,2066,24.77,322,221,1744
22.05.2017 00:00,1988,23.95,316,232,1672
22.05.2017 01:00,1872,23.36,308,253,1564
22.05.2017 02:00,1806,23.14,317,251,1489
22.05.2017 03:00,1761,22.97,342,241,1419
22.05.2017 04:00,1766,22.87,339,226,1427
22.05.2017 05:00,1786,23.08,295,214,1491
22.05.2017 06:00,1932,24.49,229,196,1703
22.05.2017 07:00,2315,29.19,151,166,2164
22.05.2017 08:00,2687,39.04,98,138,2589
22.05.2017 09:00,2735,41.19,103,130,2632
22.05.2017 10:00,2696,38.82,151,145,2545
22.05.2017 11:00,2744,37.02,175,163,2569
22.05.2017 12:00,2769,36.99,191,189,2578
22.05.2017 13:00,2735,36.96,220,206,2515
22.05.2017 14:00,2751,37.91,222,222,2529
22.05.2017 15:00,2751,36.93,223,241,2528
22.05.2017 16:00,2746,36.94,235,249,2511
22.05.2017 17:00,2639,36.06,241,266,2398
22.05.2017 18:00,2663,37.78,223,259,2440
22.05.2017 19:00,2590,39.12,184,239,2406
22.05.2017 20:00,2556,40.17,147,210,2409
22.05.2017 21:00,2499,28.74,130,182,2369
22.05.2017 22:00,2455,40.22,152,169,2303
22.05.2017 23:00,2375,26.83,189,170,2186
23.05.2017 00:00,2176,24.22,190,176,1986
23.05.2017 01:00,1997,24.07,188,157,1809
23.05.2017 02:00,1971,23.34,161,150,1810
23.05.2017 03:00,1991,23.07,143,143,1848
23.05.2017 04:00,2004,23.01,135,140,1869
23.05.2017 05:00,1984,23.28,129,137,1855
23.05.2017 06:00,2044,24.26,129,121,1915
23.05.2017 07:00,2403,28.28,96,99,2307
23.05.2017 08:00,2740,41.02,66,76,2674
23.05.2017 09:00,2826,41.4,52,68,2774
23.05.2017 10:00,2818,41.89,62,79,2756
23.05.2017 11:00,2866,38.05,81,92,2785
23.05.2017 12:00,2802,36.94,109,113,2693
23.05.2017 13:00,2783,33.97,113,125,2670
23.05.2017 14:00,2799,30.5,118,132,2681
23.05.2017 15:00,2780,31.01,127,138,2653
23.05.2017 16:00,2746,29.1,116,129,2630
23.05.2017 17:00,2680,29.06,94,118,2586
23.05.2017 18:00,2678,31.84,77,108,2601
23.05.2017 19:00,2610,33.75,68,104,2542
23.05.2017 20:00,2539,37.11,84,101,2455
23.05.2017 21:00,2472,34.78,83,103,2389
23.05.2017 22:00,2420,34.16,101,107,2319
23.05.2017 23:00,2324,27.31,133,122,2191
24.05.2017 00:00,2112,24.99,165,138,1947
24.05.2017 01:00,1868,22.64,217,103,1651
24.05.2017 02:00,1793,21.22,254,108,1539
24.05.2017 03:00,1812,19.61,204,120,1608
24.05.2017 04:00,1902,19.64,146,147,1756
24.05.2017 05:00,1924,20.92,137,154,1787
24.05.2017 06:00,1982,23.22,170,147,1812
24.05.2017 07:00,2346,25.93,158,145,2188
24.05.2017 08:00,2801,33.64,122,152,2679
24.05.2017 09:00,2919,36.65,134,155,2785
24.05.2017 10:00,2892,34.13,166,157,2726
24.05.2017 11:00,2952,31.21,173,171,2779
24.05.2017 12:00,2994,32.35,156,186,2838
24.05.2017 13:00,2980,29.36,120,188,2860
24.05.2017 14:00,2903,28.11,154,208,2749
24.05.2017 15:00,2876,27.64,167,217,2709
24.05.2017 16:00,2863,26.25,157,219,2706
24.05.2017 17:00,2730,26.37,192,241,2538
24.05.2017 18:00,2707,27.83,198,254,2509
24.05.2017 19:00,2588,27.81,236,257,2352
24.05.2017 20:00,2550,32.64,265,273,2285
24.05.2017 21:00,2503,25.96,257,284,2246
24.05.2017 22:00,2398,26.69,348,305,2050
24.05.2017 23:00,2278,26.83,400,310,1878
25.05.2017 00:00,2085,25.18,440,320,1645
25.05.2017 01:00,1901,24.37,429,298,1472
25.05.2017 02:00,1850,23.84,386,296,1464
25.05.2017 03:00,1847,23.57,332,290,1515
25.05.2017 04:00,1854,23.4,301,269,1553
25.05.2017 05:00,1828,22.94,255,250,1573
25.05.2017 06:00,1814,24.09,217,227,1597
25.05.2017 07:00,1936,24.13,155,200,1781
25.05.2017 08:00,2086,24.93,114,184,1972
25.05.2017 09:00,2245,25.85,117,187,2128
25.05.2017 10:00,2320,25.79,134,196,2186
25.05.2017 11:00,2313,25.59,174,223,2139
25.05.2017 12:00,2317,26.02,254,272,2063
25.05.2017 13:00,2294,25.16,313,328,1981
25.05.2017 14:00,2227,23.13,393,387,1834
25.05.2017 15:00,2139,22.72,461,428,1678
25.05.2017 16:00,2174,22.64,491,464,1683
25.05.2017 17:00,2174,23.48,506,494,1668
25.05.2017 18:00,2202,25.71,534,488,1668
25.05.2017 19:00,2166,26.26,556,451,1610
25.05.2017 20:00,2200,27.12,414,394,1786
25.05.2017 21:00,2244,26.31,268,356,1976
25.05.2017 22:00,2234,27.91,253,320,1981
25.05.2017 23:00,2144,26.35,279,280,1865
26.05.2017 00:00,1949,25.31,320,268,1629
26.05.2017 01:00,1816,24.07,338,268,1478
26.05.2017 02:00,1694,23.69,401,278,1293
26.05.2017 03:00,1710,23.48,370,276,1340
26.05.2017 04:00,1698,22.94,346,263,1352
26.05.2017 05:00,1620,23.69,398,248,1222
26.05.2017 06:00,1641,25,369,216,1272
26.05.2017 07:00,2007,27.36,213,181,1794
26.05.2017 08:00,2295,33.97,124,145,2171
26.05.2017 09:00,2479,37.38,111,130,2368
26.05.2017 10:00,2503,35.6,138,121,2365
26.05.2017 11:00,2549,34,136,125,2413
26.05.2017 12:00,2554,33.08,137,143,2417
26.05.2017 13:00,2516,30.86,150,142,2366
26.05.2017 14:00,2458,28.32,166,168,2292
26.05.2017 15:00,2387,27.12,204,179,2183
26.05.2017 16:00,2318,27.53,247,179,2071
26.05.2017 17:00,2274,28.63,247,184,2027
26.05.2017 18:00,2349,32.05,231,182,2118
26.05.2017 19:00,2336,33.95,173,169,2163
26.05.2017 20:00,2315,33.16,100,152,2215
26.05.2017 21:00,2221,29.12,80,118,2141
26.05.2017 22:00,2148,29.34,99,104,2049
26.05.2017 23:00,2156,28.67,106,108,2050
27.05.2017 00:00,2030,26.72,128,113,1902
27.05.2017 01:00,1895,25.61,146,143,1749
27.05.2017 02:00,1780,24.69,202,151,1578
27.05.2017 03:00,1665,24.3,281,161,1384
27.05.2017 04:00,1684,24.05,295,174,1389
27.05.2017 05:00,1621,23.79,306,185,1315
27.05.2017 06:00,1592,23.62,314,181,1278
27.05.2017 07:00,1684,24.72,264,171,1420
27.05.2017 08:00,1871,27.24,172,145,1699
27.05.2017 09:00,2057,29.4,151,141,1906
27.05.2017 10:00,2136,28.75,205,170,1931
27.05.2017 11:00,2123,26.1,267,198,1856
27.05.2017 12:00,2083,25.29,332,244,1751
27.05.2017 13:00,2088,24.39,376,287,1712
27.05.2017 14:00,2069,24.32,393,314,1676
27.05.2017 15:00,2052,24.08,349,314,1703
27.05.2017 16:00,2156,23.89,269,330,1887
27.05.2017 17:00,2176,24.26,237,321,1939
27.05.2017 18:00,2208,26.26,229,276,1979
27.05.2017 19:00,2237,28.33,205,269,2032
27.05.2017 20:00,2219,28.22,189,249,2030
27.05.2017 21:00,2172,27.23,206,254,1966
27.05.2017 22:00,2075,26.24,320,269,1755
27.05.2017 23:00,2013,25.35,445,316,1568
28.05.2017 00:00,1863,24.08,516,371,1347
28.05.2017 01:00,1678,21.25,577,425,1101
28.05.2017 02:00,1558,16.08,578,458,980
28.05.2017 03:00,1460,18.66,641,476,819
28.05.2017 04:00,1423,16.58,689,491,734
28.05.2017 05:00,1422,14.25,655,513,767
28.05.2017 06:00,1429,9.91,585,491,844
28.05.2017 07:00,1576,14.36,460,452,1116
28.05.2017 08:00,1787,18.27,322,399,1465
28.05.2017 09:00,1933,19.04,306,393,1627
28.05.2017 10:00,2002,22.82,400,438,1602
28.05.2017 11:00,2005,23.56,564,511,1441
28.05.2017 12:00,1925,23.39,729,586,1196
28.05.2017 13:00,2043,22.77,682,626,1361
28.05.2017 14:00,2215,22.45,565,654,1650
28.05.2017 15:00,2288,21.91,487,678,1801
28.05.2017 16:00,2271,21.73,487,682,1784
28.05.2017 17:00,2242,22.53,487,664,1755
28.05.2017 18:00,2176,23.83,606,673,1570
28.05.2017 19:00,2140,25.5,697,692,1443
28.05.2017 20:00,2144,25.9,732,709,1412
28.05.2017 21:00,2169,26,703,732,1466
28.05.2017 22:00,2150,25.82,683,712,1467
28.05.2017 23:00,2074,25.11,696,683,1378
29.05.2017 00:00,1948,24.06,666,661,1282
29.05.2017 01:00,1860,22.27,629,655,1231
29.05.2017 02:00,1798,21.4,647,615,1151
29.05.2017 03:00,1745,21.43,606,552,1139
29.05.2017 04:00,1715,22.03,540,475,1175
29.05.2017 05:00,1736,22.69,447,418,1289
29.05.2017 06:00,1857,24.82,351,366,1506
29.05.2017 07:00,2229,33.93,282,312,1947
29.05.2017 08:00,2533,41.67,273,259,2260
29.05.2017 09:00,2673,43.06,247,208,2426
29.05.2017 10:00,2692,42.71,186,166,2506
29.05.2017 11:00,2830,41.82,97,136,2733
29.05.2017 12:00,2873,41.32,47,108,2826
29.05.2017 13:00,2846,38.93,27,93,2819
29.05.2017 14:00,2876,38.33,25,84,2851
29.05.2017 15:00,2886,35.58,31,90,2855
29.05.2017 16:00,2905,36.32,27,99,2878
29.05.2017 17:00,2827,37,22,113,2805
29.05.2017 18:00,2832,41.16,21,113,2811
29.05.2017 19:00,2742,43.02,30,110,2712
29.05.2017 20:00,2663,42.32,36,115,2627
29.05.2017 21:00,2587,40.09,35,109,2552
29.05.2017 22:00,2520,40.05,37,105,2483
29.05.2017 23:00,2397,33.31,37,100,2360
30.05.2017 00:00,2220,28.23,34,96,2186
30.05.2017 01:00,2059,27.28,30,95,2029
30.05.2017 02:00,2009,26.54,30,90,1979
30.05.2017 03:00,1980,26.37,34,86,1946
30.05.2017 04:00,1963,26.29,34,84,1929
30.05.2017 05:00,1950,26.43,40,89,1910
30.05.2017 06:00,2013,30.54,39,99,1974
30.05.2017 07:00,2316,38.05,68,112,2248
30.05.2017 08:00,2663,49.6,111,129,2552
30.05.2017 09:00,2831,52.23,127,150,2704
30.05.2017 10:00,2816,50.08,188,174,2628
30.05.2017 11:00,2818,46.13,307,213,2511
30.05.2017 12:00,2910,44.32,253,243,2657
30.05.2017 13:00,2928,44.82,230,272,2698
30.05.2017 14:00,2888,43.1,281,289,2607
30.05.2017 15:00,2915,39.07,232,302,2683
30.05.2017 16:00,2884,34.03,257,286,2627
30.05.2017 17:00,2811,33.06,273,282,2538
30.05.2017 18:00,2760,35.1,291,291,2469
30.05.2017 19:00,2654,39.91,363,310,2291
30.05.2017 20:00,2574,40.95,440,324,2134
30.05.2017 21:00,2585,38.35,400,353,2185
30.05.2017 22:00,2582,36.83,373,417,2209
30.05.2017 23:00,2409,31.51,447,465,1962
31.05.2017 00:00,2245,26.14,452,535,1793
31.05.2017 01:00,1922,24.62,578,538,1344
31.05.2017 02:00,1836,23.87,719,610,1117
31.05.2017 03:00,1842,23.56,747,652,1095
31.05.2017 04:00,1873,22.58,737,701,1136
31.05.2017 05:00,1862,22.53,771,727,1091
31.05.2017 06:00,1886,23.98,939,803,947
31.05.2017 07:00,2129,26.45,1120,903,1009
31.05.2017 08:00,2521,36.78,1206,999,1315
31.05.2017 09:00,2736,38.59,1215,1105,1521
31.05.2017 10:00,2787,34.29,1258,1176,1529
31.05.2017 11:00,2871,30.08,1279,1225,1592
31.05.2017 12:00,2900,28.9,1304,1253,1596
31.05.2017 13:00,2909,29.04,1288,1274,1621
31.05.2017 14:00,2891,28.01,1274,1285,1617
31.05.2017 15:00,2844,26.52,1253,1280,1591
31.05.2017 16:00,2828,26.16,1253,1273,1575
31.05.2017 17:00,2710,25.93,1228,1245,1482
31.05.2017 18:00,2662,26.07,1249,1221,1413
31.05.2017 19:00,2608,26.58,1215,1211,1393
31.05.2017 20:00,2567,26.43,1148,1147,1419
31.05.2017 21:00,2460,25.93,1131,1087,1329
31.05.2017 22:00,2368,26.2,1125,1017,1243
31.05.2017 23:00,2292,26.1,1072,985,1220
06.01.2017 00:00,2067,25.27,1044,924,1023
06.01.2017 01:00,1931,21.97,1043,956,888
06.01.2017 02:00,1845,21.23,1014,908,831
06.01.2017 03:00,1870,20.64,922,863,948
06.01.2017 04:00,1909,20.69,814,809,1095
06.01.2017 05:00,1927,21.84,724,743,1203
06.01.2017 06:00,2018,23.69,669,674,1349
06.01.2017 07:00,2390,26.83,578,607,1812
06.01.2017 08:00,2716,37.39,501,560,2215
06.01.2017 09:00,2897,40.08,400,509,2497
06.01.2017 10:00,2877,38.03,349,462,2528
06.01.2017 11:00,2869,33.24,360,437,2509
06.01.2017 12:00,2801,33,428,440,2373
06.01.2017 13:00,2622,31.01,565,462,2057
06.01.2017 14:00,2554,31.86,658,497,1896
06.01.2017 15:00,2503,31.34,717,534,1786
06.01.2017 16:00,2518,34.08,702,569,1816
06.01.2017 17:00,2392,34.11,765,584,1627
06.01.2017 18:00,2345,36.67,765,564,1580
06.01.2017 19:00,2277,38.38,713,523,1564
06.01.2017 20:00,2346,42.04,552,462,1794
06.01.2017 21:00,2396,33.8,388,384,2008
06.01.2017 22:00,2385,33.12,299,353,2086
06.01.2017 23:00,2348,31.81,286,324,2062
06.02.2017 00:00,2137,26.41,305,315,1832
06.02.2017 01:00,1973,26.38,382,320,1591
06.02.2017 02:00,1816,25.83,489,333,1327
06.02.2017 03:00,1718,24.99,533,321,1185
06.02.2017 04:00,1753,24.59,493,317,1260
06.02.2017 05:00,1770,24.34,391,293,1379
06.02.2017 06:00,1955,26.14,292,253,1663
06.02.2017 07:00,2329,35.33,197,221,2132
06.02.2017 08:00,2692,40.24,123,194,2569
06.02.2017 09:00,2794,41.5,102,167,2692
06.02.2017 10:00,2783,39.96,81,133,2702
06.02.2017 11:00,2798,38.67,60,113,2738
06.02.2017 12:00,2770,38.83,67,103,2703
06.02.2017 13:00,2665,38.25,83,100,2582
06.02.2017 14:00,2579,35.95,84,100,2495
06.02.2017 15:00,2514,34.45,77,94,2437
06.02.2017 16:00,2471,34.82,66,88,2405
06.02.2017 17:00,2434,35.96,57,86,2377
06.02.2017 18:00,2411,39.7,56,79,2355
06.02.2017 19:00,2295,42.78,75,72,2220
06.02.2017 20:00,2253,43.82,58,65,2195
06.02.2017 21:00,2179,36.86,60,64,2119
06.02.2017 22:00,2106,36.84,92,70,2014
06.02.2017 23:00,2033,39.18,144,80,1889
06.03.2017 00:00,1929,33.53,168,105,1761
06.03.2017 01:00,1853,30.03,193,170,1660
06.03.2017 02:00,1791,30.02,205,195,1586
06.03.2017 03:00,1746,28.05,232,200,1514
06.03.2017 04:00,1734,26.41,240,204,1494
06.03.2017 05:00,1655,25.86,252,202,1403
06.03.2017 06:00,1615,25,250,193,1365
06.03.2017 07:00,1672,25.28,235,180,1437
06.03.2017 08:00,1797,26.03,224,173,1573
06.03.2017 09:00,1973,26.33,209,179,1764
06.03.2017 10:00,2109,28.57,205,192,1904
06.03.2017 11:00,2138,28.31,237,207,1901
06.03.2017 12:00,2156,27.03,250,225,1906
06.03.2017 13:00,2137,26.49,260,233,1877
06.03.2017 14:00,2093,26.93,287,250,1806
06.03.2017 15:00,2041,26.71,292,256,1749
06.03.2017 16:00,2046,26.97,266,252,1780
06.03.2017 17:00,2070,27.61,233,248,1837
06.03.2017 18:00,2146,28.66,184,249,1962
06.03.2017 19:00,2128,29.54,166,233,1962
06.03.2017 20:00,2119,28.85,154,223,1965
06.03.2017 21:00,2066,27.55,150,218,1916
06.03.2017 22:00,1997,27.18,204,226,1793
06.03.2017 23:00,1929,27.38,296,240,1633
06.04.2017 00:00,1804,26.16,303,248,1501
06.04.2017 01:00,1703,26.31,285,219,1418
06.04.2017 02:00,1670,25.17,242,206,1428
06.04.2017 03:00,1642,23.77,218,195,1424
06.04.2017 04:00,1612,22.88,234,188,1378
06.04.2017 05:00,1539,21.58,216,178,1323
06.04.2017 06:00,1534,19.98,189,157,1345
06.04.2017 07:00,1591,20.33,140,132,1451
06.04.2017 08:00,1699,22.93,82,107,1617
06.04.2017 09:00,1849,24.13,44,96,1805
06.04.2017 10:00,1987,24.99,44,89,1943
06.04.2017 11:00,2054,26.03,57,91,1997
06.04.2017 12:00,2102,25.85,58,90,2044
06.04.2017 13:00,2148,26.1,59,87,2089
06.04.2017 14:00,2148,24.86,63,86,2085
06.04.2017 15:00,2139,24.58,58,87,2081
06.04.2017 16:00,2154,24.13,65,86,2089
06.04.2017 17:00,2197,24.44,59,102,2138
06.04.2017 18:00,2279,24.94,54,122,2225
06.04.2017 19:00,2304,25.76,55,137,2249
06.04.2017 20:00,2275,27,102,171,2173
06.04.2017 21:00,2134,26.44,236,221,1898
06.04.2017 22:00,2075,26.48,276,277,1799
06.04.2017 23:00,2135,30.59,283,338,1852
06.05.2017 00:00,1986,26.32,363,387,1623
06.05.2017 01:00,1802,24.74,464,404,1338
06.05.2017 02:00,1697,23.93,564,471,1133
06.05.2017 03:00,1674,22.53,607,525,1067
06.05.2017 04:00,1710,21.68,633,569,1077
06.05.2017 05:00,1682,21.65,654,587,1028
06.05.2017 06:00,1736,23.09,657,595,1079
06.05.2017 07:00,2025,24.1,646,610,1379
06.05.2017 08:00,2266,24.62,692,614,1574
06.05.2017 09:00,2362,27.02,752,614,1610
06.05.2017 10:00,2473,26.52,735,624,1738
06.05.2017 11:00,2503,24.95,705,613,1798
06.05.2017 12:00,2489,25.31,702,613,1787
06.05.2017 13:00,2450,24.52,725,617,1725
06.05.2017 14:00,2470,24.11,691,623,1779
06.05.2017 15:00,2445,24.07,656,612,1789
06.05.2017 16:00,2399,24.69,645,619,1754
06.05.2017 17:00,2358,26,643,606,1715
06.05.2017 18:00,2393,26.9,620,557,1773
06.05.2017 19:00,2366,30.22,526,510,1840
06.05.2017 20:00,2367,31.1,386,439,1981
06.05.2017 21:00,2297,27.13,315,390,1982
06.05.2017 22:00,2182,26.76,342,355,1840
06.05.2017 23:00,2107,27.31,378,341,1729
06.06.2017 00:00,1963,26.1,457,351,1506
06.06.2017 01:00,1840,24.22,454,366,1386
06.06.2017 02:00,1750,19.94,451,380,1299
06.06.2017 03:00,1691,14.97,492,381,1199
06.06.2017 04:00,1619,10.8,528,370,1091
06.06.2017 05:00,1531,10.22,531,359,1000
06.06.2017 06:00,1524,17.7,519,361,1005
06.06.2017 07:00,1752,24.62,360,317,1392
06.06.2017 08:00,1978,26.47,258,275,1720
06.06.2017 09:00,2133,27.37,315,314,1818
06.06.2017 10:00,2151,27.14,505,406,1646
06.06.2017 11:00,2090,26.72,742,535,1348
06.06.2017 12:00,2086,26.31,895,656,1191
06.06.2017 13:00,2126,25.62,973,768,1153
06.06.2017 14:00,2181,23.78,1000,849,1181
06.06.2017 15:00,2094,22.71,1061,873,1033
06.06.2017 16:00,2085,21.54,1111,948,974
06.06.2017 17:00,2102,20.98,1099,984,1003
06.06.2017 18:00,2147,21.95,1087,994,1060
06.06.2017 19:00,2242,22.72,1051,1018,1191
06.06.2017 20:00,2291,23.08,1009,1041,1282
06.06.2017 21:00,2245,21.92,1007,1040,1238
06.06.2017 22:00,2188,20.44,1031,1021,1157
06.06.2017 23:00,2145,20.23,955,991,1190
06.07.2017 00:00,2150,13.55,842,969,1308
06.07.2017 01:00,2039,10.67,765,887,1274
06.07.2017 02:00,1957,8.8,713,811,1244
06.07.2017 03:00,1915,6.82,654,733,1261
06.07.2017 04:00,1869,4.63,612,641,1257
06.07.2017 05:00,1900,4.42,550,610,1350
06.07.2017 06:00,2010,5.71,570,606,1440
06.07.2017 07:00,2293,19.8,646,593,1647
06.07.2017 08:00,2725,23.68,618,604,2107
06.07.2017 09:00,2878,24.53,625,599,2253
06.07.2017 10:00,3013,23.93,506,592,2507
06.07.2017 11:00,2923,23.58,683,648,2240
06.07.2017 12:00,2844,22.99,858,765,1986
06.07.2017 13:00,2717,22.27,1019,857,1698
06.07.2017 14:00,2756,22.17,1031,920,1725
06.07.2017 15:00,2751,21.88,1064,974,1687
06.07.2017 16:00,2668,20.27,1177,1026,1491
06.07.2017 17:00,2642,19.93,1164,1050,1478
06.07.2017 18:00,2653,19.7,1146,1054,1507
06.07.2017 19:00,2639,20.37,1101,1051,1538
06.07.2017 20:00,2642,23.13,1079,1050,1563
06.07.2017 21:00,2585,22.03,1056,1035,1529
06.07.2017 22:00,2510,21.97,1028,1015,1482
06.07.2017 23:00,2406,21.58,1021,998,1385
06.08.2017 00:00,2242,18.4,986,989,1256
06.08.2017 01:00,2136,15.5,962,1006,1174
06.08.2017 02:00,2052,10.2,975,987,1077
06.08.2017 03:00,1962,9.91,997,961,965
06.08.2017 04:00,1957,9.86,999,955,958
06.08.2017 05:00,1918,9.92,1018,945,900
06.08.2017 06:00,1959,18.6,1062,937,897
06.08.2017 07:00,2330,24.09,1059,938,1271
06.08.2017 08:00,2705,27.98,1043,933,1662
06.08.2017 09:00,2867,29.3,1010,915,1857
06.08.2017 10:00,2894,29.39,1015,959,1879
06.08.2017 11:00,3011,31.47,976,966,2035
06.08.2017 12:00,2968,31.67,945,937,2023
06.08.2017 13:00,2911,30.38,895,885,2016
06.08.2017 14:00,2881,30,835,836,2046
06.08.2017 15:00,2815,29.88,805,772,2010
06.08.2017 16:00,2782,30.02,719,703,2063
06.08.2017 17:00,2724,31.65,598,622,2126
06.08.2017 18:00,2710,33.95,509,518,2201
06.08.2017 19:00,2645,36.4,405,417,2240
06.08.2017 20:00,2635,37.76,291,326,2344
06.08.2017 21:00,2609,32.45,251,288,2358
06.08.2017 22:00,2564,33.73,213,256,2351
06.08.2017 23:00,2476,32.48,215,263,2261
06.09.2017 00:00,2325,28.08,206,281,2119
06.09.2017 01:00,2157,26.76,235,282,1922
06.09.2017 02:00,2035,24.91,260,283,1775
06.09.2017 03:00,2006,24.61,259,280,1747
06.09.2017 04:00,2011,24.04,251,283,1760
06.09.2017 05:00,1992,24.3,233,291,1759
06.09.2017 06:00,2087,27.54,242,290,1845
06.09.2017 07:00,2389,33.29,255,293,2134
06.09.2017 08:00,2679,39.38,289,280,2390
06.09.2017 09:00,2770,42.59,271,257,2499
06.09.2017 10:00,2838,40.59,184,228,2654
06.09.2017 11:00,2896,40.22,164,215,2732
06.09.2017 12:00,2898,40.81,153,217,2745
06.09.2017 13:00,2816,36.38,159,225,2657
06.09.2017 14:00,2766,33.83,176,254,2590
06.09.2017 15:00,2669,31.05,212,281,2457
06.09.2017 16:00,2547,29.09,304,326,2243
06.09.2017 17:00,2439,29.69,389,380,2050
06.09.2017 18:00,2405,31.44,440,406,1965
06.09.2017 19:00,2367,33.2,470,462,1897
06.09.2017 20:00,2265,32.88,589,520,1676
06.09.2017 21:00,2094,28.94,720,529,1374
06.09.2017 22:00,1964,27.66,763,504,1201
06.09.2017 23:00,1963,26.36,723,478,1240
06.10.2017 00:00,1952,24.77,592,448,1360
06.10.2017 01:00,1880,26.68,552,437,1328
06.10.2017 02:00,1706,24.47,551,374,1155
06.10.2017 03:00,1699,24.1,434,316,1265
06.10.2017 04:00,1731,23.65,328,277,1403
06.10.2017 05:00,1694,23.19,245,226,1449
06.10.2017 06:00,1689,23.67,220,193,1469
06.10.2017 07:00,1790,24.27,180,184,1610
06.10.2017 08:00,2038,26.76,107,185,1931
06.10.2017 09:00,2185,29.15,98,177,2087
06.10.2017 10:00,2276,31.17,113,162,2163
06.10.2017 11:00,2317,29.9,116,164,2201
06.10.2017 12:00,2299,29.94,140,168,2159
06.10.2017 13:00,2266,28.35,144,166,2122
06.10.2017 14:00,2216,25.86,153,165,2063
06.10.2017 15:00,2109,25.01,202,178,1907
06.10.2017 16:00,2082,25.03,214,188,1868
06.10.2017 17:00,2118,26.6,176,189,1942
06.10.2017 18:00,2141,29.1,156,184,1985
06.10.2017 19:00,2168,31.49,144,169,2024
06.10.2017 20:00,2118,29.88,140,148,1978
06.10.2017 21:00,2078,27.24,121,145,1957
06.10.2017 22:00,2068,27.47,125,154,1943
06.10.2017 23:00,2051,27.35,194,183,1857
06.11.2017 00:00,1910,25.89,288,197,1622
06.11.2017 01:00,1769,26.5,348,228,1421
06.11.2017 02:00,1716,24.52,356,232,1360
06.11.2017 03:00,1617,21.78,367,228,1250
06.11.2017 04:00,1603,18,317,225,1286
06.11.2017 05:00,1550,15.39,303,222,1247
06.11.2017 06:00,1522,12.6,305,215,1217
06.11.2017 07:00,1556,12.84,280,198,1276
06.11.2017 08:00,1748,16.49,180,188,1568
06.11.2017 09:00,1970,18.43,140,209,1830
06.11.2017 10:00,2137,20.86,155,249,1982
06.11.2017 11:00,2191,21.91,257,312,1934
06.11.2017 12:00,2093,21.88,467,362,1626
06.11.2017 13:00,2034,21.65,598,415,1436
06.11.2017 14:00,1982,21.09,702,474,1280
06.11.2017 15:00,2046,20.8,647,527,1399
06.11.2017 16:00,2127,20.22,568,515,1559
06.11.2017 17:00,2214,21.15,489,505,1725
06.11.2017 18:00,2205,23.58,506,448,1699
06.11.2017 19:00,2305,25.82,439,408,1866
06.11.2017 20:00,2372,27.91,332,366,2040
06.11.2017 21:00,2330,26.75,283,340,2047
06.11.2017 22:00,2269,26.4,310,339,1959
06.11.2017 23:00,2149,25.76,395,359,1754
06.12.2017 00:00,1885,24.36,572,412,1313
06.12.2017 01:00,1639,24.22,723,456,916
06.12.2017 02:00,1632,20.66,736,546,896
06.12.2017 03:00,1781,18.15,560,549,1221
06.12.2017 04:00,1932,14.6,405,543,1527
06.12.2017 05:00,1919,15.66,365,515,1554
06.12.2017 06:00,1948,19.88,406,466,1542
06.12.2017 07:00,2336,24.73,411,501,1925
06.12.2017 08:00,2664,33.17,512,558,2152
06.12.2017 09:00,2741,33.84,660,620,2081
06.12.2017 10:00,2701,29.95,801,688,1900
06.12.2017 11:00,2687,28.26,918,782,1769
06.12.2017 12:00,2691,26.36,1011,869,1680
06.12.2017 13:00,2657,23.27,1069,941,1588
06.12.2017 14:00,2738,22.72,1111,1046,1627
06.12.2017 15:00,2691,22.28,1199,1113,1492
06.12.2017 16:00,2729,22.2,1219,1174,1510
06.12.2017 17:00,2634,21.96,1247,1187,1387
06.12.2017 18:00,2595,22.23,1294,1212,1301
06.12.2017 19:00,2522,24.31,1306,1174,1216
06.12.2017 20:00,2473,23.94,1312,1174,1161
06.12.2017 21:00,2419,23.33,1268,1162,1151
06.12.2017 22:00,2352,23.26,1264,1157,1088
06.12.2017 23:00,2253,22.38,1273,1163,980
13.06.2017 00:00,2064,20.01,1285,1166,779
13.06.2017 01:00,1969,17.98,1272,1193,697
13.06.2017 02:00,1919,10.7,1246,1178,673
13.06.2017 03:00,1851,7.87,1257,1163,594
13.06.2017 04:00,1873,7.42,1215,1144,658
13.06.2017 05:00,1852,8.92,1183,1117,669
13.06.2017 06:00,1910,15.85,1184,1102,726
13.06.2017 07:00,2269,22.67,1157,1095,1112
13.06.2017 08:00,2653,25.6,1111,1075,1542
13.06.2017 09:00,2709,27.71,1112,1056,1597
13.06.2017 10:00,2693,26.39,1132,1049,1561
13.06.2017 11:00,2735,26.66,1158,1076,1577
13.06.2017 12:00,2698,28.3,1208,1092,1490
13.06.2017 13:00,2657,27.4,1193,1114,1464
13.06.2017 14:00,2689,27.75,1186,1106,1503
13.06.2017 15:00,2602,27.78,1203,1099,1399
13.06.2017 16:00,2558,27.23,1218,1054,1340
13.06.2017 17:00,2523,25.88,1180,1045,1343
13.06.2017 18:00,2496,29.13,1089,949,1407
13.06.2017 19:00,2418,35.48,1033,869,1385
13.06.2017 20:00,2421,37.91,857,758,1564
13.06.2017 21:00,2436,34.31,708,678,1728
13.06.2017 22:00,2379,34.12,645,611,1734
13.06.2017 23:00,2273,32.14,624,545,1649
14.06.2017 00:00,2095,26.22,601,511,1494
14.06.2017 01:00,1945,24.21,573,480,1372
14.06.2017 02:00,1859,23.33,527,427,1332
14.06.2017 03:00,1851,23.1,487,391,1364
14.06.2017 04:00,1810,23.13,482,359,1328
14.06.2017 05:00,1726,23.37,481,337,1245
14.06.2017 06:00,1828,24.06,445,315,1383
14.06.2017 07:00,2253,33.57,339,298,1914
14.06.2017 08:00,2616,40.27,298,282,2318
14.06.2017 09:00,2700,43.76,292,262,2408
14.06.2017 10:00,2683,41.63,306,251,2377
14.06.2017 11:00,2735,41.12,290,245,2445
14.06.2017 12:00,2761,39.93,284,253,2477
14.06.2017 13:00,2734,36.94,302,281,2432
14.06.2017 14:00,2729,35.99,334,299,2395
14.06.2017 15:00,2657,35.92,371,314,2286
14.06.2017 16:00,2601,35.02,453,338,2148
14.06.2017 17:00,2495,35.85,493,355,2002
14.06.2017 18:00,2451,39.56,490,336,1961
14.06.2017 19:00,2396,44.18,459,305,1937
14.06.2017 20:00,2407,48.75,344,267,2063
14.06.2017 21:00,2426,43.57,209,234,2217
14.06.2017 22:00,2331,41.88,200,208,2131
14.06.2017 23:00,2228,41.77,268,209,1960
15.06.2017 00:00,2006,34.59,357,218,1649
15.06.2017 01:00,1903,32.21,398,237,1505
15.06.2017 02:00,1801,25.63,421,239,1380
15.06.2017 03:00,1759,24.68,408,232,1351
15.06.2017 04:00,1780,24.53,374,213,1406
15.06.2017 05:00,1771,24.48,279,187,1492
15.06.2017 06:00,1938,26.92,202,156,1736
15.06.2017 07:00,2284,31.25,106,119,2178
15.06.2017 08:00,2607,36.9,65,92,2542
15.06.2017 09:00,2705,38,64,79,2641
15.06.2017 10:00,2689,35.49,72,78,2617
15.06.2017 11:00,2756,30.69,69,82,2687
15.06.2017 12:00,2797,32.76,55,88,2742
15.06.2017 13:00,2756,29.14,64,100,2692
15.06.2017 14:00,2753,28.41,68,108,2685
15.06.2017 15:00,2767,29.03,65,111,2702
15.06.2017 16:00,2729,27.16,83,111,2646
15.06.2017 17:00,2668,29.51,78,114,2590
15.06.2017 18:00,2628,33.81,67,104,2561
15.06.2017 19:00,2536,36.02,66,98,2470
15.06.2017 20:00,2523,36.75,66,94,2457
15.06.2017 21:00,2442,35.74,96,110,2346
15.06.2017 22:00,2415,34.18,118,144,2297
15.06.2017 23:00,2366,33.75,145,189,2221
16.06.2017 00:00,2136,29.28,231,241,1905
16.06.2017 01:00,1924,24.74,323,260,1601
16.06.2017 02:00,1848,23.35,341,297,1507
16.06.2017 03:00,1823,22,367,331,1456
16.06.2017 04:00,1785,21.07,420,356,1365
16.06.2017 05:00,1794,21.05,401,358,1393
16.06.2017 06:00,1912,22.41,361,338,1551
16.06.2017 07:00,2208,25.94,390,310,1818
16.06.2017 08:00,2515,30.77,415,295,2100
16.06.2017 09:00,2609,27.97,440,318,2169
16.06.2017 10:00,2677,26.66,464,393,2213
16.06.2017 11:00,2711,24.23,510,431,2201
16.06.2017 12:00,2693,23.97,568,474,2125
16.06.2017 13:00,2664,23.49,555,489,2109
16.06.2017 14:00,2613,23.3,572,498,2041
16.06.2017 15:00,2525,22.84,554,496,1971
16.06.2017 16:00,2497,22.53,515,483,1982
16.06.2017 17:00,2499,22.09,435,491,2064
16.06.2017 18:00,2541,22,383,485,2158
16.06.2017 19:00,2484,21.77,363,467,2121
16.06.2017 20:00,2334,23.01,423,447,1911
16.06.2017 21:00,2167,23.05,475,427,1692
16.06.2017 22:00,2094,22.96,455,416,1639
16.06.2017 23:00,2052,23.23,455,430,1597
17.06.2017 00:00,1898,21.83,480,425,1418
17.06.2017 01:00,1779,20.3,476,414,1303
17.06.2017 02:00,1684,18.02,453,401,1231
17.06.2017 03:00,1690,17.08,389,385,1301
17.06.2017 04:00,1681,19.49,353,365,1328
17.06.2017 05:00,1678,18.46,299,336,1379
17.06.2017 06:00,1692,19.77,254,311,1438
17.06.2017 07:00,1766,19.14,230,280,1536
17.06.2017 08:00,1895,21,196,245,1699
17.06.2017 09:00,2047,23.01,176,229,1871
17.06.2017 10:00,2158,23.49,188,222,1970
17.06.2017 11:00,2266,23.24,154,226,2112
17.06.2017 12:00,2227,23.09,204,233,2023
17.06.2017 13:00,2172,22.82,264,252,1908
17.06.2017 14:00,2147,22.55,288,271,1859
17.06.2017 15:00,2055,22.09,342,287,1713
17.06.2017 16:00,1979,22.22,370,294,1609
17.06.2017 17:00,1992,22.91,369,297,1623
17.06.2017 18:00,1988,23.98,376,288,1612
17.06.2017 19:00,2007,24.54,335,276,1672
17.06.2017 20:00,1995,24.4,265,246,1730
17.06.2017 21:00,1964,24.01,237,225,1727
17.06.2017 22:00,1910,23.63,237,221,1673
17.06.2017 23:00,1863,23.65,315,228,1548
18.06.2017 00:00,1785,23.06,348,243,1437
18.06.2017 01:00,1661,24.26,406,277,1255
18.06.2017 02:00,1567,23.74,431,282,1136
18.06.2017 03:00,1541,23.41,423,284,1118
18.06.2017 04:00,1495,23.08,444,289,1051
18.06.2017 05:00,1482,21.95,387,291,1095
18.06.2017 06:00,1507,22.49,351,292,1156
18.06.2017 07:00,1633,23.39,283,284,1350
18.06.2017 08:00,1754,24.08,255,279,1499
18.06.2017 09:00,1902,24.4,267,290,1635
18.06.2017 10:00,2036,24.4,293,313,1743
18.06.2017 11:00,2110,24.34,327,346,1783
18.06.2017 12:00,2134,24.24,376,380,1758
18.06.2017 13:00,2182,24.13,382,423,1800
18.06.2017 14:00,2215,23.53,386,466,1829
18.06.2017 15:00,2179,21.98,424,501,1755
18.06.2017 16:00,2119,22.9,494,529,1625
18.06.2017 17:00,2098,23.6,546,546,1552
18.06.2017 18:00,2091,24.26,597,538,1494
18.06.2017 19:00,2087,24.26,617,516,1470
18.06.2017 20:00,2067,24.39,570,475,1497
18.06.2017 21:00,2083,24.38,520,452,1563
18.06.2017 22:00,2068,24.2,481,448,1587
18.06.2017 23:00,2051,40.08,488,438,1563
19.06.2017 00:00,2003,34.81,492,447,1511
19.06.2017 01:00,1898,24.08,505,486,1393
19.06.2017 02:00,1852,23.76,490,480,1362
19.06.2017 03:00,1816,23.32,482,461,1334
19.06.2017 04:00,1811,23.12,428,430,1383
19.06.2017 05:00,1750,23.55,411,402,1339
19.06.2017 06:00,1851,28.4,376,365,1475
19.06.2017 07:00,2182,38.3,307,328,1875
19.06.2017 08:00,2511,42.97,257,287,2254
19.06.2017 09:00,2661,44.03,239,270,2422
19.06.2017 10:00,2674,40.98,270,269,2404
19.06.2017 11:00,2711,38.24,294,264,2417
19.06.2017 12:00,2734,38.49,320,275,2414
19.06.2017 13:00,2741,34.96,345,315,2396
19.06.2017 14:00,2764,35.06,359,331,2405
19.06.2017 15:00,2728,35.88,383,340,2345
19.06.2017 16:00,2690,38.33,391,349,2299
19.06.2017 17:00,2617,39.51,365,345,2252
19.06.2017 18:00,2569,42.1,335,324,2234
19.06.2017 19:00,2561,45.6,287,307,2274
19.06.2017 20:00,2520,49.99,259,289,2261
19.06.2017 21:00,2493,45.4,232,281,2261
19.06.2017 22:00,2404,44.13,285,310,2119
19.06.2017 23:00,2226,42.63,467,367,1759
20.06.2017 00:00,2037,35.78,610,454,1427
20.06.2017 01:00,1906,24.35,693,561,1213
20.06.2017 02:00,1839,23.71,737,609,1102
20.06.2017 03:00,1797,23.01,816,662,981
20.06.2017 04:00,1806,22.63,837,690,969
20.06.2017 05:00,1763,22.81,823,721,940
20.06.2017 06:00,1868,23.64,825,743,1043
20.06.2017 07:00,2105,33.7,895,750,1210
20.06.2017 08:00,2337,42.32,1014,777,1323
20.06.2017 09:00,2438,43.7,1059,782,1379
20.06.2017 10:00,2524,41.28,1052,830,1472
20.06.2017 11:00,2599,38.71,1031,851,1568
20.06.2017 12:00,2610,36.11,1057,870,1553
20.06.2017 13:00,2611,32.75,1067,891,1544
20.06.2017 14:00,2628,32,1061,916,1567
20.06.2017 15:00,2603,31.08,1053,932,1550
20.06.2017 16:00,2660,31.09,1023,950,1637
20.06.2017 17:00,2584,31.22,989,950,1595
20.06.2017 18:00,2569,36.44,957,923,1612
20.06.2017 19:00,2526,37.17,919,893,1607
20.06.2017 20:00,2516,38.75,810,819,1706
20.06.2017 21:00,2485,38.99,702,755,1783
20.06.2017 22:00,2459,37.96,593,690,1866
20.06.2017 23:00,2324,35.57,606,640,1718
21.06.2017 00:00,2108,24.69,660,625,1448
21.06.2017 01:00,1943,23.96,670,581,1273
21.06.2017 02:00,1879,23.25,645,565,1234
21.06.2017 03:00,1850,23.04,629,548,1221
21.06.2017 04:00,1828,22.92,605,526,1223
21.06.2017 05:00,1777,22.91,581,492,1196
21.06.2017 06:00,1921,24.17,490,454,1431
21.06.2017 07:00,2306,37.49,334,411,1972
21.06.2017 08:00,2644,42.96,270,376,2374
21.06.2017 09:00,2727,44.31,253,347,2474
21.06.2017 10:00,2723,43.24,270,322,2453
21.06.2017 11:00,2703,40.06,321,317,2382
21.06.2017 12:00,2675,39.54,358,324,2317
21.06.2017 13:00,2625,37.64,384,352,2241
21.06.2017 14:00,2616,36.09,412,368,2204
21.06.2017 15:00,2611,33.65,399,364,2212
21.06.2017 16:00,2610,34.69,361,351,2249
21.06.2017 17:00,2561,38.2,318,323,2243
21.06.2017 18:00,2542,32.86,318,304,2224
21.06.2017 19:00,2465,36.4,299,273,2166
21.06.2017 20:00,2483,38.75,235,247,2248
21.06.2017 21:00,2448,33.04,191,219,2257
21.06.2017 22:00,2391,40.64,193,193,2198
21.06.2017 23:00,2314,39.85,219,186,2095
22.06.2017 00:00,2094,32.97,271,185,1823
22.06.2017 01:00,2012,29.99,225,182,1787
22.06.2017 02:00,1960,27.85,211,179,1749
22.06.2017 03:00,1889,25.58,233,179,1656
22.06.2017 04:00,1881,25.01,215,164,1666
22.06.2017 05:00,1840,25.04,196,152,1644
22.06.2017 06:00,1962,29.47,169,134,1793
22.06.2017 07:00,2285,36.46,95,112,2190
22.06.2017 08:00,2582,42.39,93,93,2489
22.06.2017 09:00,2695,44.8,100,81,2595
22.06.2017 10:00,2722,40.88,88,82,2634
22.06.2017 11:00,2856,38.91,57,85,2799
22.06.2017 12:00,2851,37.15,66,83,2785
22.06.2017 13:00,2796,34.96,65,89,2731
22.06.2017 14:00,2770,31.71,63,100,2707
22.06.2017 15:00,2689,30.32,49,106,2640
22.06.2017 16:00,2614,30.37,49,102,2565
22.06.2017 17:00,2573,30.17,49,111,2524
22.06.2017 18:00,2567,37.43,40,105,2527
22.06.2017 19:00,2518,39.9,30,113,2488
22.06.2017 20:00,2440,40.9,28,103,2412
22.06.2017 21:00,2356,38.05,30,100,2326
22.06.2017 22:00,2297,37.56,39,93,2258
22.06.2017 23:00,2193,35.2,40,99,2153
23.06.2017 00:00,2006,30.23,68,107,1938
23.06.2017 01:00,1804,25.33,98,128,1706
23.06.2017 02:00,1710,23.55,85,130,1625
23.06.2017 03:00,1683,22.43,66,128,1617
23.06.2017 04:00,1604,21.41,95,120,1509
23.06.2017 05:00,1548,21.59,77,115,1471
23.06.2017 06:00,1576,23.34,58,108,1518
23.06.2017 07:00,1682,26.86,52,89,1630
23.06.2017 08:00,1868,31.02,31,73,1837
23.06.2017 09:00,2039,32.81,23,65,2016
23.06.2017 10:00,2156,33.27,19,58,2137
23.06.2017 11:00,2197,30.45,17,59,2180
23.06.2017 12:00,2209,29.05,25,68,2184
23.06.2017 13:00,2195,27.77,44,78,2151
23.06.2017 14:00,2117,26.1,96,95,2021
23.06.2017 15:00,2056,25.07,90,114,1966
23.06.2017 16:00,2051,24.98,93,143,1958
23.06.2017 17:00,2058,25.01,105,184,1953
23.06.2017 18:00,2100,27.68,117,223,1983
23.06.2017 19:00,2009,27.66,247,282,1762
23.06.2017 20:00,1968,27.55,337,371,1631
23.06.2017 21:00,1883,25.25,410,397,1473
23.06.2017 22:00,1881,25.16,379,383,1502
23.06.2017 23:00,1912,25.61,357,365,1555
24.06.2017 00:00,1820,25.16,384,373,1436
24.06.2017 01:00,1700,25.12,440,389,1260
24.06.2017 02:00,1671,23.78,423,412,1248
24.06.2017 03:00,1607,23.24,440,432,1167
24.06.2017 04:00,1533,22.28,484,448,1049
24.06.2017 05:00,1475,20.28,480,464,995
24.06.2017 06:00,1441,19.99,483,480,958
24.06.2017 07:00,1516,22.09,503,497,1013
24.06.2017 08:00,1639,23.75,515,518,1124
24.06.2017 09:00,1774,24.03,540,531,1234
24.06.2017 10:00,1907,23.93,567,562,1340
24.06.2017 11:00,1953,22.88,608,600,1345
24.06.2017 12:00,1984,22.37,686,642,1298
24.06.2017 13:00,1953,22.14,769,681,1184
24.06.2017 14:00,1908,21.42,818,709,1090
24.06.2017 15:00,1994,20.6,722,727,1272
24.06.2017 16:00,1995,19.68,753,769,1242
24.06.2017 17:00,2026,19.41,737,793,1289
24.06.2017 18:00,2042,22.07,724,781,1318
24.06.2017 19:00,1924,23.57,898,783,1026
24.06.2017 20:00,1749,23.78,1025,760,724
24.06.2017 21:00,1738,23.69,1023,783,715
24.06.2017 22:00,1817,23.74,901,777,916
24.06.2017 23:00,1843,23.87,880,766,963
25.06.2017 00:00,1668,23.49,991,756,677
25.06.2017 01:00,1567,23.95,978,746,589
25.06.2017 02:00,1536,23.03,915,752,621
25.06.2017 03:00,1460,20.79,861,707,599
25.06.2017 04:00,1466,18.25,810,678,656
25.06.2017 05:00,1423,14.45,726,634,697
25.06.2017 06:00,1446,10.25,675,617,771
25.06.2017 07:00,1489,10.26,719,632,770
25.06.2017 08:00,1595,17.69,764,660,831
25.06.2017 09:00,1812,19.26,771,719,1041
25.06.2017 10:00,2023,21.22,766,776,1257
25.06.2017 11:00,2133,21.97,789,813,1344
25.06.2017 12:00,2127,21.88,879,852,1248
25.06.2017 13:00,2146,21.76,938,894,1208
25.06.2017 14:00,2140,21.07,937,926,1203
25.06.2017 15:00,2062,20.56,1017,965,1045
25.06.2017 16:00,1980,19.91,1055,991,925
25.06.2017 17:00,1960,20.38,1098,1013,862
25.06.2017 18:00,2020,17.58,1121,1031,899
25.06.2017 19:00,2018,21.69,1119,996,899
25.06.2017 20:00,2046,23.2,1053,966,993
25.06.2017 21:00,2040,23.2,986,940,1054
25.06.2017 22:00,1952,23.37,1015,901,937
25.06.2017 23:00,1888,23.2,1045,878,843
26.06.2017 00:00,1816,21.8,1026,889,790
26.06.2017 01:00,1661,21.86,1054,928,607
26.06.2017 02:00,1567,20.24,1093,934,474
26.06.2017 03:00,1521,17.4,1088,950,433
26.06.2017 04:00,1540,16.91,1106,964,434
26.06.2017 05:00,1522,16.95,1151,984,371
26.06.2017 06:00,1655,22.36,1182,1027,473
26.06.2017 07:00,2034,26.52,1218,1093,816
26.06.2017 08:00,2354,29.38,1284,1139,1070
26.06.2017 09:00,2530,32.86,1310,1164,1220
26.06.2017 10:00,2626,32.83,1302,1184,1324
26.06.2017 11:00,2665,28.43,1305,1196,1360
26.06.2017 12:00,2655,27.91,1304,1187,1351
26.06.2017 13:00,2649,27.49,1280,1183,1369
26.06.2017 14:00,2756,27.35,1265,1241,1491
26.06.2017 15:00,2777,26.2,1255,1253,1522
26.06.2017 16:00,2606,27.2,1283,1144,1323
26.06.2017 17:00,2555,27.36,1238,1122,1317
26.06.2017 18:00,2576,27.47,1191,1110,1385
26.06.2017 19:00,2466,26.71,1200,1083,1266
26.06.2017 20:00,2398,26.71,1159,1027,1239
26.06.2017 21:00,2368,26.01,1049,962,1319
26.06.2017 22:00,2326,26.37,974,914,1352
26.06.2017 23:00,2241,25.86,962,858,1279
27.06.2017 00:00,2068,23.29,964,824,1104
27.06.2017 01:00,2033,23.21,910,843,1123
27.06.2017 02:00,1971,22.9,867,808,1104
27.06.2017 03:00,1932,22.59,857,781,1075
27.06.2017 04:00,1913,22.5,825,731,1088
27.06.2017 05:00,1893,22.51,741,678,1152
27.06.2017 06:00,2013,28.7,668,615,1345
27.06.2017 07:00,2353,33.13,572,553,1781
27.06.2017 08:00,2599,41.37,555,489,2044
27.06.2017 09:00,2688,45.89,463,415,2225
27.06.2017 10:00,2738,46.3,371,341,2367
27.06.2017 11:00,2784,46.69,297,279,2487
27.06.2017 12:00,2784,48.04,252,231,2532
27.06.2017 13:00,2744,45.95,220,215,2524
27.06.2017 14:00,2740,44.45,190,174,2550
27.06.2017 15:00,2710,44.1,173,162,2537
27.06.2017 16:00,2717,40.15,151,144,2566
27.06.2017 17:00,2604,42.53,136,124,2468
27.06.2017 18:00,2609,42.6,115,109,2494
27.06.2017 19:00,2550,43.93,87,96,2463
27.06.2017 20:00,2478,43.94,74,84,2404
27.06.2017 21:00,2413,40.24,54,68,2359
27.06.2017 22:00,2304,37.98,63,63,2241
27.06.2017 23:00,2289,32.62,65,65,2224
28.06.2017 00:00,2160,27.3,65,64,2095
28.06.2017 01:00,1996,28.77,57,45,1939
28.06.2017 02:00,1925,27.35,64,50,1861
28.06.2017 03:00,1892,26.02,78,60,1814
28.06.2017 04:00,1903,25.4,92,74,1811
28.06.2017 05:00,1869,25.34,111,98,1758
28.06.2017 06:00,1923,27.96,156,120,1767
28.06.2017 07:00,2208,32.76,151,129,2057
28.06.2017 08:00,2569,38.64,98,138,2471
28.06.2017 09:00,2785,41.51,84,166,2701
28.06.2017 10:00,2858,41.99,101,203,2757
28.06.2017 11:00,2882,41.95,179,261,2703
28.06.2017 12:00,2809,42.7,316,339,2493
28.06.2017 13:00,2677,43.58,478,418,2199
28.06.2017 14:00,2659,39.92,600,491,2059
28.06.2017 15:00,2610,36.57,694,569,1916
28.06.2017 16:00,2526,33.79,803,647,1723
28.06.2017 17:00,2446,34.9,872,729,1574
28.06.2017 18:00,2497,38.4,890,825,1607
28.06.2017 19:00,2461,38.97,926,878,1535
28.06.2017 20:00,2392,39.04,994,921,1398
28.06.2017 21:00,2310,33.32,1055,961,1255
28.06.2017 22:00,2266,28.71,1089,994,1177
28.06.2017 23:00,2284,28.09,1107,1057,1177
29.06.2017 00:00,2104,24.08,1157,1114,947
29.06.2017 01:00,2011,22.23,1140,1150,871
29.06.2017 02:00,1946,21.82,1196,1177,750
29.06.2017 03:00,1865,21.77,1242,1195,623
29.06.2017 04:00,1858,21.81,1266,1209,592
29.06.2017 05:00,1910,21.86,1214,1212,696
29.06.2017 06:00,2046,22.74,1177,1221,869
29.06.2017 07:00,2395,31.5,1149,1224,1246
29.06.2017 08:00,2643,40.11,1180,1201,1463
29.06.2017 09:00,2793,45.83,1148,1185,1645
29.06.2017 10:00,2890,46.39,1125,1196,1765
29.06.2017 11:00,2896,46.39,1156,1168,1740
29.06.2017 12:00,2901,46.66,1171,1165,1730
29.06.2017 13:00,2901,44.89,1130,1159,1771
29.06.2017 14:00,2885,44.11,1139,1158,1746
29.06.2017 15:00,2828,41.71,1170,1142,1658
29.06.2017 16:00,2758,38.23,1238,1129,1520
29.06.2017 17:00,2617,37.31,1294,1124,1323
29.06.2017 18:00,2573,37.31,1280,1101,1293
29.06.2017 19:00,2541,38.09,1227,1081,1314
29.06.2017 20:00,2533,38.08,1158,1057,1375
29.06.2017 21:00,2524,33.14,1140,1062,1384
29.06.2017 22:00,2452,30.58,1135,1058,1317
29.06.2017 23:00,2359,28.5,1084,1030,1275
30.06.2017 00:00,2182,25.11,1075,1021,1107
30.06.2017 01:00,2031,24.21,1057,1015,974
30.06.2017 02:00,1985,22.43,1026,1016,959
30.06.2017 03:00,1898,21.97,1073,1015,825
30.06.2017 04:00,1846,21.75,1109,1015,737
30.06.2017 05:00,1860,21.83,1063,986,797
30.06.2017 06:00,2000,23.05,985,971,1015
30.06.2017 07:00,2327,27.91,930,936,1397
30.06.2017 08:00,2636,36.28,921,898,1715
30.06.2017 09:00,2787,37.98,892,839,1895
30.06.2017 10:00,2855,35.99,820,794,2035
30.06.2017 11:00,2911,35.51,764,759,2147
30.06.2017 12:00,2921,32.24,751,724,2170
30.06.2017 13:00,2809,29.33,747,673,2062
30.06.2017 14:00,2693,27.29,783,643,1910
30.06.2017 15:00,2543,25.08,793,603,1750
30.06.2017 16:00,2443,25.09,785,545,1658
30.06.2017 17:00,2421,26.63,758,537,1663
30.06.2017 18:00,2478,29.61,714,542,1764
30.06.2017 19:00,2505,32.66,670,554,1835
30.06.2017 20:00,2431,30.42,633,532,1798
30.06.2017 21:00,2334,26.43,597,515,1737
30.06.2017 22:00,2216,25.57,617,487,1599
30.06.2017 23:00,2142,25.39,592,460,1550
07.01.2017 00:00,2055,23.76,530,452,1525
07.01.2017 01:00,1986,27.16,479,472,1507
07.01.2017 02:00,1888,23.81,458,462,1430
07.01.2017 03:00,1848,23.47,451,444,1397
07.01.2017 04:00,1796,23.34,458,420,1338
07.01.2017 05:00,1732,23.26,477,413,1255
07.01.2017 06:00,1712,23.46,497,419,1215
07.01.2017 07:00,1788,24.95,504,423,1284
07.01.2017 08:00,1926,26.77,520,432,1406
07.01.2017 09:00,2078,28.82,516,430,1562
07.01.2017 10:00,2244,31.62,511,437,1733
07.01.2017 11:00,2362,32.54,472,428,1890
07.01.2017 12:00,2456,32.36,393,409,2063
07.01.2017 13:00,2389,29.1,373,383,2016
07.01.2017 14:00,2335,26.07,365,353,1970
07.01.2017 15:00,2272,26.33,344,325,1928
07.01.2017 16:00,2263,26.04,297,305,1966
07.01.2017 17:00,2285,26.09,251,284,2034
07.01.2017 18:00,2328,29.01,207,267,2121
07.01.2017 19:00,2276,29.34,207,248,2069
07.01.2017 20:00,2238,29.18,201,240,2037
07.01.2017 21:00,2175,29.39,208,240,1967
07.01.2017 22:00,2095,28.91,228,243,1867
07.01.2017 23:00,2064,28.06,287,258,1777
07.02.2017 00:00,1901,25.63,377,281,1524
07.02.2017 01:00,1708,24.36,391,260,1317
07.02.2017 02:00,1641,23.12,409,286,1232
07.02.2017 03:00,1602,22.73,406,300,1196
07.02.2017 04:00,1609,22.63,393,320,1216
07.02.2017 05:00,1574,20.27,395,340,1179
07.02.2017 06:00,1568,20.59,381,345,1187
07.02.2017 07:00,1611,21.3,381,346,1230
07.02.2017 08:00,1757,23.07,364,357,1393
07.02.2017 09:00,1839,24.76,439,388,1400
07.02.2017 10:00,2008,26.08,435,421,1573
07.02.2017 11:00,2123,26.26,459,469,1664
07.02.2017 12:00,2093,25.92,558,509,1535
07.02.2017 13:00,2098,25.02,629,556,1469
07.02.2017 14:00,2077,23.02,716,620,1361
07.02.2017 15:00,2029,22.74,805,686,1224
07.02.2017 16:00,2005,22.44,870,754,1135
07.02.2017 17:00,1973,22.26,979,804,994
07.02.2017 18:00,1989,22.35,1045,860,944
07.02.2017 19:00,1979,25.99,1139,922,840
07.02.2017 20:00,2038,26.4,1127,948,911
07.02.2017 21:00,2038,24.34,1133,950,905
07.02.2017 22:00,2008,24.25,1115,956,893
07.02.2017 23:00,2047,24.75,1062,957,985
07.03.2017 00:00,2016,25.86,1025,972,991
07.03.2017 01:00,1955,23.26,1045,1033,910
07.03.2017 02:00,1848,22.77,1073,1046,775
07.03.2017 03:00,1835,22.31,1080,1055,755
07.03.2017 04:00,1858,22.29,1075,1065,783
07.03.2017 05:00,1841,22.65,1064,1063,777
07.03.2017 06:00,1955,23.19,1086,1077,869
07.03.2017 07:00,2263,23.85,1124,1108,1139
07.03.2017 08:00,2579,26.44,1142,1119,1437
07.03.2017 09:00,2697,28.43,1148,1118,1549
07.03.2017 10:00,2780,28.28,1136,1129,1644
07.03.2017 11:00,2712,28.94,1238,1096,1474
07.03.2017 12:00,2726,28.69,1206,1066,1520
07.03.2017 13:00,2722,27.99,1167,1055,1555
07.03.2017 14:00,2797,27.49,1072,1013,1725
07.03.2017 15:00,2795,26.76,996,983,1799
07.03.2017 16:00,2703,27.34,1038,968,1665
07.03.2017 17:00,2606,27.53,987,908,1619
07.03.2017 18:00,2697,28.03,906,874,1791
07.03.2017 19:00,2818,27.92,675,821,2143
07.03.2017 20:00,2760,26.82,541,723,2219
07.03.2017 21:00,2656,27.44,463,636,2193
07.03.2017 22:00,2497,26.57,491,587,2006
07.03.2017 23:00,2346,26.53,566,580,1780
07.04.2017 00:00,2204,26.07,582,584,1622
07.04.2017 01:00,2083,27.8,573,611,1510
07.04.2017 02:00,2049,24.14,570,646,1479
07.04.2017 03:00,1921,23.3,632,646,1289
07.04.2017 04:00,1894,23.2,652,635,1242
07.04.2017 05:00,1867,23.07,595,639,1272
07.04.2017 06:00,1989,23.19,571,635,1418
07.04.2017 07:00,2296,25.68,551,629,1745
07.04.2017 08:00,2627,30.2,546,628,2081
07.04.2017 09:00,2759,32.76,521,602,2238
07.04.2017 10:00,2786,35.13,466,546,2320
07.04.2017 11:00,2797,34.74,461,507,2336
07.04.2017 12:00,2819,32.97,420,500,2399
07.04.2017 13:00,2801,31.93,374,490,2427
07.04.2017 14:00,2786,31.93,402,493,2384
07.04.2017 15:00,2712,30.55,446,492,2266
07.04.2017 16:00,2621,31.82,481,475,2140
07.04.2017 17:00,2496,32.14,499,454,1997
07.04.2017 18:00,2506,36.07,443,423,2063
07.04.2017 19:00,2431,39.04,409,364,2022
07.04.2017 20:00,2431,40.04,346,304,2085
07.04.2017 21:00,2416,40.22,267,282,2149
07.04.2017 22:00,2364,39.39,232,257,2132
07.04.2017 23:00,2247,36.69,276,253,1971
07.05.2017 00:00,2110,32.99,306,265,1804
07.05.2017 01:00,1905,31.95,320,247,1585
07.05.2017 02:00,1809,31.15,360,244,1449
07.05.2017 03:00,1785,29.04,354,238,1431
07.05.2017 04:00,1794,27.63,323,225,1471
07.05.2017 05:00,1749,27.3,300,196,1449
07.05.2017 06:00,1840,31.12,238,169,1602
07.05.2017 07:00,2180,37.11,141,135,2039
07.05.2017 08:00,2511,42.86,73,107,2438
07.05.2017 09:00,2665,46.01,47,93,2618
07.05.2017 10:00,2734,44.18,38,81,2696
07.05.2017 11:00,2777,43.71,44,71,2733
07.05.2017 12:00,2774,42.06,55,73,2719
07.05.2017 13:00,2694,38.93,89,81,2605
07.05.2017 14:00,2682,38.09,108,93,2574
07.05.2017 15:00,2627,37.44,141,105,2486
07.05.2017 16:00,2576,37.38,177,123,2399
07.05.2017 17:00,2474,38.9,209,139,2265
07.05.2017 18:00,2471,40.83,226,147,2245
07.05.2017 19:00,2423,41.5,231,141,2192
07.05.2017 20:00,2412,43.48,177,123,2235
07.05.2017 21:00,2443,43.09,93,118,2350
07.05.2017 22:00,2387,42.87,42,111,2345
07.05.2017 23:00,2286,40.66,82,111,2204
07.06.2017 00:00,2160,35.47,106,133,2054
07.06.2017 01:00,1943,33.03,186,140,1757
07.06.2017 02:00,1845,31.44,227,157,1618
07.06.2017 03:00,1810,29.88,243,154,1567
07.06.2017 04:00,1807,29.81,244,148,1563
07.06.2017 05:00,1733,29.19,240,134,1493
07.06.2017 06:00,1837,32.06,200,111,1637
07.06.2017 07:00,2145,36.94,121,85,2024
07.06.2017 08:00,2520,42.29,27,65,2493
07.06.2017 09:00,2675,48.24,6,49,2669
07.06.2017 10:00,2748,43.08,5,45,2743
07.06.2017 11:00,2789,41.86,11,41,2778
07.06.2017 12:00,2770,40.03,17,44,2753
07.06.2017 13:00,2714,36.59,33,53,2681
07.06.2017 14:00,2724,36.63,62,75,2662
07.06.2017 15:00,2660,36.42,100,87,2560
07.06.2017 16:00,2650,39.52,111,99,2539
07.06.2017 17:00,2565,40.6,129,115,2436
07.06.2017 18:00,2545,44.31,152,130,2393
07.06.2017 19:00,2509,45.05,143,144,2366
07.06.2017 20:00,2475,47.46,138,150,2337
07.06.2017 21:00,2402,47.07,136,141,2266
07.06.2017 22:00,2257,44.93,177,138,2080
07.06.2017 23:00,2187,41.68,206,145,1981
07.07.2017 00:00,2018,35.61,206,144,1812
07.07.2017 01:00,1880,34.16,175,124,1705
07.07.2017 02:00,1811,32.07,141,111,1670
07.07.2017 03:00,1783,30.8,117,108,1666
07.07.2017 04:00,1789,30.69,97,104,1692
07.07.2017 05:00,1768,29.64,102,104,1666
07.07.2017 06:00,1829,30.84,95,96,1734
07.07.2017 07:00,2121,35.87,85,80,2036
07.07.2017 08:00,2412,41.88,67,61,2345
07.07.2017 09:00,2602,45.54,35,55,2567
07.07.2017 10:00,2698,45.58,19,56,2679
07.07.2017 11:00,2741,44.61,23,57,2718
07.07.2017 12:00,2735,44.38,30,53,2705
07.07.2017 13:00,2703,40.63,28,59,2675
07.07.2017 14:00,2639,35.27,48,76,2591
07.07.2017 15:00,2546,32.84,70,73,2476
07.07.2017 16:00,2484,32.63,74,77,2410
07.07.2017 17:00,2430,32.4,72,82,2358
07.07.2017 18:00,2417,37.87,66,85,2351
07.07.2017 19:00,2341,40.58,74,80,2267
07.07.2017 20:00,2255,42.74,43,73,2212
07.07.2017 21:00,2184,40.8,38,70,2146
07.07.2017 22:00,2074,39.49,63,60,2011
07.07.2017 23:00,2027,39.82,84,62,1943
07.08.2017 00:00,1905,34.73,96,70,1809
07.08.2017 01:00,1796,35.16,88,67,1708
07.08.2017 02:00,1721,33.65,57,59,1664
07.08.2017 03:00,1678,31.86,41,50,1637
07.08.2017 04:00,1632,30.68,55,48,1577
07.08.2017 05:00,1612,29.87,50,49,1562
07.08.2017 06:00,1587,29.09,56,53,1531
07.08.2017 07:00,1602,30,113,56,1489
07.08.2017 08:00,1751,32.02,127,65,1624
07.08.2017 09:00,1984,34.58,85,81,1899
07.08.2017 10:00,2136,36.71,112,120,2024
07.08.2017 11:00,2187,35.89,156,146,2031
07.08.2017 12:00,2212,35.37,191,187,2021
07.08.2017 13:00,2192,33.22,243,236,1949
07.08.2017 14:00,2141,31.41,308,287,1833
07.08.2017 15:00,2092,30.18,332,332,1760
07.08.2017 16:00,2085,30.05,333,354,1752
07.08.2017 17:00,2099,30.83,358,392,1741
07.08.2017 18:00,2077,31.99,420,385,1657
07.08.2017 19:00,2011,32.12,466,377,1545
07.08.2017 20:00,1999,32.03,402,350,1597
07.08.2017 21:00,2007,31.77,341,355,1666
07.08.2017 22:00,1922,31.85,386,359,1536
07.08.2017 23:00,1896,32.19,441,373,1455
07.09.2017 00:00,1819,30.95,469,384,1350
07.09.2017 01:00,1753,31.06,473,420,1280
07.09.2017 02:00,1705,30.33,446,417,1259
07.09.2017 03:00,1663,29.12,440,410,1223
07.09.2017 04:00,1588,28.5,490,405,1098
07.09.2017 05:00,1511,28.1,512,398,999
07.09.2017 06:00,1481,28.76,496,389,985
07.09.2017 07:00,1581,29.49,426,358,1155
07.09.2017 08:00,1681,29.83,404,338,1277
07.09.2017 09:00,1831,30.03,408,329,1423
07.09.2017 10:00,2007,31.26,356,325,1651
07.09.2017 11:00,2098,31.26,326,309,1772
07.09.2017 12:00,2115,32.4,301,281,1814
07.09.2017 13:00,2107,32.07,301,286,1806
07.09.2017 14:00,2098,31,270,280,1828
07.09.2017 15:00,2077,29.88,246,272,1831
07.09.2017 16:00,2049,30.69,223,249,1826
07.09.2017 17:00,2058,31.28,206,227,1852
07.09.2017 18:00,2092,33.8,171,196,1921
07.09.2017 19:00,2110,36.75,144,162,1966
07.09.2017 20:00,2083,40.1,115,130,1968
07.09.2017 21:00,2056,39.95,103,120,1953
07.09.2017 22:00,2017,40.36,139,125,1878
07.09.2017 23:00,2023,41.27,177,142,1846
07.10.2017 00:00,1941,35.1,176,146,1765
07.10.2017 01:00,1842,31.98,156,145,1686
07.10.2017 02:00,1748,29.92,146,130,1602
07.10.2017 03:00,1733,29.44,130,110,1603
07.10.2017 04:00,1722,29.08,111,91,1611
07.10.2017 05:00,1710,29.31,81,74,1629
07.10.2017 06:00,1802,30.42,65,60,1737
07.10.2017 07:00,2064,37.12,37,44,2027
07.10.2017 08:00,2319,44.03,13,34,2306
07.10.2017 09:00,2491,50.07,8,33,2483
07.10.2017 10:00,2580,50,10,36,2570
07.10.2017 11:00,2629,49.93,15,45,2614
07.10.2017 12:00,2639,49.92,26,54,2613
07.10.2017 13:00,2598,48.86,32,63,2566
07.10.2017 14:00,2633,47.8,37,70,2596
07.10.2017 15:00,2603,45.27,45,77,2558
07.10.2017 16:00,2588,43.99,47,86,2541
07.10.2017 17:00,2514,40.65,48,91,2466
07.10.2017 18:00,2501,40.95,60,95,2441
07.10.2017 19:00,2458,41.62,49,88,2409
07.10.2017 20:00,2420,42.97,36,86,2384
07.10.2017 21:00,2346,40.21,28,83,2318
07.10.2017 22:00,2260,38.86,52,84,2208
07.10.2017 23:00,2204,38.96,45,86,2159
07.11.2017 00:00,2049,33.17,40,93,2009
07.11.2017 01:00,1977,30.67,42,147,1935
07.11.2017 02:00,1914,29.83,57,161,1857
07.11.2017 03:00,1893,29.61,64,175,1829
07.11.2017 04:00,1881,28.96,104,198,1777
07.11.2017 05:00,1836,28.95,152,221,1684
07.11.2017 06:00,1841,29.8,202,221,1639
07.11.2017 07:00,2083,34.09,184,199,1899
07.11.2017 08:00,2357,41.44,149,184,2208
07.11.2017 09:00,2549,44.22,103,169,2446
07.11.2017 10:00,2636,43.43,76,139,2560
07.11.2017 11:00,2686,42.03,76,142,2610
07.11.2017 12:00,2679,41.45,92,132,2587
07.11.2017 13:00,2557,39.42,141,148,2416
07.11.2017 14:00,2542,36.01,188,173,2354
07.11.2017 15:00,2463,34.21,225,195,2238
07.11.2017 16:00,2414,34.42,255,213,2159
07.11.2017 17:00,2393,35.39,242,230,2151
07.11.2017 18:00,2423,37.62,229,238,2194
07.11.2017 19:00,2363,39.99,259,235,2104
07.11.2017 20:00,2317,41.2,239,227,2078
07.11.2017 21:00,2250,39.72,226,242,2024
07.11.2017 22:00,2146,38.68,280,252,1866
07.11.2017 23:00,2051,36.39,349,272,1702
07.12.2017 00:00,1954,32.42,364,300,1590
07.12.2017 01:00,1718,31.7,470,343,1248
07.12.2017 02:00,1628,30.14,482,351,1146
07.12.2017 03:00,1623,29.1,466,355,1157
07.12.2017 04:00,1612,28.52,455,345,1157
07.12.2017 05:00,1634,28.43,390,333,1244
07.12.2017 06:00,1704,29.3,330,303,1374
07.12.2017 07:00,1967,34.77,297,278,1670
07.12.2017 08:00,2258,39.94,280,265,1978
07.12.2017 09:00,2385,44.01,332,263,2053
07.12.2017 10:00,2478,44.31,330,275,2148
07.12.2017 11:00,2559,44.16,326,290,2233
07.12.2017 12:00,2554,43.9,336,306,2218
07.12.2017 13:00,2565,41.07,337,309,2228
07.12.2017 14:00,2595,39.9,307,314,2288
07.12.2017 15:00,2567,37.27,297,298,2270
07.12.2017 16:00,2599,33.93,260,282,2339
07.12.2017 17:00,2559,32.19,221,253,2338
07.12.2017 18:00,2529,33.29,207,227,2322
07.12.2017 19:00,2469,32.95,185,200,2284
07.12.2017 20:00,2420,32.82,152,181,2268
07.12.2017 21:00,2278,30.5,166,195,2112
07.12.2017 22:00,2177,29.86,242,231,1935
07.12.2017 23:00,2132,29.37,353,283,1779
13.07.2017 00:00,1891,27.28,495,345,1396
13.07.2017 01:00,1782,26.05,530,409,1252
13.07.2017 02:00,1722,24.37,578,458,1144
13.07.2017 03:00,1716,23.04,597,478,1119
13.07.2017 04:00,1755,24.76,573,486,1182
13.07.2017 05:00,1748,25.08,531,480,1217
13.07.2017 06:00,1835,26.04,483,453,1352
13.07.2017 07:00,2205,27.23,348,416,1857
13.07.2017 08:00,2521,30.17,272,377,2249
13.07.2017 09:00,2633,34.85,305,372,2328
13.07.2017 10:00,2672,35.08,340,386,2332
13.07.2017 11:00,2689,35.52,380,439,2309
13.07.2017 12:00,2633,34.96,461,490,2172
13.07.2017 13:00,2524,30.26,592,536,1932
13.07.2017 14:00,2478,30.04,640,567,1838
13.07.2017 15:00,2491,29.07,635,589,1856
13.07.2017 16:00,2484,30.27,638,604,1846
13.07.2017 17:00,2422,33.46,621,590,1801
13.07.2017 18:00,2440,36.36,587,557,1853
13.07.2017 19:00,2345,37.16,577,508,1768
13.07.2017 20:00,2267,39.1,540,456,1727
13.07.2017 21:00,2246,39.32,439,405,1807
13.07.2017 22:00,2223,39.25,396,380,1827
13.07.2017 23:00,2186,37.62,380,365,1806
14.07.2017 00:00,2016,31.32,420,367,1596
14.07.2017 01:00,1843,31.68,437,346,1406
14.07.2017 02:00,1752,31.38,435,351,1317
14.07.2017 03:00,1706,28.96,428,329,1278
14.07.2017 04:00,1698,28.15,424,297,1274
14.07.2017 05:00,1674,27.46,374,267,1300
14.07.2017 06:00,1747,28.88,304,242,1443
14.07.2017 07:00,2016,35.86,214,215,1802
14.07.2017 08:00,2325,39.76,134,193,2191
14.07.2017 09:00,2496,44.9,124,184,2372
14.07.2017 10:00,2545,43.32,127,172,2418
14.07.2017 11:00,2595,41.62,130,168,2465
14.07.2017 12:00,2543,38.94,151,172,2392
14.07.2017 13:00,2492,37.1,172,177,2320
14.07.2017 14:00,2425,35.97,200,176,2225
14.07.2017 15:00,2324,31.91,218,174,2106
14.07.2017 16:00,2196,30.34,267,168,1929
14.07.2017 17:00,2157,31.29,288,172,1869
14.07.2017 18:00,2203,36.92,234,172,1969
14.07.2017 19:00,2158,39.95,223,153,1935
14.07.2017 20:00,2127,41.64,176,135,1951
14.07.2017 21:00,2077,38.19,119,117,1958
14.07.2017 22:00,1989,38.16,119,114,1870
14.07.2017 23:00,2017,34.46,136,121,1881
15.07.2017 00:00,1942,29.77,142,127,1800
15.07.2017 01:00,1772,30.73,168,125,1604
15.07.2017 02:00,1663,28.82,210,128,1453
15.07.2017 03:00,1621,28.06,223,129,1398
15.07.2017 04:00,1610,27.43,215,120,1395
15.07.2017 05:00,1562,27.59,215,120,1347
15.07.2017 06:00,1530,27.29,197,106,1333
15.07.2017 07:00,1631,27.46,131,83,1500
15.07.2017 08:00,1801,28.94,69,66,1732
15.07.2017 09:00,1950,31.17,37,57,1913
15.07.2017 10:00,2086,33,27,48,2059
15.07.2017 11:00,2113,32.63,33,52,2080
15.07.2017 12:00,2089,32.26,50,57,2039
15.07.2017 13:00,2069,31.44,74,68,1995
15.07.2017 14:00,2006,30.06,96,80,1910
15.07.2017 15:00,1946,29.07,133,90,1813
15.07.2017 16:00,1923,28.64,139,100,1784
15.07.2017 17:00,1975,28.89,132,117,1843
15.07.2017 18:00,2015,30.24,126,115,1889
15.07.2017 19:00,1986,32.13,139,112,1847
15.07.2017 20:00,1974,32.13,96,104,1878
15.07.2017 21:00,1908,29.17,101,102,1807
15.07.2017 22:00,1882,29.15,138,118,1744
15.07.2017 23:00,1891,28.54,178,139,1713
16.07.2017 00:00,1775,27.29,220,162,1555
16.07.2017 01:00,1658,28.42,237,162,1421
16.07.2017 02:00,1571,27.06,277,177,1294
16.07.2017 03:00,1536,26.81,289,173,1247
16.07.2017 04:00,1560,26.45,237,163,1323
16.07.2017 05:00,1548,25.05,194,156,1354
16.07.2017 06:00,1470,24.83,197,136,1273
16.07.2017 07:00,1505,25.11,190,125,1315
16.07.2017 08:00,1630,25.97,157,136,1473
16.07.2017 09:00,1751,26,201,163,1550
16.07.2017 10:00,1852,26.13,295,215,1557
16.07.2017 11:00,1941,26.4,425,311,1516
16.07.2017 12:00,1973,26.36,575,404,1398
16.07.2017 13:00,1962,26.21,724,497,1238
16.07.2017 14:00,1893,26.09,890,591,1003
16.07.2017 15:00,1895,25.37,928,641,967
16.07.2017 16:00,1911,25.22,913,663,998
16.07.2017 17:00,2029,26.25,853,671,1176
16.07.2017 18:00,2117,26.52,768,632,1349
16.07.2017 19:00,2181,26.7,677,580,1504
16.07.2017 20:00,2121,26.75,655,530,1466
16.07.2017 21:00,2013,26.78,632,501,1381
16.07.2017 22:00,1928,27,650,489,1278
16.07.2017 23:00,1892,26.91,687,503,1205
17.07.2017 00:00,1763,26.49,701,520,1062
17.07.2017 01:00,1679,25.73,732,593,947
17.07.2017 02:00,1645,24.4,721,611,924
17.07.2017 03:00,1599,23.98,769,637,830
17.07.2017 04:00,1620,23.83,779,654,841
17.07.2017 05:00,1637,23.98,767,682,870
17.07.2017 06:00,1672,25.15,766,704,906
17.07.2017 07:00,1914,26.18,764,730,1150
17.07.2017 08:00,2165,27.53,780,750,1385
17.07.2017 09:00,2336,28.04,811,781,1525
17.07.2017 10:00,2356,28.34,871,782,1485
17.07.2017 11:00,2355,27.91,917,782,1438
17.07.2017 12:00,2350,27.2,918,788,1432
17.07.2017 13:00,2322,26.68,945,801,1377
17.07.2017 14:00,2301,26.59,980,833,1321
17.07.2017 15:00,2276,26.52,988,834,1288
17.07.2017 16:00,2272,26.35,990,875,1282
17.07.2017 17:00,2310,26.26,963,886,1347
17.07.2017 18:00,2391,26.45,883,856,1508
17.07.2017 19:00,2346,26.58,829,815,1517
17.07.2017 20:00,2313,26.6,732,755,1581
17.07.2017 21:00,2264,26.62,665,697,1599
17.07.2017 22:00,2176,26.57,692,683,1484
17.07.2017 23:00,2086,26.29,743,670,1343
18.07.2017 00:00,1902,25.55,770,664,1132
18.07.2017 01:00,1774,25.71,775,675,999
18.07.2017 02:00,1691,24.92,769,654,922
18.07.2017 03:00,1706,24.26,715,638,991
18.07.2017 04:00,1697,24.27,700,626,997
18.07.2017 05:00,1670,24.24,654,599,1016
18.07.2017 06:00,1706,25.54,630,586,1076
18.07.2017 07:00,1934,26.57,574,576,1360
18.07.2017 08:00,2181,27.99,539,573,1642
18.07.2017 09:00,2368,30.1,530,569,1838
18.07.2017 10:00,2417,32.79,539,551,1878
18.07.2017 11:00,2419,33.36,564,532,1855
18.07.2017 12:00,2432,31.59,560,534,1872
18.07.2017 13:00,2474,31.37,517,539,1957
18.07.2017 14:00,2454,30.38,524,538,1930
18.07.2017 15:00,2429,29.27,478,496,1951
18.07.2017 16:00,2403,28.9,441,458,1962
18.07.2017 17:00,2353,27.76,389,421,1964
18.07.2017 18:00,2329,27.86,326,346,2003
18.07.2017 19:00,2335,28.26,251,286,2084
18.07.2017 20:00,2264,28.12,192,219,2072
18.07.2017 21:00,2167,27.99,173,184,1994
18.07.2017 22:00,2109,27.96,182,169,1927
18.07.2017 23:00,2026,27.64,226,163,1800
19.07.2017 00:00,1885,26.37,225,161,1660
19.07.2017 01:00,1702,26.18,212,150,1490
19.07.2017 02:00,1653,25.76,182,132,1471
19.07.2017 03:00,1640,24.82,149,116,1491
19.07.2017 04:00,1649,24.04,126,103,1523
19.07.2017 05:00,1640,24.43,101,91,1539
19.07.2017 06:00,1677,26.04,83,71,1594
19.07.2017 07:00,1888,26.52,57,51,1831
19.07.2017 08:00,2171,34.45,18,38,2153
19.07.2017 09:00,2361,41.88,5,28,2356
19.07.2017 10:00,2422,39.12,5,24,2417
19.07.2017 11:00,2462,37.02,5,26,2457
19.07.2017 12:00,2460,34.49,5,29,2455
19.07.2017 13:00,2413,31.7,12,34,2401
19.07.2017 14:00,2384,31.71,14,39,2370
19.07.2017 15:00,2343,32.9,19,43,2324
19.07.2017 16:00,2323,35.66,30,49,2293
19.07.2017 17:00,2306,34.5,35,53,2271
19.07.2017 18:00,2332,34.48,35,59,2297
19.07.2017 19:00,2269,34.46,42,63,2227
19.07.2017 20:00,2176,31.57,59,66,2117
19.07.2017 21:00,2120,29.14,64,72,2056
19.07.2017 22:00,2078,28.6,90,90,1988
19.07.2017 23:00,2055,27.76,130,117,1925
20.07.2017 00:00,1909,26.29,145,129,1764
20.07.2017 01:00,1716,26.84,168,126,1548
20.07.2017 02:00,1652,25.63,173,149,1479
20.07.2017 03:00,1668,25.08,153,172,1515
20.07.2017 04:00,1711,25.09,146,198,1565
20.07.2017 05:00,1659,25.06,181,211,1478
20.07.2017 06:00,1629,26.18,230,237,1399
20.07.2017 07:00,1839,27.49,251,252,1588
20.07.2017 08:00,2051,29.99,243,251,1808
20.07.2017 09:00,2239,34.51,248,265,1991
20.07.2017 10:00,2284,37.07,310,295,1974
20.07.2017 11:00,2354,37.09,345,333,2009
20.07.2017 12:00,2364,37.05,379,357,1985
20.07.2017 13:00,2342,37.01,423,391,1919
20.07.2017 14:00,2357,37.02,396,391,1961
20.07.2017 15:00,2313,36.02,407,411,1906
20.07.2017 16:00,2282,34.88,415,410,1867
20.07.2017 17:00,2238,33.66,448,422,1790
20.07.2017 18:00,2254,35.63,441,431,1813
20.07.2017 19:00,2230,35.66,426,445,1804
20.07.2017 20:00,2191,35.65,374,432,1817
20.07.2017 21:00,2165,32.53,365,450,1800
20.07.2017 22:00,2096,32.25,406,461,1690
20.07.2017 23:00,2044,30.15,435,487,1609
21.07.2017 00:00,1928,27.46,417,497,1511
21.07.2017 01:00,1818,27.47,403,486,1415
21.07.2017 02:00,1756,26.92,384,484,1372
21.07.2017 03:00,1755,26.68,352,492,1403
21.07.2017 04:00,1756,26.21,359,482,1397
21.07.2017 05:00,1673,26.44,404,474,1269
21.07.2017 06:00,1641,27.4,456,454,1185
21.07.2017 07:00,1850,32.76,388,426,1462
21.07.2017 08:00,2188,35.35,307,397,1881
21.07.2017 09:00,2392,35.83,266,376,2126
21.07.2017 10:00,2482,38.87,259,360,2223
21.07.2017 11:00,2540,37.51,285,333,2255
21.07.2017 12:00,2540,38.1,294,343,2246
21.07.2017 13:00,2431,35.98,354,347,2077
21.07.2017 14:00,2352,32.94,422,354,1930
21.07.2017 15:00,2303,32.87,414,345,1889
21.07.2017 16:00,2275,32.9,358,339,1917
21.07.2017 17:00,2316,34.27,278,319,2038
21.07.2017 18:00,2376,34,225,307,2151
21.07.2017 19:00,2331,34.75,209,290,2122
21.07.2017 20:00,2259,35.44,201,277,2058
21.07.2017 21:00,2133,33.05,196,245,1937
21.07.2017 22:00,2058,32.61,219,234,1839
21.07.2017 23:00,1996,32.94,235,232,1761
22.07.2017 00:00,1833,31.9,269,224,1564
22.07.2017 01:00,1684,31.43,297,220,1387
22.07.2017 02:00,1668,27.93,248,233,1420
22.07.2017 03:00,1637,27.15,233,236,1404
22.07.2017 04:00,1671,27.04,224,252,1447
22.07.2017 05:00,1669,26.8,199,252,1470
22.07.2017 06:00,1615,26.75,215,255,1400
22.07.2017 07:00,1658,27.31,210,242,1448
22.07.2017 08:00,1787,30.18,162,228,1625
22.07.2017 09:00,1904,33.12,206,241,1698
22.07.2017 10:00,1959,33.85,316,260,1643
22.07.2017 11:00,2017,34.83,334,278,1683
22.07.2017 12:00,2028,33.83,364,321,1664
22.07.2017 13:00,1988,32.25,411,356,1577
22.07.2017 14:00,1958,30.02,391,368,1567
22.07.2017 15:00,1937,28.78,381,371,1556
22.07.2017 16:00,1942,29.18,345,365,1597
22.07.2017 17:00,1965,29.82,339,366,1626
22.07.2017 18:00,2060,32.45,307,373,1753
22.07.2017 19:00,2120,32.87,269,377,1851
22.07.2017 20:00,2023,32.33,284,351,1739
22.07.2017 21:00,1982,31.03,269,345,1713
22.07.2017 22:00,1946,30.6,287,357,1659
22.07.2017 23:00,1963,28.89,298,378,1665
23.07.2017 00:00,1841,27.05,319,385,1522
23.07.2017 01:00,1706,27.26,378,413,1328
23.07.2017 02:00,1633,27.02,420,437,1213
23.07.2017 03:00,1547,26.05,445,458,1102
23.07.2017 04:00,1444,24.68,552,495,892
23.07.2017 05:00,1364,23.07,617,518,747
23.07.2017 06:00,1285,23.96,662,535,623
23.07.2017 07:00,1326,23.9,680,545,646
23.07.2017 08:00,1475,25.17,617,540,858
23.07.2017 09:00,1602,25.78,658,559,944
23.07.2017 10:00,1735,26.67,720,622,1015
23.07.2017 11:00,1818,26.87,776,664,1042
23.07.2017 12:00,1883,27.18,790,695,1093
23.07.2017 13:00,1937,27.22,846,746,1091
23.07.2017 14:00,1896,26.45,882,765,1014
23.07.2017 15:00,1916,25.51,854,772,1062
23.07.2017 16:00,1983,25.87,763,751,1220
23.07.2017 17:00,2047,26.21,685,718,1362
23.07.2017 18:00,2173,27.05,596,693,1577
23.07.2017 19:00,2262,27.85,532,657,1730
23.07.2017 20:00,2222,28.77,489,592,1733
23.07.2017 21:00,2118,27.82,499,536,1619
23.07.2017 22:00,2055,27.91,496,518,1559
23.07.2017 23:00,2054,27.38,401,485,1653
24.07.2017 00:00,1956,27.09,327,449,1629
24.07.2017 01:00,1897,27.05,233,404,1664
24.07.2017 02:00,1768,26.68,256,372,1512
24.07.2017 03:00,1660,26.4,291,334,1369
24.07.2017 04:00,1678,26.08,256,321,1422
24.07.2017 05:00,1643,26.05,268,306,1375
24.07.2017 06:00,1701,26.94,249,293,1452
24.07.2017 07:00,1888,31.9,234,281,1654
24.07.2017 08:00,2096,37.46,228,271,1868
24.07.2017 09:00,2345,40.15,189,255,2156
24.07.2017 10:00,2476,45.28,172,245,2304
24.07.2017 11:00,2540,47.29,168,252,2372
24.07.2017 12:00,2521,46.62,194,241,2327
24.07.2017 13:00,2465,45.36,238,249,2227
24.07.2017 14:00,2468,43.83,245,260,2223
24.07.2017 15:00,2428,41.28,251,274,2177
24.07.2017 16:00,2337,39.96,314,289,2023
24.07.2017 17:00,2284,38.26,354,301,1930
24.07.2017 18:00,2283,38.75,370,303,1913
24.07.2017 19:00,2263,37.26,357,303,1906
24.07.2017 20:00,2240,37.73,322,302,1918
24.07.2017 21:00,2110,35.55,331,296,1779
24.07.2017 22:00,1977,33.89,400,291,1577
24.07.2017 23:00,1882,33.76,466,287,1416
25.07.2017 00:00,1719,29.66,482,306,1237
25.07.2017 01:00,1575,30.27,542,377,1033
25.07.2017 02:00,1494,28.26,571,391,923
25.07.2017 03:00,1449,26.79,614,415,835
25.07.2017 04:00,1450,26.81,643,432,807
25.07.2017 05:00,1456,26.04,644,474,812
25.07.2017 06:00,1469,26.21,662,495,807
25.07.2017 07:00,1699,27.11,679,503,1020
25.07.2017 08:00,1944,28.54,692,505,1252
25.07.2017 09:00,2182,29.76,649,518,1533
25.07.2017 10:00,2246,29.58,668,527,1578
25.07.2017 11:00,2329,30.5,674,541,1655
25.07.2017 12:00,2361,29.87,646,544,1715
25.07.2017 13:00,2430,29.77,535,521,1895
25.07.2017 14:00,2459,29.53,468,496,1991
25.07.2017 15:00,2414,29.48,454,450,1960
25.07.2017 16:00,2369,29.18,444,426,1925
25.07.2017 17:00,2309,28.87,434,408,1875
25.07.2017 18:00,2279,29.77,464,399,1815
25.07.2017 19:00,2221,32.34,459,391,1762
25.07.2017 20:00,2215,33.39,410,386,1805
25.07.2017 21:00,2167,32.89,403,401,1764
25.07.2017 22:00,2083,32.17,470,423,1613
25.07.2017 23:00,1991,31.44,525,454,1466
26.07.2017 00:00,1820,29.01,553,475,1267
26.07.2017 01:00,1727,26.59,567,550,1160
26.07.2017 02:00,1684,25.86,529,572,1155
26.07.2017 03:00,1627,25.07,567,582,1060
26.07.2017 04:00,1609,22.93,589,581,1020
26.07.2017 05:00,1626,23.08,582,588,1044
26.07.2017 06:00,1614,25.53,586,579,1028
26.07.2017 07:00,1878,27.33,544,573,1334
26.07.2017 08:00,2180,29.49,480,574,1700
26.07.2017 09:00,2389,29.91,452,566,1937
26.07.2017 10:00,2494,30.08,434,552,2060
26.07.2017 11:00,2569,32.1,411,527,2158
26.07.2017 12:00,2609,31.8,341,498,2268
26.07.2017 13:00,2578,36.32,300,454,2278
26.07.2017 14:00,2562,35.1,274,419,2288
26.07.2017 15:00,2513,35.21,240,373,2273
26.07.2017 16:00,2469,33.27,227,349,2242
26.07.2017 17:00,2431,31.22,209,335,2222
26.07.2017 18:00,2413,29.01,196,317,2217
26.07.2017 19:00,2372,28.94,172,303,2200
26.07.2017 20:00,2296,28.92,151,267,2145
26.07.2017 21:00,2209,28.98,126,258,2083
26.07.2017 22:00,2175,29.21,127,250,2048
26.07.2017 23:00,2111,29.56,144,238,1967
27.07.2017 00:00,1946,29.34,136,223,1810
27.07.2017 01:00,1767,28.06,131,172,1636
27.07.2017 02:00,1645,26.87,134,169,1511
27.07.2017 03:00,1593,25.36,148,169,1445
27.07.2017 04:00,1586,23.69,147,165,1439
27.07.2017 05:00,1597,25.08,138,158,1459
27.07.2017 06:00,1597,26.93,129,149,1468
27.07.2017 07:00,1831,28.48,120,134,1711
27.07.2017 08:00,2064,28.94,91,120,1973
27.07.2017 09:00,2258,31.91,65,99,2193
27.07.2017 10:00,2377,35.85,51,87,2326
27.07.2017 11:00,2435,37.13,50,73,2385
27.07.2017 12:00,2434,37.56,57,67,2377
27.07.2017 13:00,2416,37.57,74,74,2342
27.07.2017 14:00,2413,37.12,84,88,2329
27.07.2017 15:00,2393,35.14,98,97,2295
27.07.2017 16:00,2373,33.69,119,101,2254
27.07.2017 17:00,2328,33.57,128,103,2200
27.07.2017 18:00,2313,34.88,137,98,2176
27.07.2017 19:00,2317,33.96,93,90,2224
27.07.2017 20:00,2200,33.76,111,91,2089
27.07.2017 21:00,2095,30.23,133,87,1962
27.07.2017 22:00,2063,28.86,129,103,1934
27.07.2017 23:00,1980,29.18,187,123,1793
28.07.2017 00:00,1820,30.24,216,135,1604
28.07.2017 01:00,1690,29.67,221,150,1469
28.07.2017 02:00,1663,28.07,199,152,1464
28.07.2017 03:00,1617,27.42,192,160,1425
28.07.2017 04:00,1550,26.8,236,158,1314
28.07.2017 05:00,1559,26.46,241,163,1318
28.07.2017 06:00,1643,27.48,192,166,1451
28.07.2017 07:00,1856,29.13,154,161,1702
28.07.2017 08:00,2156,30.17,114,155,2042
28.07.2017 09:00,2344,34.73,100,177,2244
28.07.2017 10:00,2427,36.16,154,193,2273
28.07.2017 11:00,2426,34.65,194,202,2232
28.07.2017 12:00,2403,30.26,226,227,2177
28.07.2017 13:00,2342,27.51,290,270,2052
28.07.2017 14:00,2280,26.77,312,294,1968
28.07.2017 15:00,2248,26.59,316,316,1932
28.07.2017 16:00,2204,26.19,338,332,1866
28.07.2017 17:00,2162,26.81,360,342,1802
28.07.2017 18:00,2167,27.74,401,344,1766
28.07.2017 19:00,2169,27.83,386,339,1783
28.07.2017 20:00,2153,27.78,309,323,1844
28.07.2017 21:00,2114,27.67,283,343,1831
28.07.2017 22:00,2028,27.64,342,342,1686
28.07.2017 23:00,1994,27.62,387,349,1607
29.07.2017 00:00,1856,27.1,424,352,1432
29.07.2017 01:00,1693,27.1,441,339,1252
29.07.2017 02:00,1547,23.92,445,333,1102
29.07.2017 03:00,1542,19.61,384,299,1158
29.07.2017 04:00,1491,14.64,378,271,1113
29.07.2017 05:00,1472,10.37,345,244,1127
29.07.2017 06:00,1465,12.18,280,222,1185
29.07.2017 07:00,1526,14.88,244,205,1282
29.07.2017 08:00,1681,21.52,202,211,1479
29.07.2017 09:00,1795,23.72,279,246,1516
29.07.2017 10:00,1876,24.72,417,310,1459
29.07.2017 11:00,1964,25.99,531,425,1433
29.07.2017 12:00,2020,25.88,598,497,1422
29.07.2017 13:00,2019,24.99,680,562,1339
29.07.2017 14:00,2054,24.04,698,626,1356
29.07.2017 15:00,2091,22.97,665,655,1426
29.07.2017 16:00,2037,21.67,705,654,1332
29.07.2017 17:00,2149,22.9,598,661,1551
29.07.2017 18:00,2181,25.47,563,649,1618
29.07.2017 19:00,2125,27.01,554,590,1571
29.07.2017 20:00,1953,27.2,640,558,1313
29.07.2017 21:00,1963,27.21,541,534,1422
29.07.2017 22:00,2065,27.29,412,507,1653
29.07.2017 23:00,2035,27.46,371,452,1664
30.07.2017 00:00,1878,27.2,367,394,1511
30.07.2017 01:00,1734,26.06,360,339,1374
30.07.2017 02:00,1630,22.03,321,302,1309
30.07.2017 03:00,1584,22.3,266,258,1318
30.07.2017 04:00,1603,23.47,189,214,1414
30.07.2017 05:00,1615,22.2,131,174,1484
30.07.2017 06:00,1550,22.26,121,153,1429
30.07.2017 07:00,1517,22.26,170,140,1347
30.07.2017 08:00,1522,23.48,279,148,1243
30.07.2017 09:00,1692,24.39,295,192,1397
30.07.2017 10:00,1870,24.45,292,240,1578
30.07.2017 11:00,1969,25.36,337,321,1632
30.07.2017 12:00,2115,25.11,308,367,1807
30.07.2017 13:00,2216,25.35,290,415,1926
30.07.2017 14:00,2177,24.58,377,454,1800
30.07.2017 15:00,2194,24.15,380,478,1814
30.07.2017 16:00,2204,23.42,383,502,1821
30.07.2017 17:00,2347,21.27,265,503,2082
30.07.2017 18:00,2453,22.95,184,474,2269
30.07.2017 19:00,2337,24.81,238,431,2099
30.07.2017 20:00,2346,27.09,200,399,2146
30.07.2017 21:00,2236,27.32,263,382,1973
30.07.2017 22:00,2133,27.59,361,383,1772
30.07.2017 23:00,2036,27.54,387,378,1649
31.07.2017 00:00,1927,27.11,351,378,1576
31.07.2017 01:00,1863,26,336,472,1527
31.07.2017 02:00,1776,25.56,423,430,1353
31.07.2017 03:00,1760,25.28,382,388,1378
31.07.2017 04:00,1685,24.32,336,332,1349
31.07.2017 05:00,1648,24.64,290,288,1358
31.07.2017 06:00,1682,26.01,260,262,1422
31.07.2017 07:00,1892,26.97,230,232,1662
31.07.2017 08:00,2190,27.52,221,217,1969
31.07.2017 09:00,2401,27.73,225,231,2176
31.07.2017 10:00,2468,27.77,258,258,2210
31.07.2017 11:00,2536,27.77,291,296,2245
31.07.2017 12:00,2573,27.65,343,340,2230
31.07.2017 13:00,2521,27.55,382,385,2139
31.07.2017 14:00,2536,27.4,403,407,2133
31.07.2017 15:00,2549,27.35,429,439,2120
31.07.2017 16:00,2497,27.27,431,444,2066
31.07.2017 17:00,2447,27.26,438,451,2009
31.07.2017 18:00,2396,27.34,421,438,1975
31.07.2017 19:00,2357,27.39,385,397,1972
31.07.2017 20:00,2308,27.37,338,343,1970
31.07.2017 21:00,2224,27.41,314,311,1910
31.07.2017 22:00,2161,27.47,297,287,1864
31.07.2017 23:00,2102,27.51,283,279,1819
08.01.2017 00:00,1935,26.88,267,269,1668
08.01.2017 01:00,1758,26.97,244,246,1514
08.01.2017 02:00,1684,26.62,221,222,1463
08.01.2017 03:00,1640,26.18,199,200,1441
08.01.2017 04:00,1653,25.93,167,170,1486
08.01.2017 05:00,1687,25.95,138,140,1549
08.01.2017 06:00,1664,26.65,106,107,1558
08.01.2017 07:00,1847,26.91,74,75,1773
08.01.2017 08:00,2123,27.46,54,55,2069
08.01.2017 09:00,2298,27.75,44,45,2254
08.01.2017 10:00,2405,28.59,38,39,2367
08.01.2017 11:00,2490,29.35,38,39,2452
08.01.2017 12:00,2513,29.15,42,42,2471
08.01.2017 13:00,2488,28.89,42,44,2446
08.01.2017 14:00,2501,28.8,46,48,2455
08.01.2017 15:00,2475,28.46,47,49,2428
08.01.2017 16:00,2407,28.37,48,51,2359
08.01.2017 17:00,2325,28.29,49,52,2276
08.01.2017 18:00,2360,28.23,52,54,2308
08.01.2017 19:00,2303,28.57,55,51,2248
08.01.2017 20:00,2242,28.32,47,47,2195
08.01.2017 21:00,2185,27.81,47,46,2138
08.01.2017 22:00,2153,27.54,48,51,2105
08.01.2017 23:00,1995,27.49,55,54,1940
08.02.2017 00:00,1845,27.1,61,63,1784
08.02.2017 01:00,1730,26.73,48,49,1682
08.02.2017 02:00,1664,25.74,48,49,1616
08.02.2017 03:00,1590,25.36,54,55,1536
08.02.2017 04:00,1529,25.02,63,59,1466
08.02.2017 05:00,1465,25.16,84,78,1381
08.02.2017 06:00,1500,27.07,132,120,1368
08.02.2017 07:00,1712,29.53,170,154,1542
08.02.2017 08:00,2044,32.07,224,208,1820
08.02.2017 09:00,2273,35.69,263,253,2010
08.02.2017 10:00,2399,35.6,295,296,2104
08.02.2017 11:00,2457,35.09,325,333,2132
08.02.2017 12:00,2519,33.93,380,392,2139
08.02.2017 13:00,2525,32.16,460,460,2065
08.02.2017 14:00,2538,29.18,527,511,2011
08.02.2017 15:00,2529,28.87,571,549,1958
08.02.2017 16:00,2452,27.97,594,558,1858
08.02.2017 17:00,2378,28.12,580,555,1798
08.02.2017 18:00,2420,31.67,519,521,1901
08.02.2017 19:00,2388,31.2,449,457,1939
08.02.2017 20:00,2300,31.05,372,374,1928
08.02.2017 21:00,2196,30.83,304,308,1892
08.02.2017 22:00,2171,32.42,283,282,1888
08.02.2017 23:00,2026,30.44,253,260,1773
08.03.2017 00:00,1854,27.41,228,231,1626
08.03.2017 01:00,1715,27.43,197,202,1518
08.03.2017 02:00,1633,25.94,183,179,1450
08.03.2017 03:00,1594,24.76,160,155,1434
08.03.2017 04:00,1600,23.36,134,132,1466
08.03.2017 05:00,1627,23.39,105,109,1522
08.03.2017 06:00,1657,25.08,85,88,1572
08.03.2017 07:00,1925,26.7,81,80,1844
08.03.2017 08:00,2194,28.8,83,82,2111
08.03.2017 09:00,2348,32.52,102,95,2246
08.03.2017 10:00,2457,35.04,145,139,2312
08.03.2017 11:00,2573,35.03,168,178,2405
08.03.2017 12:00,2626,33.87,207,213,2419
08.03.2017 13:00,2520,30.57,272,251,2248
08.03.2017 14:00,2457,27.34,297,288,2160
08.03.2017 15:00,2461,26.89,289,305,2172
08.03.2017 16:00,2524,26.36,275,311,2249
08.03.2017 17:00,2550,25.95,289,317,2261
08.03.2017 18:00,2541,25.94,307,322,2234
08.03.2017 19:00,2463,26.82,375,343,2088
08.03.2017 20:00,2313,27.07,427,390,1886
08.03.2017 21:00,2267,26.8,443,450,1824
08.03.2017 22:00,2200,26.81,524,550,1676
08.03.2017 23:00,2083,26.67,615,617,1468
08.04.2017 00:00,1940,25.52,651,647,1289
08.04.2017 01:00,1722,25.16,631,645,1091
08.04.2017 02:00,1606,22.7,643,655,963
08.04.2017 03:00,1558,21.3,682,687,876
08.04.2017 04:00,1642,19.03,681,687,961
08.04.2017 05:00,1655,18.95,708,691,947
08.04.2017 06:00,1653,23.72,696,677,957
08.04.2017 07:00,1886,26,717,696,1169
08.04.2017 08:00,2163,26.12,715,708,1448
08.04.2017 09:00,2315,26.52,701,721,1614
08.04.2017 10:00,2371,26.61,702,731,1669
08.04.2017 11:00,2427,26.48,746,748,1681
08.04.2017 12:00,2356,25.61,786,796,1570
08.04.2017 13:00,2331,25.26,828,844,1503
08.04.2017 14:00,2334,25.06,902,904,1432
08.04.2017 15:00,2265,24.92,941,927,1324
08.04.2017 16:00,2188,24.85,948,951,1240
08.04.2017 17:00,2253,24.79,955,954,1298
08.04.2017 18:00,2439,24.82,966,965,1473
08.04.2017 19:00,2386,26.2,959,960,1427
08.04.2017 20:00,2194,26.06,950,946,1244
08.04.2017 21:00,2057,25.89,937,931,1120
08.04.2017 22:00,2023,25.86,929,919,1094
08.04.2017 23:00,1909,25.63,920,907,989
08.05.2017 00:00,1756,24.58,924,922,832
08.05.2017 01:00,1711,24,1007,1004,704
08.05.2017 02:00,1655,23.03,1026,1012,629
08.05.2017 03:00,1619,22,1030,1021,589
08.05.2017 04:00,1536,21.49,1028,1018,508
08.05.2017 05:00,1556,20.7,991,1012,565
08.05.2017 06:00,1547,20.44,997,1013,550
08.05.2017 07:00,1671,22.84,1015,1023,656
08.05.2017 08:00,1775,23.67,1018,1015,757
08.05.2017 09:00,1909,24.75,1022,1024,887
08.05.2017 10:00,2065,25.28,1006,1015,1059
08.05.2017 11:00,2208,25.82,990,1004,1218
08.05.2017 12:00,2243,25.73,958,1002,1285
08.05.2017 13:00,2186,25.06,976,998,1210
08.05.2017 14:00,2173,23.37,982,1004,1191
08.05.2017 15:00,2155,23.43,956,986,1199
08.05.2017 16:00,2119,24.55,930,955,1189
08.05.2017 17:00,2193,25.04,916,916,1277
08.05.2017 18:00,2219,25.88,867,872,1352
08.05.2017 19:00,2243,26.67,823,805,1420
08.05.2017 20:00,2147,26.78,736,715,1411
08.05.2017 21:00,2164,26.69,645,672,1519
08.05.2017 22:00,2146,27.3,600,630,1546
08.05.2017 23:00,1933,26.68,597,581,1336
08.06.2017 00:00,1747,25.24,609,574,1138
08.06.2017 01:00,1590,24.91,576,555,1014
08.06.2017 02:00,1534,20.57,586,587,948
08.06.2017 03:00,1552,18.03,574,578,978
08.06.2017 04:00,1591,16.59,575,584,1016
08.06.2017 05:00,1533,13.69,602,601,931
08.06.2017 06:00,1464,10.87,608,608,856
08.06.2017 07:00,1540,10.75,635,645,905
08.06.2017 08:00,1705,16.25,674,687,1031
08.06.2017 09:00,1842,20.24,743,760,1099
08.06.2017 10:00,1906,20.79,846,847,1060
08.06.2017 11:00,1938,22.68,909,909,1029
08.06.2017 12:00,2024,23.04,986,996,1038
08.06.2017 13:00,2043,23.14,1059,1055,984
08.06.2017 14:00,2066,20.72,1089,1095,977
08.06.2017 15:00,2040,20.36,1119,1111,921
08.06.2017 16:00,2009,20.47,1117,1104,892
08.06.2017 17:00,2042,22.17,1082,1100,960
08.06.2017 18:00,2105,22.69,1051,1080,1054
08.06.2017 19:00,2156,25.54,993,999,1163
08.06.2017 20:00,2142,26.67,885,895,1257
08.06.2017 21:00,2143,27.24,810,813,1333
08.06.2017 22:00,2114,31.13,755,745,1359
08.06.2017 23:00,1997,31.03,695,702,1302
08.07.2017 00:00,1847,26.97,678,696,1169
08.07.2017 01:00,1700,27.06,653,642,1047
08.07.2017 02:00,1664,25.96,639,618,1025
08.07.2017 03:00,1633,25.28,596,585,1037
08.07.2017 04:00,1637,24.8,551,549,1086
08.07.2017 05:00,1721,24.86,503,507,1218
08.07.2017 06:00,1771,28.28,449,458,1322
08.07.2017 07:00,2067,34.34,406,413,1661
08.07.2017 08:00,2415,37.8,365,369,2050
08.07.2017 09:00,2563,37.85,340,345,2223
08.07.2017 10:00,2540,36.42,334,341,2206
08.07.2017 11:00,2658,34.08,351,353,2307
08.07.2017 12:00,2679,33.14,368,364,2311
08.07.2017 13:00,2648,29.03,377,369,2271
08.07.2017 14:00,2641,27.53,375,378,2266
08.07.2017 15:00,2628,28.1,375,375,2253
08.07.2017 16:00,2543,29.04,375,371,2168
08.07.2017 17:00,2457,32.65,380,375,2077
08.07.2017 18:00,2426,36.95,363,356,2063
08.07.2017 19:00,2427,40.44,335,336,2092
08.07.2017 20:00,2376,40.8,305,304,2071
08.07.2017 21:00,2289,35.85,291,293,1998
08.07.2017 22:00,2174,35.06,304,302,1870
08.07.2017 23:00,2004,33.46,317,324,1687
08.08.2017 00:00,1822,26.69,322,332,1500
08.08.2017 01:00,1730,28.09,354,370,1376
08.08.2017 02:00,1650,26.86,333,348,1317
08.08.2017 03:00,1621,25.34,313,328,1308
08.08.2017 04:00,1618,24.59,295,309,1323
08.08.2017 05:00,1628,24.64,279,287,1349
08.08.2017 06:00,1672,26.96,253,259,1419
08.08.2017 07:00,1989,31,237,237,1752
08.08.2017 08:00,2372,35,204,206,2168
08.08.2017 09:00,2601,36.51,185,187,2416
08.08.2017 10:00,2680,37.06,194,194,2486
08.08.2017 11:00,2720,36.2,205,210,2515
08.08.2017 12:00,2661,36.38,254,255,2407
08.08.2017 13:00,2564,34.74,348,318,2216
08.08.2017 14:00,2570,31.51,396,362,2174
08.08.2017 15:00,2554,29.56,415,406,2139
08.08.2017 16:00,2505,30.95,463,463,2042
08.08.2017 17:00,2423,31.33,488,505,1935
08.08.2017 18:00,2484,32.36,531,545,1953
08.08.2017 19:00,2416,33.09,612,602,1804
08.08.2017 20:00,2391,30.09,631,630,1760
08.08.2017 21:00,2332,28.77,667,667,1665
08.08.2017 22:00,2265,28.52,707,708,1558
08.08.2017 23:00,2130,26.16,751,757,1379
08.09.2017 00:00,1954,24.68,780,795,1174
08.09.2017 01:00,1808,25,822,843,986
08.09.2017 02:00,1734,23.06,859,866,875
08.09.2017 03:00,1714,21.12,879,871,835
08.09.2017 04:00,1727,19.08,885,853,842
08.09.2017 05:00,1735,19.11,866,827,869
08.09.2017 06:00,1838,24.55,790,785,1048
08.09.2017 07:00,2234,25.87,706,734,1528
08.09.2017 08:00,2628,27.29,647,668,1981
08.09.2017 09:00,2752,32.56,563,570,2189
08.09.2017 10:00,2788,32.35,512,507,2276
08.09.2017 11:00,2831,31.49,451,441,2380
08.09.2017 12:00,2789,30.59,432,413,2357
08.09.2017 13:00,2741,27.74,414,401,2327
08.09.2017 14:00,2698,26.56,413,419,2285
08.09.2017 15:00,2640,27.09,434,434,2206
08.09.2017 16:00,2699,29.25,457,469,2242
08.09.2017 17:00,2552,28.64,493,495,2059
08.09.2017 18:00,2548,32.07,475,482,2073
08.09.2017 19:00,2493,30.73,461,460,2032
08.09.2017 20:00,2432,30.95,459,437,1973
08.09.2017 21:00,2310,29.9,416,412,1894
08.09.2017 22:00,2296,30.1,402,403,1894
08.09.2017 23:00,2096,28.68,413,419,1683
08.10.2017 00:00,1868,26.02,405,412,1463
08.10.2017 01:00,1735,27.05,403,405,1332
08.10.2017 02:00,1675,26,384,385,1291
08.10.2017 03:00,1672,25.41,366,369,1306
08.10.2017 04:00,1685,25.58,352,358,1333
08.10.2017 05:00,1695,25.39,349,353,1346
08.10.2017 06:00,1688,27.76,334,336,1354
08.10.2017 07:00,1950,33.57,315,314,1635
08.10.2017 08:00,2359,36.81,279,281,2080
08.10.2017 09:00,2599,40.88,263,259,2336
08.10.2017 10:00,2695,41.95,251,253,2444
08.10.2017 11:00,2746,41.95,248,254,2498
08.10.2017 12:00,2753,41.93,257,264,2496
08.10.2017 13:00,2678,41.63,250,253,2428
08.10.2017 14:00,2698,40.95,254,255,2444
08.10.2017 15:00,2697,39.2,278,280,2419
08.10.2017 16:00,2636,37.88,244,242,2392
08.10.2017 17:00,2564,36.24,235,226,2329
08.10.2017 18:00,2542,37.05,204,200,2338
08.10.2017 19:00,2496,38,166,172,2330
08.10.2017 20:00,2444,38.66,147,154,2297
08.10.2017 21:00,2361,35.6,123,127,2238
08.10.2017 22:00,2373,35.31,113,115,2260
08.10.2017 23:00,2251,33.94,116,118,2135
08.11.2017 00:00,2026,28.86,114,115,1912
08.11.2017 01:00,1906,28.99,110,111,1796
08.11.2017 02:00,1836,28.13,108,109,1728
08.11.2017 03:00,1844,27.03,101,102,1743
08.11.2017 04:00,1841,26.29,91,92,1750
08.11.2017 05:00,1860,26.12,79,76,1781
08.11.2017 06:00,1892,28.11,62,63,1830
08.11.2017 07:00,2133,31.79,47,48,2086
08.11.2017 08:00,2422,40.75,34,36,2388
08.11.2017 09:00,2607,46.98,24,25,2583
08.11.2017 10:00,2655,49.68,27,28,2628
08.11.2017 11:00,2713,51.18,33,30,2680
08.11.2017 12:00,2731,61.36,39,36,2692
08.11.2017 13:00,2696,52.65,38,40,2658
08.11.2017 14:00,2637,46.8,42,45,2595
08.11.2017 15:00,2521,39.09,48,50,2473
08.11.2017 16:00,2489,39.01,57,56,2432
08.11.2017 17:00,2424,36.88,77,64,2347
08.11.2017 18:00,2428,37.42,89,75,2339
08.11.2017 19:00,2372,38.08,110,85,2262
08.11.2017 20:00,2283,35.35,115,89,2168
08.11.2017 21:00,2240,33.49,91,77,2149
08.11.2017 22:00,2228,33.78,85,82,2143
08.11.2017 23:00,2112,29.39,72,82,2040
08.12.2017 00:00,2006,27.37,76,79,1930
08.12.2017 01:00,1878,25.63,70,80,1808
08.12.2017 02:00,1764,23.62,71,83,1693
08.12.2017 03:00,1684,21.23,84,89,1600
08.12.2017 04:00,1586,20.72,108,101,1478
08.12.2017 05:00,1696,19.31,110,110,1586
08.12.2017 06:00,1682,17.59,110,114,1572
08.12.2017 07:00,1741,20.37,112,116,1629
08.12.2017 08:00,1850,23.66,118,107,1732
08.12.2017 09:00,2043,24.37,99,102,1944
08.12.2017 10:00,2159,25.84,88,95,2071
08.12.2017 11:00,2237,25.56,106,111,2131
08.12.2017 12:00,2184,25.67,167,132,2017
08.12.2017 13:00,2184,25.1,192,180,1992
08.12.2017 14:00,2199,24.98,203,223,1996
08.12.2017 15:00,2163,24.96,212,227,1951
08.12.2017 16:00,2180,24.26,235,263,1945
08.12.2017 17:00,2154,24.87,278,282,1876
08.12.2017 18:00,2138,24.91,311,292,1827
08.12.2017 19:00,2132,25.42,313,310,1819
08.12.2017 20:00,2090,25.44,340,346,1750
08.12.2017 21:00,2025,25.67,365,367,1660
08.12.2017 22:00,1951,25.54,384,388,1567
08.12.2017 23:00,1790,24.02,419,419,1371
13.08.2017 00:00,1738,22.39,491,473,1247
13.08.2017 01:00,1693,23.66,522,498,1171
13.08.2017 02:00,1541,21.66,522,507,1019
13.08.2017 03:00,1526,20.42,504,506,1022
13.08.2017 04:00,1490,18.09,513,513,977
13.08.2017 05:00,1503,13.67,511,514,992
13.08.2017 06:00,1480,12.34,537,540,943
13.08.2017 07:00,1490,12.16,569,576,921
13.08.2017 08:00,1533,18.01,636,623,897
13.08.2017 09:00,1599,21.28,685,681,914
13.08.2017 10:00,1726,23.36,760,764,966
13.08.2017 11:00,1864,24.53,820,826,1044
13.08.2017 12:00,1963,24.82,848,854,1115
13.08.2017 13:00,2020,24.73,892,897,1128
13.08.2017 14:00,2005,24.69,911,910,1094
13.08.2017 15:00,2009,24.56,873,885,1136
13.08.2017 16:00,2022,23.68,832,846,1190
13.08.2017 17:00,2085,24.26,789,791,1296
13.08.2017 18:00,2153,24.81,707,714,1446
13.08.2017 19:00,2240,26.59,602,613,1638
13.08.2017 20:00,2308,27.78,484,498,1824
13.08.2017 21:00,2317,30.08,412,430,1905
13.08.2017 22:00,2255,33.21,368,374,1887
13.08.2017 23:00,2108,30.87,360,361,1748
14.08.2017 00:00,1952,27.37,353,359,1599
14.08.2017 01:00,1808,28.42,329,332,1479
14.08.2017 02:00,1718,26.37,309,315,1409
14.08.2017 03:00,1683,25.24,294,296,1389
14.08.2017 04:00,1734,25.17,263,269,1471
14.08.2017 05:00,1787,25.28,231,239,1556
14.08.2017 06:00,1897,27.64,209,211,1688
14.08.2017 07:00,2146,32.9,178,179,1968
14.08.2017 08:00,2511,37.9,136,139,2375
14.08.2017 09:00,2707,39.39,121,123,2586
14.08.2017 10:00,2716,38.23,111,113,2605
14.08.2017 11:00,2780,39.12,105,107,2675
14.08.2017 12:00,2754,39.22,101,103,2653
14.08.2017 13:00,2751,39.02,101,104,2650
14.08.2017 14:00,2728,39.13,110,113,2618
14.08.2017 15:00,2677,37.8,93,94,2584
14.08.2017 16:00,2737,36.99,103,104,2634
14.08.2017 17:00,2653,35.27,101,103,2552
14.08.2017 18:00,2629,36.68,91,93,2538
14.08.2017 19:00,2568,39.64,83,85,2485
14.08.2017 20:00,2476,41.32,80,81,2396
14.08.2017 21:00,2479,37.47,98,94,2381
14.08.2017 22:00,2504,36.74,109,104,2395
14.08.2017 23:00,2341,31.57,114,118,2227
15.08.2017 00:00,2154,26.82,113,121,2041
15.08.2017 01:00,1983,26.78,92,96,1891
15.08.2017 02:00,1937,26.33,103,106,1834
15.08.2017 03:00,1916,25.34,123,132,1793
15.08.2017 04:00,1876,25.31,161,169,1715
15.08.2017 05:00,1852,25.3,204,216,1648
15.08.2017 06:00,1909,27.56,251,267,1658
15.08.2017 07:00,2119,33.53,285,299,1834
15.08.2017 08:00,2452,35,302,314,2150
15.08.2017 09:00,2717,36.73,310,325,2407
15.08.2017 10:00,2745,34.97,353,361,2392
15.08.2017 11:00,2792,33.76,408,403,2384
15.08.2017 12:00,2807,31.91,451,445,2356
15.08.2017 13:00,2775,31.45,500,494,2275
15.08.2017 14:00,2760,31.35,563,550,2197
15.08.2017 15:00,2711,31.42,614,594,2097
15.08.2017 16:00,2702,31.31,652,634,2050
15.08.2017 17:00,2548,30.42,675,661,1873
15.08.2017 18:00,2535,31.52,696,687,1839
15.08.2017 19:00,2464,35.06,710,702,1754
15.08.2017 20:00,2487,35.3,737,740,1750
15.08.2017 21:00,2432,35.24,747,759,1685
15.08.2017 22:00,2366,34.11,766,772,1600
15.08.2017 23:00,2195,29.04,794,784,1401
16.08.2017 00:00,2026,27.1,803,786,1223
16.08.2017 01:00,1961,26.66,813,816,1148
16.08.2017 02:00,2092,26.06,728,782,1364
16.08.2017 03:00,2106,25.84,684,730,1422
16.08.2017 04:00,2161,25.83,632,659,1529
16.08.2017 05:00,2197,26.05,553,558,1644
16.08.2017 06:00,2260,27.42,471,479,1789
16.08.2017 07:00,2455,34.14,403,406,2052
16.08.2017 08:00,2777,37.61,373,370,2404
16.08.2017 09:00,2897,42,374,367,2523
16.08.2017 10:00,2911,42.39,371,362,2540
16.08.2017 11:00,2979,41.93,359,360,2620
16.08.2017 12:00,2940,41.92,288,295,2652
16.08.2017 13:00,2910,40.32,308,317,2602
16.08.2017 14:00,2921,40.03,305,311,2616
16.08.2017 15:00,2860,38.47,287,290,2573
16.08.2017 16:00,2759,35.35,237,240,2522
16.08.2017 17:00,2684,37.16,251,252,2433
16.08.2017 18:00,2676,39.94,191,192,2485
16.08.2017 19:00,2611,41.93,171,171,2440
16.08.2017 20:00,2584,43.15,154,154,2430
16.08.2017 21:00,2549,41.95,144,147,2405
16.08.2017 22:00,2551,40.1,150,153,2401
16.08.2017 23:00,2375,36.02,157,158,2218
17.08.2017 00:00,2145,31.36,160,161,1985
17.08.2017 01:00,1937,30.03,123,124,1814
17.08.2017 02:00,1836,29.09,115,116,1721
17.08.2017 03:00,1838,27.55,104,105,1734
17.08.2017 04:00,1852,27.49,96,98,1756
17.08.2017 05:00,1870,29.15,91,89,1779
17.08.2017 06:00,1947,30.42,83,81,1864
17.08.2017 07:00,2186,38.17,79,79,2107
17.08.2017 08:00,2507,47.35,78,80,2429
17.08.2017 09:00,2663,47.32,81,83,2582
17.08.2017 10:00,2713,50.04,89,81,2624
17.08.2017 11:00,2754,50.06,113,102,2641
17.08.2017 12:00,2799,53.88,140,141,2659
17.08.2017 13:00,2761,50.36,154,155,2607
17.08.2017 14:00,2751,50.01,212,207,2539
17.08.2017 15:00,2640,47.77,231,210,2409
17.08.2017 16:00,2647,40.73,288,266,2359
17.08.2017 17:00,2555,36.26,310,292,2245
17.08.2017 18:00,2572,36.19,352,333,2220
17.08.2017 19:00,2529,37.42,397,365,2132
17.08.2017 20:00,2467,38.04,415,408,2052
17.08.2017 21:00,2394,37.45,478,459,1916
17.08.2017 22:00,2365,36.71,435,480,1930
17.08.2017 23:00,2229,31.73,448,510,1781
18.08.2017 00:00,2110,29.09,419,480,1691
18.08.2017 01:00,2034,28.5,454,472,1580
18.08.2017 02:00,1993,28.29,414,422,1579
18.08.2017 03:00,1944,27.28,366,373,1578
18.08.2017 04:00,1927,26.35,330,338,1597
18.08.2017 05:00,1947,27.7,314,322,1633
18.08.2017 06:00,2086,28.61,299,303,1787
18.08.2017 07:00,2328,33.63,291,288,2037
18.08.2017 08:00,2669,38.86,269,260,2400
18.08.2017 09:00,2827,43.29,239,238,2588
18.08.2017 10:00,2898,44.47,252,252,2646
18.08.2017 11:00,2896,48.01,225,224,2671
18.08.2017 12:00,2819,48.05,258,256,2561
18.08.2017 13:00,2866,40.96,317,317,2549
18.08.2017 14:00,2754,40.05,281,281,2473
18.08.2017 15:00,2661,38.69,290,289,2371
18.08.2017 16:00,2621,40.39,277,281,2344
18.08.2017 17:00,2542,33.89,258,267,2284
18.08.2017 18:00,2604,35.71,257,266,2347
18.08.2017 19:00,2520,37.43,223,232,2297
18.08.2017 20:00,2428,38.7,195,201,2233
18.08.2017 21:00,2373,36.99,189,190,2184
18.08.2017 22:00,2323,37.02,174,177,2149
18.08.2017 23:00,2127,34.95,161,164,1966
19.08.2017 00:00,1981,29.45,152,152,1829
19.08.2017 01:00,1756,29.12,187,168,1569
19.08.2017 02:00,1621,27.23,228,225,1393
19.08.2017 03:00,1605,26.92,257,260,1348
19.08.2017 04:00,1590,26.32,305,302,1285
19.08.2017 05:00,1563,25.83,358,334,1205
19.08.2017 06:00,1574,25.87,399,379,1175
19.08.2017 07:00,1700,26.62,405,427,1295
19.08.2017 08:00,1893,29.41,433,455,1460
19.08.2017 09:00,2044,29.46,468,485,1576
19.08.2017 10:00,2171,31.71,501,506,1670
19.08.2017 11:00,2175,32.31,514,513,1661
19.08.2017 12:00,2184,31.66,551,553,1633
19.08.2017 13:00,2080,30.24,597,594,1483
19.08.2017 14:00,2090,28.94,641,635,1449
19.08.2017 15:00,2062,27.07,676,662,1386
19.08.2017 16:00,2043,26.19,698,684,1345
19.08.2017 17:00,2048,26.22,719,688,1329
19.08.2017 18:00,2051,26.57,675,670,1376
19.08.2017 19:00,2081,27.04,606,631,1475
19.08.2017 20:00,2091,26.88,599,594,1492
19.08.2017 21:00,2120,26.63,550,571,1570
19.08.2017 22:00,2050,27,559,547,1491
19.08.2017 23:00,1886,25.33,560,537,1326
20.08.2017 00:00,1795,24.41,542,534,1253
20.08.2017 01:00,1722,24.19,531,525,1191
20.08.2017 02:00,1683,22.44,474,496,1209
20.08.2017 03:00,1657,21.36,453,460,1204
20.08.2017 04:00,1599,21.1,434,430,1165
20.08.2017 05:00,1619,20.01,411,406,1208
20.08.2017 06:00,1602,18.24,413,418,1189
20.08.2017 07:00,1613,20.48,404,408,1209
20.08.2017 08:00,1737,23.25,418,420,1319
20.08.2017 09:00,1918,24.07,435,435,1483
20.08.2017 10:00,2000,25.51,458,472,1542
20.08.2017 11:00,2056,26.34,510,515,1546
20.08.2017 12:00,2122,26.47,543,556,1579
20.08.2017 13:00,2109,26.16,588,576,1521
20.08.2017 14:00,2102,25.79,616,595,1486
20.08.2017 15:00,2105,25.73,602,586,1503
20.08.2017 16:00,2111,25.68,545,568,1566
20.08.2017 17:00,2229,26.17,495,530,1734
20.08.2017 18:00,2211,27.15,434,455,1777
20.08.2017 19:00,2257,27.55,373,377,1884
20.08.2017 20:00,2283,27.47,338,331,1945
20.08.2017 21:00,2278,28.5,291,307,1987
20.08.2017 22:00,2222,30.57,273,292,1949
20.08.2017 23:00,2028,29.06,299,294,1729
21.08.2017 00:00,1871,26.4,311,290,1560
21.08.2017 01:00,1812,24.32,282,279,1530
21.08.2017 02:00,1764,23.72,255,259,1509
21.08.2017 03:00,1761,23.43,224,234,1537
21.08.2017 04:00,1758,23.69,201,202,1557
21.08.2017 05:00,1802,23.11,206,186,1596
21.08.2017 06:00,1938,24,181,169,1757
21.08.2017 07:00,2273,30.77,151,150,2122
21.08.2017 08:00,2661,38.27,135,153,2526
21.08.2017 09:00,2802,42.69,116,136,2686
21.08.2017 10:00,2850,45.03,125,141,2725
21.08.2017 11:00,2880,47.85,134,142,2746
21.08.2017 12:00,2847,48.09,124,134,2723
21.08.2017 13:00,2767,48.01,159,151,2608
21.08.2017 14:00,2691,47.85,176,176,2515
21.08.2017 15:00,2667,45.54,188,201,2479
21.08.2017 16:00,2671,43.98,209,219,2462
21.08.2017 17:00,2561,39.78,212,225,2349
21.08.2017 18:00,2562,45.03,222,232,2340
21.08.2017 19:00,2531,40.5,202,208,2329
21.08.2017 20:00,2518,41.86,184,186,2334
21.08.2017 21:00,2496,41.01,189,179,2307
21.08.2017 22:00,2361,40.31,169,178,2192
21.08.2017 23:00,2162,36.99,181,207,1981
22.08.2017 00:00,1973,31.24,212,217,1761
22.08.2017 01:00,1853,31.98,241,241,1612
22.08.2017 02:00,1819,29.7,246,248,1573
22.08.2017 03:00,1861,29.53,235,257,1626
22.08.2017 04:00,1873,27.9,225,244,1648
22.08.2017 05:00,1905,27.78,206,225,1699
22.08.2017 06:00,1972,31.78,207,213,1765
22.08.2017 07:00,2210,37.71,208,199,2002
22.08.2017 08:00,2590,48.04,184,187,2406
22.08.2017 09:00,2695,57.35,153,163,2542
22.08.2017 10:00,2686,57.39,139,151,2547
22.08.2017 11:00,2707,59.95,130,132,2577
22.08.2017 12:00,2728,59.98,129,135,2599
22.08.2017 13:00,2661,59.92,149,145,2512
22.08.2017 14:00,2621,57.39,148,150,2473
22.08.2017 15:00,2618,57.34,157,164,2461
22.08.2017 16:00,2619,50.02,158,174,2461
22.08.2017 17:00,2583,39.04,159,168,2424
22.08.2017 18:00,2608,45.08,159,152,2449
22.08.2017 19:00,2593,44.71,149,145,2444
22.08.2017 20:00,2548,48.17,132,129,2416
22.08.2017 21:00,2541,45.07,121,120,2420
22.08.2017 22:00,2508,43.38,114,115,2394
22.08.2017 23:00,2297,38.81,102,105,2195
23.08.2017 00:00,2071,34.85,104,105,1967
23.08.2017 01:00,1960,31.82,113,114,1847
23.08.2017 02:00,1909,31.7,121,121,1788
23.08.2017 03:00,1828,30.36,124,123,1704
23.08.2017 04:00,1774,30.4,124,114,1650
23.08.2017 05:00,1810,30.07,133,125,1677
23.08.2017 06:00,1911,31.74,130,120,1781
23.08.2017 07:00,2224,39.07,122,119,2102
23.08.2017 08:00,2512,99.98,104,103,2408
23.08.2017 09:00,2749,120.01,77,77,2672
23.08.2017 10:00,2731,105.57,66,69,2665
23.08.2017 11:00,2712,100,64,63,2648
23.08.2017 12:00,2732,85.06,62,59,2670
23.08.2017 13:00,2668,79.83,63,57,2605
23.08.2017 14:00,2654,81.05,69,59,2585
23.08.2017 15:00,2623,86.01,64,59,2559
23.08.2017 16:00,2601,65.19,56,60,2545
23.08.2017 17:00,2505,49.12,63,64,2442
23.08.2017 18:00,2513,75.34,63,62,2450
23.08.2017 19:00,2462,49.03,58,60,2404
23.08.2017 20:00,2444,49.24,58,59,2386
23.08.2017 21:00,2460,44.96,59,53,2401
23.08.2017 22:00,2413,41.92,55,49,2358
23.08.2017 23:00,2215,35.96,50,52,2165
24.08.2017 00:00,2069,31.29,50,54,2019
24.08.2017 01:00,1949,30.72,47,50,1902
24.08.2017 02:00,1886,31.04,49,50,1837
24.08.2017 03:00,1882,30.9,54,55,1828
24.08.2017 04:00,1891,30.92,55,56,1836
24.08.2017 05:00,1971,29.18,57,58,1914
24.08.2017 06:00,2088,31.01,59,60,2029
24.08.2017 07:00,2369,37.35,64,65,2305
24.08.2017 08:00,2706,48.02,66,66,2640
24.08.2017 09:00,2797,48.39,62,63,2735
24.08.2017 10:00,2793,50.51,57,61,2736
24.08.2017 11:00,2810,54.39,65,68,2745
24.08.2017 12:00,2814,50.94,82,86,2732
24.08.2017 13:00,2789,53.87,92,98,2697
24.08.2017 14:00,2799,54.5,107,115,2692
24.08.2017 15:00,2776,49.08,131,137,2645
24.08.2017 16:00,2743,45.22,155,156,2588
24.08.2017 17:00,2662,39.73,154,156,2508
24.08.2017 18:00,2669,44.83,186,187,2483
24.08.2017 19:00,2602,42.75,189,198,2413
24.08.2017 20:00,2622,44.89,185,207,2437
24.08.2017 21:00,2632,44.55,197,219,2435
24.08.2017 22:00,2485,41.88,259,262,2226
24.08.2017 23:00,2206,36.67,305,307,1901
25.08.2017 00:00,1886,33.14,346,334,1540
25.08.2017 01:00,1829,32.63,450,429,1379
25.08.2017 02:00,1851,31.31,460,459,1391
25.08.2017 03:00,1855,30.13,458,470,1397
25.08.2017 04:00,1806,29.99,473,478,1333
25.08.2017 05:00,1782,30.68,537,527,1245
25.08.2017 06:00,1884,32.28,608,577,1276
25.08.2017 07:00,2144,40.01,636,605,1508
25.08.2017 08:00,2543,43.97,663,648,1880
25.08.2017 09:00,2633,47.41,706,696,1927
25.08.2017 10:00,2705,49.61,791,798,1914
25.08.2017 11:00,2728,50.05,815,826,1913
25.08.2017 12:00,2686,47.7,841,840,1845
25.08.2017 13:00,2570,43.37,825,830,1745
25.08.2017 14:00,2564,41.03,826,842,1738
25.08.2017 15:00,2523,39.76,794,816,1729
25.08.2017 16:00,2491,38.56,745,766,1746
25.08.2017 17:00,2473,36.04,683,698,1790
25.08.2017 18:00,2534,40.41,630,635,1904
25.08.2017 19:00,2507,42.93,537,532,1970
25.08.2017 20:00,2446,45.7,440,440,2006
25.08.2017 21:00,2388,45.4,401,398,1987
25.08.2017 22:00,2304,41.24,343,350,1961
25.08.2017 23:00,2091,37.93,319,328,1772
26.08.2017 00:00,1922,34.6,303,309,1619
26.08.2017 01:00,1757,34.75,263,262,1494
26.08.2017 02:00,1737,32.21,249,249,1488
26.08.2017 03:00,1725,31.38,237,233,1488
26.08.2017 04:00,1705,30.89,209,208,1496
26.08.2017 05:00,1712,30.61,186,193,1526
26.08.2017 06:00,1722,30.29,166,167,1556
26.08.2017 07:00,1733,30.47,139,139,1594
26.08.2017 08:00,1888,31.14,118,121,1770
26.08.2017 09:00,2114,35.68,104,108,2010
26.08.2017 10:00,2281,36.84,114,116,2167
26.08.2017 11:00,2338,36.52,126,128,2212
26.08.2017 12:00,2351,35.85,140,142,2211
26.08.2017 13:00,2281,32.31,134,136,2147
26.08.2017 14:00,2192,31.93,139,141,2053
26.08.2017 15:00,2183,31.59,144,145,2039
26.08.2017 16:00,2158,32.71,116,114,2042
26.08.2017 17:00,2167,32.96,115,117,2052
26.08.2017 18:00,2178,36.82,99,103,2079
26.08.2017 19:00,2180,39.67,89,89,2091
26.08.2017 20:00,2146,42,75,77,2071
26.08.2017 21:00,2147,42.38,66,66,2081
26.08.2017 22:00,2035,39.97,67,60,1968
26.08.2017 23:00,1929,37.52,55,54,1874
27.08.2017 00:00,1829,34.06,51,51,1778
27.08.2017 01:00,1710,34.95,47,49,1663
27.08.2017 02:00,1656,32.2,40,42,1616
27.08.2017 03:00,1636,31.31,36,38,1600
27.08.2017 04:00,1631,31.18,37,36,1594
27.08.2017 05:00,1637,31.17,32,33,1605
27.08.2017 06:00,1636,31.13,28,29,1608
27.08.2017 07:00,1647,31.58,27,28,1620
27.08.2017 08:00,1726,32.98,30,31,1696
27.08.2017 09:00,1852,34.79,66,29,1786
27.08.2017 10:00,2022,35.63,65,30,1957
27.08.2017 11:00,2153,38.63,48,57,2105
27.08.2017 12:00,2191,38.68,71,59,2120
27.08.2017 13:00,2218,36.9,79,81,2139
27.08.2017 14:00,2156,34.24,152,115,2004
27.08.2017 15:00,2088,33.53,147,125,1941
27.08.2017 16:00,2071,33.29,117,122,1954
27.08.2017 17:00,2081,32.94,131,154,1950
27.08.2017 18:00,2047,32.38,137,140,1910
27.08.2017 19:00,2029,35.2,154,139,1875
27.08.2017 20:00,2069,38.96,143,129,1926
27.08.2017 21:00,2220,42.21,122,124,2098
27.08.2017 22:00,2174,42.43,108,119,2066
27.08.2017 23:00,2003,38,103,103,1900
28.08.2017 00:00,1835,34.2,98,93,1737
28.08.2017 01:00,1775,33.54,107,101,1668
28.08.2017 02:00,1762,30.94,91,89,1671
28.08.2017 03:00,1750,30.64,74,73,1676
28.08.2017 04:00,1739,30.4,61,61,1678
28.08.2017 05:00,1804,30.42,54,56,1750
28.08.2017 06:00,1927,31.99,47,48,1880
28.08.2017 07:00,2244,42.13,45,46,2199
28.08.2017 08:00,2590,74.8,39,41,2551
28.08.2017 09:00,2745,81.98,32,34,2713
28.08.2017 10:00,2779,74.8,27,29,2752
28.08.2017 11:00,2815,74.79,28,30,2787
28.08.2017 12:00,2768,70.63,33,35,2735
28.08.2017 13:00,2665,54.09,42,42,2623
28.08.2017 14:00,2631,50.55,58,55,2573
28.08.2017 15:00,2700,46.84,73,67,2627
28.08.2017 16:00,2675,44.7,88,81,2587
28.08.2017 17:00,2579,39.75,101,99,2478
28.08.2017 18:00,2572,44.93,112,106,2460
28.08.2017 19:00,2525,46.6,116,110,2409
28.08.2017 20:00,2461,50,125,116,2336
28.08.2017 21:00,2449,47.36,141,136,2308
28.08.2017 22:00,2352,41.23,146,148,2206
28.08.2017 23:00,2191,35.87,153,160,2038
29.08.2017 00:00,2012,32,167,175,1845
29.08.2017 01:00,1892,30.17,203,206,1689
29.08.2017 02:00,1815,29.67,226,231,1589
29.08.2017 03:00,1779,29.52,243,245,1536
29.08.2017 04:00,1827,29.31,247,254,1580
29.08.2017 05:00,1865,29.38,250,257,1615
29.08.2017 06:00,1941,29.95,245,254,1696
29.08.2017 07:00,2166,35,232,244,1934
29.08.2017 08:00,2478,39.91,227,240,2251
29.08.2017 09:00,2610,43.4,218,231,2392
29.08.2017 10:00,2683,49.25,232,243,2451
29.08.2017 11:00,2742,46.92,255,267,2487
29.08.2017 12:00,2719,46.01,310,317,2409
29.08.2017 13:00,2625,46.04,366,369,2259
29.08.2017 14:00,2597,51.96,417,421,2180
29.08.2017 15:00,2536,43.04,444,447,2092
29.08.2017 16:00,2483,40.46,462,470,2021
29.08.2017 17:00,2449,38.71,471,473,1978
29.08.2017 18:00,2519,39.3,470,475,2049
29.08.2017 19:00,2563,41.12,447,460,2116
29.08.2017 20:00,2538,41.8,449,471,2089
29.08.2017 21:00,2467,41.24,470,481,1997
29.08.2017 22:00,2359,38.3,496,495,1863
29.08.2017 23:00,2165,34.2,528,525,1637
30.08.2017 00:00,2024,31.18,516,523,1508
30.08.2017 01:00,2050,31.19,510,524,1540
30.08.2017 02:00,2049,30.26,494,490,1555
30.08.2017 03:00,2017,29.83,454,446,1563
30.08.2017 04:00,2114,29.56,396,395,1718
30.08.2017 05:00,2099,29.6,326,336,1773
30.08.2017 06:00,2058,30.82,269,272,1789
30.08.2017 07:00,2265,36.51,215,216,2050
30.08.2017 08:00,2697,42,171,173,2526
30.08.2017 09:00,2790,48.02,134,137,2656
30.08.2017 10:00,2832,48.04,112,114,2720
30.08.2017 11:00,2822,48.01,91,93,2731
30.08.2017 12:00,2893,48.36,85,87,2808
30.08.2017 13:00,2894,54,76,79,2818
30.08.2017 14:00,2896,52.96,73,78,2823
30.08.2017 15:00,2858,48.01,64,70,2794
30.08.2017 16:00,2842,48.01,72,77,2770
30.08.2017 17:00,2732,42.56,77,77,2655
30.08.2017 18:00,2723,42.46,84,88,2639
30.08.2017 19:00,2614,41.37,95,101,2519
30.08.2017 20:00,2556,40.07,119,126,2437
30.08.2017 21:00,2550,39.49,162,162,2388
30.08.2017 22:00,2393,37.04,178,195,2215
30.08.2017 23:00,2144,32.48,212,229,1932
31.08.2017 00:00,1924,30.57,244,256,1680
31.08.2017 01:00,1860,30.57,339,342,1521
31.08.2017 02:00,1840,29.97,355,356,1485
31.08.2017 03:00,1835,29.75,335,343,1500
31.08.2017 04:00,1899,29.25,291,309,1608
31.08.2017 05:00,2000,29.54,270,286,1730
31.08.2017 06:00,2137,30.42,247,256,1890
31.08.2017 07:00,2430,33.79,227,234,2203
31.08.2017 08:00,2768,39.92,225,233,2543
31.08.2017 09:00,2901,45.75,218,226,2683
31.08.2017 10:00,2907,48.07,200,204,2707
31.08.2017 11:00,2903,49.04,183,186,2720
31.08.2017 12:00,2921,47.49,201,208,2720
31.08.2017 13:00,2851,46.72,238,246,2613
31.08.2017 14:00,2799,45.8,290,293,2509
31.08.2017 15:00,2684,42.41,353,343,2331
31.08.2017 16:00,2623,42.01,395,389,2228
31.08.2017 17:00,2486,40.19,442,446,2044
31.08.2017 18:00,2512,41.9,479,465,2033
31.08.2017 19:00,2447,43.08,476,473,1971
31.08.2017 20:00,2479,41.4,495,497,1984
31.08.2017 21:00,2503,42.64,524,496,1979
31.08.2017 22:00,2373,38.69,517,487,1856
31.08.2017 23:00,2217,35.36,491,487,1726
09.01.2017 00:00,2028,32.53,468,491,1560
09.01.2017 01:00,1908,31.82,453,464,1455
09.01.2017 02:00,1808,30.95,447,438,1361
09.01.2017 03:00,1797,30.21,405,408,1392
09.01.2017 04:00,1756,29.64,377,377,1379
09.01.2017 05:00,1783,30.46,351,356,1432
09.01.2017 06:00,1935,31.51,321,325,1614
09.01.2017 07:00,2246,35.43,281,284,1965
09.01.2017 08:00,2627,41.05,247,248,2380
09.01.2017 09:00,2758,45.83,216,215,2542
09.01.2017 10:00,2751,46.03,188,189,2563
09.01.2017 11:00,2763,47.81,181,180,2582
09.01.2017 12:00,2757,49.16,180,180,2577
09.01.2017 13:00,2671,48.95,177,178,2494
09.01.2017 14:00,2612,45.75,170,173,2442
09.01.2017 15:00,2540,44.94,158,162,2382
09.01.2017 16:00,2477,42.86,142,145,2335
09.01.2017 17:00,2467,42.21,129,133,2338
09.01.2017 18:00,2465,42.68,121,123,2344
09.01.2017 19:00,2373,42.2,103,105,2270
09.01.2017 20:00,2302,43.74,100,102,2202
09.01.2017 21:00,2323,43.95,105,103,2218
09.01.2017 22:00,2214,39.2,111,110,2103
09.01.2017 23:00,2088,36.21,113,116,1975
09.02.2017 00:00,1902,34.44,116,118,1786
09.02.2017 01:00,1816,32.22,122,123,1694
09.02.2017 02:00,1749,31.29,131,132,1618
09.02.2017 03:00,1680,30.85,138,134,1542
09.02.2017 04:00,1692,30.62,134,132,1558
09.02.2017 05:00,1702,30.7,131,132,1571
09.02.2017 06:00,1741,30.7,128,126,1613
09.02.2017 07:00,1784,31.1,126,125,1658
09.02.2017 08:00,1932,32.39,125,124,1807
09.02.2017 09:00,2131,35.1,118,115,2013
09.02.2017 10:00,2249,38,104,100,2145
09.02.2017 11:00,2307,38.15,91,93,2216
09.02.2017 12:00,2314,38.03,94,95,2220
09.02.2017 13:00,2294,35.37,90,95,2204
09.02.2017 14:00,2258,33.91,92,98,2166
09.02.2017 15:00,2195,33.08,94,100,2101
09.02.2017 16:00,2152,32.5,97,101,2055
09.02.2017 17:00,2139,32.44,102,106,2037
09.02.2017 18:00,2214,33.94,104,106,2110
09.02.2017 19:00,2190,37.25,112,110,2078
09.02.2017 20:00,2146,40.32,128,118,2018
09.02.2017 21:00,2216,40.52,133,129,2083
09.02.2017 22:00,2131,37.08,140,141,1991
09.02.2017 23:00,2006,34.61,154,156,1852
09.03.2017 00:00,1920,32.05,169,169,1751
09.03.2017 01:00,1833,32.29,169,169,1664
09.03.2017 02:00,1707,31.41,170,172,1537
09.03.2017 03:00,1645,31,188,188,1457
09.03.2017 04:00,1674,30.77,208,208,1466
09.03.2017 05:00,1688,30.62,223,223,1465
09.03.2017 06:00,1759,30.44,234,235,1525
09.03.2017 07:00,1767,30.98,243,245,1524
09.03.2017 08:00,1847,32.18,247,248,1600
09.03.2017 09:00,2013,33.37,255,257,1758
09.03.2017 10:00,2161,34.4,256,257,1905
09.03.2017 11:00,2192,34.64,266,269,1926
09.03.2017 12:00,2165,34.48,276,278,1889
09.03.2017 13:00,2195,34.46,308,310,1887
09.03.2017 14:00,2200,33.46,333,335,1867
09.03.2017 15:00,2179,32.64,344,346,1835
09.03.2017 16:00,2167,32.34,350,349,1817
09.03.2017 17:00,2145,32.32,357,355,1788
09.03.2017 18:00,2116,33.46,366,363,1750
09.03.2017 19:00,2124,35.01,395,385,1729
09.03.2017 20:00,2175,38.02,415,403,1760
09.03.2017 21:00,2282,42.27,397,399,1885
09.03.2017 22:00,2178,37.51,370,376,1808
09.03.2017 23:00,2039,33.81,368,370,1671
09.04.2017 00:00,1916,32.27,373,380,1543
09.04.2017 01:00,1892,30.89,440,442,1452
09.04.2017 02:00,1838,30.37,440,445,1398
09.04.2017 03:00,1861,29.95,454,451,1407
09.04.2017 04:00,1915,29.84,448,456,1467
09.04.2017 05:00,1947,30.29,461,458,1486
09.04.2017 06:00,2100,30.8,454,448,1646
09.04.2017 07:00,2427,38.27,429,435,1998
09.04.2017 08:00,2771,44.92,406,426,2365
09.04.2017 09:00,2893,52.06,388,395,2505
09.04.2017 10:00,2962,49.1,352,361,2610
09.04.2017 11:00,3006,50.08,290,301,2716
09.04.2017 12:00,3053,48,274,291,2779
09.04.2017 13:00,2990,48.04,258,267,2732
09.04.2017 14:00,2956,42.2,252,258,2704
09.04.2017 15:00,2913,39.19,251,259,2662
09.04.2017 16:00,2879,39.17,274,275,2605
09.04.2017 17:00,2785,39.18,315,300,2470
09.04.2017 18:00,2774,40.76,321,316,2453
09.04.2017 19:00,2781,42.91,331,338,2450
09.04.2017 20:00,2760,45.48,332,346,2428
09.04.2017 21:00,2684,45.71,336,334,2348
09.04.2017 22:00,2499,40.56,331,326,2168
09.04.2017 23:00,2308,36.93,329,319,1979
09.05.2017 00:00,2164,33.22,309,308,1855
09.05.2017 01:00,2022,31.52,273,274,1749
09.05.2017 02:00,1952,30.42,257,251,1695
09.05.2017 03:00,1907,30.24,248,238,1659
09.05.2017 04:00,1906,30.24,235,231,1671
09.05.2017 05:00,1939,30.4,228,229,1711
09.05.2017 06:00,2078,31.04,217,221,1861
09.05.2017 07:00,2430,36.37,211,211,2219
09.05.2017 08:00,2769,48.95,197,199,2572
09.05.2017 09:00,2900,66.84,175,179,2725
09.05.2017 10:00,2901,66.9,158,164,2743
09.05.2017 11:00,2997,67.61,144,146,2853
09.05.2017 12:00,2935,69.88,130,133,2805
09.05.2017 13:00,2920,69.18,138,140,2782
09.05.2017 14:00,2886,50.35,114,117,2772
09.05.2017 15:00,2897,50.09,128,131,2769
09.05.2017 16:00,2884,50.08,113,116,2771
09.05.2017 17:00,2811,53.57,108,111,2703
09.05.2017 18:00,2843,53.63,102,104,2741
09.05.2017 19:00,2798,48.44,104,106,2694
09.05.2017 20:00,2774,54.92,113,114,2661
09.05.2017 21:00,2739,48.44,138,133,2601
09.05.2017 22:00,2570,40.4,148,141,2422
09.05.2017 23:00,2371,37.25,156,152,2215
09.06.2017 00:00,2162,32.97,161,156,2001
09.06.2017 01:00,2004,30.6,163,154,1841
09.06.2017 02:00,1934,30.33,159,156,1775
09.06.2017 03:00,1893,29.97,161,155,1732
09.06.2017 04:00,1907,30.5,172,163,1735
09.06.2017 05:00,1912,31.18,175,165,1737
09.06.2017 06:00,2015,31.26,181,174,1834
09.06.2017 07:00,2309,36.32,203,189,2106
09.06.2017 08:00,2644,47.19,215,202,2429
09.06.2017 09:00,2837,57.91,223,227,2614
09.06.2017 10:00,2876,60.1,278,265,2598
09.06.2017 11:00,2889,67.99,277,260,2612
09.06.2017 12:00,2890,80.43,292,274,2598
09.06.2017 13:00,2840,76.05,295,286,2545
09.06.2017 14:00,2830,50.02,292,277,2538
09.06.2017 15:00,2853,48.65,270,275,2583
09.06.2017 16:00,2840,44.56,280,292,2560
09.06.2017 17:00,2768,46.44,286,301,2482
09.06.2017 18:00,2824,44.89,334,340,2490
09.06.2017 19:00,2814,43.07,359,361,2455
09.06.2017 20:00,2734,46.13,356,360,2378
09.06.2017 21:00,2678,42.43,382,394,2296
09.06.2017 22:00,2482,35.56,410,422,2072
09.06.2017 23:00,2296,31.95,422,432,1874
09.07.2017 00:00,2105,31.01,460,449,1645
09.07.2017 01:00,2046,29.81,542,524,1504
09.07.2017 02:00,2037,29.04,546,536,1491
09.07.2017 03:00,1969,28.5,550,516,1419
09.07.2017 04:00,1936,28.53,485,473,1451
09.07.2017 05:00,2022,28.85,432,433,1590
09.07.2017 06:00,2224,29.06,387,408,1837
09.07.2017 07:00,2526,34.63,366,382,2160
09.07.2017 08:00,2866,42.87,342,358,2524
09.07.2017 09:00,2980,49.91,337,332,2643
09.07.2017 10:00,2982,49.98,327,313,2655
09.07.2017 11:00,2979,50.35,292,273,2687
09.07.2017 12:00,2989,49.99,242,238,2747
09.07.2017 13:00,2919,52.93,188,195,2731
09.07.2017 14:00,2888,43.04,140,152,2748
09.07.2017 15:00,2884,45,115,127,2769
09.07.2017 16:00,2877,49.69,105,109,2772
09.07.2017 17:00,2846,49.94,87,87,2759
09.07.2017 18:00,2867,49.07,84,84,2783
09.07.2017 19:00,2840,44.81,84,81,2756
09.07.2017 20:00,2858,50.99,79,77,2779
09.07.2017 21:00,2849,49.79,80,77,2769
09.07.2017 22:00,2654,41.02,80,83,2574
09.07.2017 23:00,2499,37.14,90,100,2409
09.08.2017 00:00,2283,32.79,104,110,2179
09.08.2017 01:00,2114,32.05,91,96,2023
09.08.2017 02:00,2050,30.39,107,119,1943
09.08.2017 03:00,2013,29.55,124,126,1889
09.08.2017 04:00,2013,29.7,127,132,1886
09.08.2017 05:00,2069,30.36,138,139,1931
09.08.2017 06:00,2203,31.45,152,148,2051
09.08.2017 07:00,2525,33.31,158,157,2367
09.08.2017 08:00,2825,49.6,166,170,2659
09.08.2017 09:00,2936,56.72,189,195,2747
09.08.2017 10:00,2954,56.88,232,234,2722
09.08.2017 11:00,3027,50.1,287,295,2740
09.08.2017 12:00,3013,50.05,365,350,2648
09.08.2017 13:00,2951,45.54,441,419,2510
09.08.2017 14:00,2816,38.64,484,470,2332
09.08.2017 15:00,2812,36.43,548,543,2264
09.08.2017 16:00,2848,34.89,584,582,2264
09.08.2017 17:00,2769,34.7,622,618,2147
09.08.2017 18:00,2805,34.75,652,645,2153
09.08.2017 19:00,2699,34.09,665,661,2034
09.08.2017 20:00,2623,35.97,667,657,1956
09.08.2017 21:00,2546,37.31,666,648,1880
09.08.2017 22:00,2383,33.02,610,620,1773
09.08.2017 23:00,2169,30.86,537,560,1632
09.09.2017 00:00,2053,29.59,487,512,1566
09.09.2017 01:00,1969,29.51,462,457,1507
09.09.2017 02:00,1893,29.34,382,392,1511
09.09.2017 03:00,1827,29.02,333,345,1494
09.09.2017 04:00,1772,28.88,329,322,1443
09.09.2017 05:00,1742,28.65,361,325,1381
09.09.2017 06:00,1734,28.77,367,334,1367
09.09.2017 07:00,1813,28.99,381,359,1432
09.09.2017 08:00,1973,30.72,403,388,1570
09.09.2017 09:00,2149,33.32,391,388,1758
09.09.2017 10:00,2309,37.08,394,409,1915
09.09.2017 11:00,2461,37.17,398,423,2063
09.09.2017 12:00,2490,38.68,377,397,2113
09.09.2017 13:00,2484,36.26,385,391,2099
09.09.2017 14:00,2446,33.1,383,385,2063
09.09.2017 15:00,2441,31.83,359,361,2082
09.09.2017 16:00,2400,31.84,416,393,1984
09.09.2017 17:00,2350,32.87,423,406,1927
09.09.2017 18:00,2312,34.54,422,412,1890
09.09.2017 19:00,2159,36.21,431,396,1728
09.09.2017 20:00,2087,39.08,393,388,1694
09.09.2017 21:00,2166,41.53,389,427,1777
09.09.2017 22:00,2175,36.37,382,414,1793
09.09.2017 23:00,2066,33.51,380,391,1686
09.10.2017 00:00,2002,30.62,369,370,1633
09.10.2017 01:00,1802,31.06,274,272,1528
09.10.2017 02:00,1740,29.56,235,234,1505
09.10.2017 03:00,1730,28.23,203,201,1527
09.10.2017 04:00,1730,27.1,168,166,1562
09.10.2017 05:00,1707,27.05,146,145,1561
09.10.2017 06:00,1769,27.05,131,134,1638
09.10.2017 07:00,1806,26.87,132,133,1674
09.10.2017 08:00,1862,27.1,131,128,1731
09.10.2017 09:00,2009,30.04,137,129,1872
09.10.2017 10:00,2107,31.92,139,143,1968
09.10.2017 11:00,2111,33.59,163,168,1948
09.10.2017 12:00,2059,33.54,206,198,1853
09.10.2017 13:00,2004,33.09,242,232,1762
09.10.2017 14:00,1969,31.76,261,260,1708
09.10.2017 15:00,1944,31.03,288,293,1656
09.10.2017 16:00,1887,31.57,305,308,1582
09.10.2017 17:00,1899,31.36,326,333,1573
09.10.2017 18:00,2000,31.87,348,345,1652
09.10.2017 19:00,2125,32.82,350,342,1775
09.10.2017 20:00,2187,33.95,364,349,1823
09.10.2017 21:00,2290,33.84,371,382,1919
09.10.2017 22:00,2164,32.28,395,416,1769
09.10.2017 23:00,2014,29.97,424,440,1590
09.11.2017 00:00,1820,28.6,452,448,1368
09.11.2017 01:00,1755,27.1,502,508,1253
09.11.2017 02:00,1733,25.25,512,536,1221
09.11.2017 03:00,1721,24.89,549,563,1172
09.11.2017 04:00,1752,25.3,574,584,1178
09.11.2017 05:00,1859,27.52,613,628,1246
09.11.2017 06:00,2047,27.94,669,673,1378
09.11.2017 07:00,2304,32.19,721,699,1583
09.11.2017 08:00,2604,37.97,751,736,1853
09.11.2017 09:00,2745,41.96,778,769,1967
09.11.2017 10:00,2798,42.06,836,836,1962
09.11.2017 11:00,2859,42.9,889,886,1970
09.11.2017 12:00,2853,42.08,889,885,1964
09.11.2017 13:00,2891,40.43,908,906,1983
09.11.2017 14:00,2952,40.43,889,891,2063
09.11.2017 15:00,2934,40.47,846,853,2088
09.11.2017 16:00,2877,38.76,781,792,2096
09.11.2017 17:00,2804,38.56,692,718,2112
09.11.2017 18:00,2868,39.68,630,659,2238
09.11.2017 19:00,2804,39.6,558,601,2246
09.11.2017 20:00,2774,42.07,544,552,2230
09.11.2017 21:00,2763,38.84,503,519,2260
09.11.2017 22:00,2568,33.64,487,501,2081
09.11.2017 23:00,2334,31.23,491,489,1843
09.12.2017 00:00,2108,28.25,514,504,1594
09.12.2017 01:00,2063,26.88,565,577,1498
09.12.2017 02:00,2039,25.67,598,600,1441
09.12.2017 03:00,1994,24.46,632,627,1362
09.12.2017 04:00,1997,24.21,676,669,1321
09.12.2017 05:00,2067,24.94,697,698,1370
09.12.2017 06:00,2183,27.01,698,701,1485
09.12.2017 07:00,2466,32.23,707,708,1759
09.12.2017 08:00,2790,36.47,716,712,2074
09.12.2017 09:00,2957,39.47,681,703,2276
09.12.2017 10:00,3018,39.5,675,698,2343
09.12.2017 11:00,3041,39.99,664,679,2377
09.12.2017 12:00,3016,39.73,646,664,2370
09.12.2017 13:00,2981,38.88,631,645,2350
09.12.2017 14:00,2914,33.78,626,617,2288
09.12.2017 15:00,2914,33.57,592,603,2322
09.12.2017 16:00,2885,33.52,567,589,2318
09.12.2017 17:00,2828,33.83,558,578,2270
09.12.2017 18:00,2806,35.36,538,555,2268
09.12.2017 19:00,2746,37.04,508,527,2238
09.12.2017 20:00,2782,39.42,500,512,2282
09.12.2017 21:00,2763,34.14,496,502,2267
09.12.2017 22:00,2491,32.58,503,493,1988
09.12.2017 23:00,2248,30.52,525,507,1723
13.09.2017 00:00,2103,28.86,520,521,1583
13.09.2017 01:00,2016,29.26,556,562,1460
13.09.2017 02:00,1946,26.57,556,556,1390
13.09.2017 03:00,1939,26.01,520,523,1419
13.09.2017 04:00,1960,26.12,481,484,1479
13.09.2017 05:00,2007,28.88,454,460,1553
13.09.2017 06:00,2197,31.1,435,445,1762
13.09.2017 07:00,2540,33.6,444,450,2096
13.09.2017 08:00,2855,50.09,479,463,2376
13.09.2017 09:00,2931,55.02,472,475,2459
13.09.2017 10:00,2989,50.05,529,526,2460
13.09.2017 11:00,3017,49.02,586,578,2431
13.09.2017 12:00,3057,42.46,661,654,2396
13.09.2017 13:00,3071,39.88,748,747,2323
13.09.2017 14:00,3137,39.25,833,832,2304
13.09.2017 15:00,3138,37.66,890,891,2248
13.09.2017 16:00,3150,36.66,923,925,2227
13.09.2017 17:00,3147,36.43,959,961,2188
13.09.2017 18:00,3122,36.73,972,974,2150
13.09.2017 19:00,3093,37.09,970,970,2123
13.09.2017 20:00,3215,38.82,966,961,2249
13.09.2017 21:00,3147,36.9,954,951,2193
13.09.2017 22:00,3011,33.26,965,960,2046
13.09.2017 23:00,2778,29.28,980,981,1798
14.09.2017 00:00,2559,26.1,939,941,1620
14.09.2017 01:00,2298,27.02,853,846,1445
14.09.2017 02:00,2245,26.56,874,866,1371
14.09.2017 03:00,2267,25.98,886,883,1381
14.09.2017 04:00,2279,26.57,875,873,1404
14.09.2017 05:00,2310,27.61,837,836,1473
14.09.2017 06:00,2430,30.51,795,793,1635
14.09.2017 07:00,2817,34.87,740,737,2077
14.09.2017 08:00,3097,40.08,679,671,2418
14.09.2017 09:00,3234,48.95,582,604,2652
14.09.2017 10:00,3291,44.64,484,555,2807
14.09.2017 11:00,3310,46.08,464,517,2846
14.09.2017 12:00,3233,49.94,485,454,2748
14.09.2017 13:00,3107,48.68,425,390,2682
14.09.2017 14:00,3114,41.02,402,396,2712
14.09.2017 15:00,3033,42.71,428,422,2605
14.09.2017 16:00,2977,39.95,420,427,2557
14.09.2017 17:00,2861,38.23,456,436,2405
14.09.2017 18:00,2831,40.12,434,430,2397
14.09.2017 19:00,2782,40.18,409,396,2373
14.09.2017 20:00,2876,54.74,361,384,2515
14.09.2017 21:00,2858,44.8,328,345,2530
14.09.2017 22:00,2659,39.1,328,315,2331
14.09.2017 23:00,2446,32.84,299,299,2147
15.09.2017 00:00,2279,30.16,280,290,1999
15.09.2017 01:00,2094,28.73,259,258,1835
15.09.2017 02:00,1998,28.11,279,243,1719
15.09.2017 03:00,1989,27.35,272,260,1717
15.09.2017 04:00,2022,27.57,296,293,1726
15.09.2017 05:00,2046,29.09,354,336,1692
15.09.2017 06:00,2151,30.96,391,359,1760
15.09.2017 07:00,2491,35.01,422,414,2069
15.09.2017 08:00,2847,39.9,446,442,2401
15.09.2017 09:00,3026,44.58,457,453,2569
15.09.2017 10:00,3036,48.95,443,441,2593
15.09.2017 11:00,3106,48.08,414,430,2692
15.09.2017 12:00,3089,46.42,400,427,2689
15.09.2017 13:00,2968,44.5,391,422,2577
15.09.2017 14:00,2909,39.83,388,418,2521
15.09.2017 15:00,2780,37.96,434,437,2346
15.09.2017 16:00,2604,36.58,444,423,2160
15.09.2017 17:00,2513,37.58,449,432,2064
15.09.2017 18:00,2562,40.66,417,414,2145
15.09.2017 19:00,2550,45.47,414,403,2136
15.09.2017 20:00,2638,55.07,384,399,2254
15.09.2017 21:00,2631,47.95,379,395,2252
15.09.2017 22:00,2459,39.17,370,400,2089
15.09.2017 23:00,2190,33.12,370,376,1820
16.09.2017 00:00,2010,31.4,370,377,1640
16.09.2017 01:00,2003,31.03,376,379,1627
16.09.2017 02:00,1966,31.04,365,362,1601
16.09.2017 03:00,1877,30.56,326,326,1551
16.09.2017 04:00,1861,30.6,301,297,1560
16.09.2017 05:00,1939,30.82,263,269,1676
16.09.2017 06:00,1982,31.44,242,244,1740
16.09.2017 07:00,2067,31.94,209,228,1858
16.09.2017 08:00,2186,34.7,196,213,1990
16.09.2017 09:00,2322,38.6,183,188,2139
16.09.2017 10:00,2485,40.92,178,178,2307
16.09.2017 11:00,2496,38.1,172,167,2324
16.09.2017 12:00,2515,35.5,172,168,2343
16.09.2017 13:00,2471,37.93,152,157,2319
16.09.2017 14:00,2405,35.29,133,145,2272
16.09.2017 15:00,2321,34.01,135,140,2186
16.09.2017 16:00,2288,34.01,130,134,2158
16.09.2017 17:00,2310,35.5,126,126,2184
16.09.2017 18:00,2340,38.44,109,114,2231
16.09.2017 19:00,2369,39.98,100,102,2269
16.09.2017 20:00,2433,48.01,91,92,2342
16.09.2017 21:00,2437,46.7,87,83,2350
16.09.2017 22:00,2345,40.8,88,88,2257
16.09.2017 23:00,2257,35.6,80,84,2177
17.09.2017 00:00,2173,33.66,76,79,2097
17.09.2017 01:00,2083,33.22,58,58,2025
17.09.2017 02:00,1994,31.95,54,49,1940
17.09.2017 03:00,1964,31.49,46,43,1918
17.09.2017 04:00,1951,30.73,45,40,1906
17.09.2017 05:00,1958,31.06,36,40,1922
17.09.2017 06:00,2000,31.83,37,38,1963
17.09.2017 07:00,2032,31.85,44,42,1988
17.09.2017 08:00,2113,32.07,44,43,2069
17.09.2017 09:00,2259,33.87,39,39,2220
17.09.2017 10:00,2371,37.59,32,35,2339
17.09.2017 11:00,2403,39.94,29,32,2374
17.09.2017 12:00,2421,40.17,31,30,2390
17.09.2017 13:00,2413,38.98,34,30,2379
17.09.2017 14:00,2394,36.46,33,31,2361
17.09.2017 15:00,2386,34.62,30,32,2356
17.09.2017 16:00,2359,35.04,35,34,2324
17.09.2017 17:00,2354,34.9,36,38,2318
17.09.2017 18:00,2387,36.66,38,40,2349
17.09.2017 19:00,2440,44.18,43,45,2397
17.09.2017 20:00,2558,50.06,51,53,2507
17.09.2017 21:00,2600,46.95,65,66,2535
17.09.2017 22:00,2444,39.91,72,73,2372
17.09.2017 23:00,2298,35.76,80,82,2218
18.09.2017 00:00,2141,33.09,95,96,2046
18.09.2017 01:00,2013,31.54,97,98,1916
18.09.2017 02:00,2004,31.34,108,109,1896
18.09.2017 03:00,2014,31.09,115,116,1899
18.09.2017 04:00,2028,30.91,121,122,1907
18.09.2017 05:00,2062,31.1,130,131,1932
18.09.2017 06:00,2251,32.6,148,150,2103
18.09.2017 07:00,2666,39.94,164,165,2502
18.09.2017 08:00,2991,51.06,165,165,2826
18.09.2017 09:00,3092,58.78,166,163,2926
18.09.2017 10:00,3077,58.76,154,153,2923
18.09.2017 11:00,3109,58.79,138,140,2971
18.09.2017 12:00,3060,51.07,132,136,2928
18.09.2017 13:00,2966,55.05,118,122,2848
18.09.2017 14:00,2955,45.29,101,105,2854
18.09.2017 15:00,2924,45.33,95,100,2829
18.09.2017 16:00,2874,42.47,90,94,2784
18.09.2017 17:00,2768,43.92,99,94,2669
18.09.2017 18:00,2795,45.46,105,101,2690
18.09.2017 19:00,2762,45.28,137,131,2625
18.09.2017 20:00,2843,52.89,150,150,2693
18.09.2017 21:00,2791,53.14,142,151,2649
18.09.2017 22:00,2583,43.65,141,151,2442
18.09.2017 23:00,2371,33.14,153,160,2218
19.09.2017 00:00,2159,31.58,167,167,1992
19.09.2017 01:00,2046,31.14,202,200,1844
19.09.2017 02:00,2000,30.48,215,211,1785
19.09.2017 03:00,2004,29.74,225,221,1779
19.09.2017 04:00,2005,29.7,230,231,1775
19.09.2017 05:00,2055,30.08,241,245,1814
19.09.2017 06:00,2231,31.5,247,251,1984
19.09.2017 07:00,2599,37.15,261,262,2338
19.09.2017 08:00,2860,45.05,273,273,2587
19.09.2017 09:00,2974,48.1,273,276,2701
19.09.2017 10:00,3018,49.47,278,282,2740
19.09.2017 11:00,3047,49.88,281,282,2766
19.09.2017 12:00,3045,48.68,303,308,2742
19.09.2017 13:00,2987,46.23,325,333,2662
19.09.2017 14:00,2937,43.96,330,340,2607
19.09.2017 15:00,2836,42.72,345,342,2491
19.09.2017 16:00,2831,42.45,307,319,2524
19.09.2017 17:00,2871,44.21,302,307,2569
19.09.2017 18:00,2977,43.49,287,285,2690
19.09.2017 19:00,2923,44.79,265,258,2658
19.09.2017 20:00,2981,58.11,230,241,2751
19.09.2017 21:00,2898,45.07,227,238,2671
19.09.2017 22:00,2712,39.89,215,235,2497
19.09.2017 23:00,2436,35.55,203,221,2233
20.09.2017 00:00,2182,32.27,224,229,1958
20.09.2017 01:00,2083,30.08,254,240,1829
20.09.2017 02:00,2041,29.49,248,245,1793
20.09.2017 03:00,2026,28.74,231,240,1795
20.09.2017 04:00,2024,28.67,233,230,1791
20.09.2017 05:00,2084,29.39,201,208,1883
20.09.2017 06:00,2227,31.05,189,185,2038
20.09.2017 07:00,2589,38.28,174,178,2415
20.09.2017 08:00,2899,45.33,142,148,2757
20.09.2017 09:00,3013,48.3,122,132,2891
20.09.2017 10:00,3014,50.93,108,114,2906
20.09.2017 11:00,3025,48.86,83,87,2942
20.09.2017 12:00,2995,49.06,76,81,2919
20.09.2017 13:00,2918,48.64,72,76,2846
20.09.2017 14:00,2895,44.85,74,78,2821
20.09.2017 15:00,2771,43.03,71,73,2700
20.09.2017 16:00,2755,43.25,78,74,2677
20.09.2017 17:00,2710,44.06,80,76,2630
20.09.2017 18:00,2687,43.97,77,76,2610
20.09.2017 19:00,2711,45.43,71,75,2640
20.09.2017 20:00,2834,58.5,73,77,2761
20.09.2017 21:00,2807,44.49,69,70,2738
20.09.2017 22:00,2634,39.84,62,63,2572
20.09.2017 23:00,2454,35.52,60,61,2394
21.09.2017 00:00,2275,32.82,68,70,2207
21.09.2017 01:00,2147,31.23,51,53,2096
21.09.2017 02:00,2099,30.41,47,48,2052
21.09.2017 03:00,2099,29.66,49,51,2050
21.09.2017 04:00,2091,29.49,45,46,2046
21.09.2017 05:00,2128,29.98,45,47,2083
21.09.2017 06:00,2280,32.11,50,50,2230
21.09.2017 07:00,2655,38.87,57,53,2598
21.09.2017 08:00,2939,45.1,61,57,2878
21.09.2017 09:00,3015,50.97,58,56,2957
21.09.2017 10:00,3087,47.03,59,57,3028
21.09.2017 11:00,3099,45.09,60,63,3039
21.09.2017 12:00,3115,45.05,58,60,3057
21.09.2017 13:00,3066,44.01,56,59,3010
21.09.2017 14:00,3005,43.59,48,50,2957
21.09.2017 15:00,2934,40.58,52,55,2882
21.09.2017 16:00,2869,38.67,58,60,2811
21.09.2017 17:00,2795,40.75,67,69,2728
21.09.2017 18:00,2793,41.49,77,79,2716
21.09.2017 19:00,2731,43.33,99,99,2632
21.09.2017 20:00,2794,46.62,135,124,2659
21.09.2017 21:00,2696,44.82,155,142,2541
21.09.2017 22:00,2510,37.63,163,165,2347
21.09.2017 23:00,2316,32.5,185,193,2131
22.09.2017 00:00,2120,30.73,186,191,1934
22.09.2017 01:00,2068,30.64,198,202,1870
22.09.2017 02:00,2012,30.2,200,202,1812
22.09.2017 03:00,2050,29.43,200,201,1850
22.09.2017 04:00,2056,29.44,205,205,1851
22.09.2017 05:00,2068,30.21,204,205,1864
22.09.2017 06:00,2179,31.9,212,212,1967
22.09.2017 07:00,2471,38.39,228,225,2243
22.09.2017 08:00,2759,44.05,227,229,2532
22.09.2017 09:00,2934,49.8,227,230,2707
22.09.2017 10:00,2967,49.71,223,225,2744
22.09.2017 11:00,3091,47.37,235,234,2856
22.09.2017 12:00,3075,47.86,231,234,2844
22.09.2017 13:00,3049,46.4,210,213,2839
22.09.2017 14:00,3011,46.02,200,202,2811
22.09.2017 15:00,2930,44.08,192,190,2738
22.09.2017 16:00,2914,44.49,193,190,2721
22.09.2017 17:00,2872,43.35,172,173,2700
22.09.2017 18:00,2897,43.57,158,159,2739
22.09.2017 19:00,2837,45.92,135,135,2702
22.09.2017 20:00,2847,48.92,141,140,2706
22.09.2017 21:00,2707,47.21,130,132,2577
22.09.2017 22:00,2536,41.18,102,105,2434
22.09.2017 23:00,2386,37.02,96,96,2290
23.09.2017 00:00,2245,31.85,93,93,2152
23.09.2017 01:00,2089,32.87,61,62,2028
23.09.2017 02:00,2001,31.65,53,54,1948
23.09.2017 03:00,1960,31.26,48,49,1912
23.09.2017 04:00,1940,31.01,45,47,1895
23.09.2017 05:00,1947,31.22,44,45,1903
23.09.2017 06:00,1973,31.53,46,46,1927
23.09.2017 07:00,2069,32.21,52,50,2017
23.09.2017 08:00,2167,35.03,53,51,2114
23.09.2017 09:00,2321,41.54,48,49,2273
23.09.2017 10:00,2457,42.93,50,53,2407
23.09.2017 11:00,2547,41.91,51,54,2496
23.09.2017 12:00,2546,39.9,51,54,2495
23.09.2017 13:00,2529,31.91,63,65,2466
23.09.2017 14:00,2485,32.17,60,63,2425
23.09.2017 15:00,2420,32.12,84,84,2336
23.09.2017 16:00,2435,32,112,108,2323
23.09.2017 17:00,2450,32.77,123,123,2327
23.09.2017 18:00,2527,37.22,148,148,2379
23.09.2017 19:00,2495,41.11,146,145,2349
23.09.2017 20:00,2566,45.12,189,187,2377
23.09.2017 21:00,2470,41.5,211,210,2259
23.09.2017 22:00,2344,33.05,204,204,2140
23.09.2017 23:00,2201,32.37,208,210,1993
24.09.2017 00:00,2090,31.58,214,218,1876
24.09.2017 01:00,1972,31.76,226,230,1746
24.09.2017 02:00,1916,30.42,219,224,1697
24.09.2017 03:00,1883,30.14,212,218,1671
24.09.2017 04:00,1864,30.06,218,217,1646
24.09.2017 05:00,1858,30.16,222,215,1636
24.09.2017 06:00,1892,30.79,220,220,1672
24.09.2017 07:00,2012,30.25,241,238,1771
24.09.2017 08:00,2074,31.13,241,242,1833
24.09.2017 09:00,2249,33.72,241,246,2008
24.09.2017 10:00,2385,35.57,217,223,2168
24.09.2017 11:00,2455,35.25,218,223,2237
24.09.2017 12:00,2459,35.61,221,222,2238
24.09.2017 13:00,2406,35.21,237,234,2169
24.09.2017 14:00,2296,32.71,261,242,2035
24.09.2017 15:00,2250,31.52,260,244,1990
24.09.2017 16:00,2228,31.37,274,262,1954
24.09.2017 17:00,2283,31.62,277,262,2006
24.09.2017 18:00,2415,34.36,300,296,2115
24.09.2017 19:00,2472,34.96,312,319,2160
24.09.2017 20:00,2555,40.04,343,360,2212
24.09.2017 21:00,2452,34.47,390,414,2062
24.09.2017 22:00,2286,33.55,406,435,1880
24.09.2017 23:00,2107,31.76,436,460,1671
25.09.2017 00:00,2008,29.99,476,470,1532
25.09.2017 01:00,1933,29.56,477,475,1456
25.09.2017 02:00,1893,29.26,462,453,1431
25.09.2017 03:00,1879,29.12,460,456,1419
25.09.2017 04:00,1908,29.28,464,458,1444
25.09.2017 05:00,1954,29.52,496,489,1458
25.09.2017 06:00,2097,31.78,517,522,1580
25.09.2017 07:00,2506,34.45,551,556,1955
25.09.2017 08:00,2819,35.98,601,580,2218
25.09.2017 09:00,3001,36.75,615,607,2386
25.09.2017 10:00,3002,36.2,628,632,2374
25.09.2017 11:00,3002,35.89,654,679,2348
25.09.2017 12:00,2901,34.97,705,705,2196
25.09.2017 13:00,2725,34.65,757,731,1968
25.09.2017 14:00,2635,34.54,788,749,1847
25.09.2017 15:00,2609,33.84,776,748,1833
25.09.2017 16:00,2626,33.9,764,737,1862
25.09.2017 17:00,2592,34.7,739,718,1853
25.09.2017 18:00,2662,35.38,725,698,1937
25.09.2017 19:00,2756,35.91,693,683,2063
25.09.2017 20:00,2896,35.98,676,704,2220
25.09.2017 21:00,2799,34.3,647,680,2152
25.09.2017 22:00,2618,32.96,611,640,2007
25.09.2017 23:00,2396,30.65,589,596,1807
26.09.2017 00:00,2208,29.61,559,557,1649
26.09.2017 01:00,1903,29.74,536,528,1367
26.09.2017 02:00,1794,29.08,501,497,1293
26.09.2017 03:00,1786,29.02,479,477,1307
26.09.2017 04:00,1798,29.09,472,473,1326
26.09.2017 05:00,1822,29.76,472,464,1350
26.09.2017 06:00,2040,32.14,467,464,1573
26.09.2017 07:00,2393,35.36,474,464,1919
26.09.2017 08:00,2701,38.01,457,461,2244
26.09.2017 09:00,2824,38.91,456,454,2368
26.09.2017 10:00,2787,37.97,466,460,2321
26.09.2017 11:00,2752,36.08,491,481,2261
26.09.2017 12:00,2698,35.77,491,477,2207
26.09.2017 13:00,2684,36.09,491,481,2193
26.09.2017 14:00,2674,35.13,486,474,2188
26.09.2017 15:00,2645,34.83,493,480,2152
26.09.2017 16:00,2680,35.9,485,478,2195
26.09.2017 17:00,2574,38.09,512,504,2062
26.09.2017 18:00,2603,40.02,516,498,2087
26.09.2017 19:00,2622,44.94,526,513,2096
26.09.2017 20:00,2638,38.94,537,535,2101
26.09.2017 21:00,2541,36.06,514,530,2027
26.09.2017 22:00,2337,33.77,517,531,1820
26.09.2017 23:00,2145,31.9,507,524,1638
27.09.2017 00:00,1938,29.72,495,505,1443
27.09.2017 01:00,1831,30.91,441,448,1390
27.09.2017 02:00,1778,30.04,442,448,1336
27.09.2017 03:00,1750,29.98,450,443,1300
27.09.2017 04:00,1770,30.08,447,450,1323
27.09.2017 05:00,1832,31.09,445,457,1387
27.09.2017 06:00,1985,33.41,453,468,1532
27.09.2017 07:00,2333,39.66,457,466,1876
27.09.2017 08:00,2616,45.47,447,467,2169
27.09.2017 09:00,2760,51.12,456,480,2304
27.09.2017 10:00,2738,48.05,479,495,2259
27.09.2017 11:00,2730,43.08,532,527,2198
27.09.2017 12:00,2658,41.16,593,570,2065
27.09.2017 13:00,2597,35.94,636,601,1961
27.09.2017 14:00,2619,34.94,657,643,1962
27.09.2017 15:00,2549,34.42,683,656,1866
27.09.2017 16:00,2560,35.96,684,671,1876
27.09.2017 17:00,2563,36.49,664,678,1899
27.09.2017 18:00,2603,37.8,681,684,1922
27.09.2017 19:00,2655,35.68,704,714,1951
27.09.2017 20:00,2731,35.92,744,751,1987
27.09.2017 21:00,2589,34.29,745,761,1844
27.09.2017 22:00,2398,32.7,742,760,1656
27.09.2017 23:00,2220,30.54,733,749,1487
28.09.2017 00:00,2023,29.13,736,733,1287
28.09.2017 01:00,1949,29.32,717,717,1232
28.09.2017 02:00,1861,29.13,702,701,1159
28.09.2017 03:00,1855,29,673,669,1182
28.09.2017 04:00,1846,29.1,676,668,1170
28.09.2017 05:00,1845,29.54,689,669,1156
28.09.2017 06:00,1986,31.67,712,683,1274
28.09.2017 07:00,2323,33.96,739,700,1584
28.09.2017 08:00,2643,34.61,745,728,1898
28.09.2017 09:00,2760,34.68,750,740,2010
28.09.2017 10:00,2752,33.73,787,783,1965
28.09.2017 11:00,2726,33.59,823,824,1903
28.09.2017 12:00,2632,32.97,846,838,1786
28.09.2017 13:00,2575,33.15,851,850,1724
28.09.2017 14:00,2600,33.66,861,862,1739
28.09.2017 15:00,2564,33.62,841,829,1723
28.09.2017 16:00,2576,33.57,804,796,1772
28.09.2017 17:00,2544,33.59,759,748,1785
28.09.2017 18:00,2524,33.78,702,683,1822
28.09.2017 19:00,2509,35.41,663,653,1846
28.09.2017 20:00,2674,35.33,636,649,2038
28.09.2017 21:00,2629,34.05,650,664,1979
28.09.2017 22:00,2400,33.61,617,623,1783
28.09.2017 23:00,2205,31.48,591,592,1614
29.09.2017 00:00,2033,29.78,564,571,1469
29.09.2017 01:00,2012,29.93,570,589,1442
29.09.2017 02:00,1968,29.95,549,563,1419
29.09.2017 03:00,1879,29.65,545,544,1334
29.09.2017 04:00,1838,29.79,562,549,1276
29.09.2017 05:00,1871,30.97,578,556,1293
29.09.2017 06:00,2048,31.91,615,576,1433
29.09.2017 07:00,2420,34.59,579,590,1841
29.09.2017 08:00,2647,34.47,596,589,2051
29.09.2017 09:00,2751,35.09,591,605,2160
29.09.2017 10:00,2734,34.73,608,608,2126
29.09.2017 11:00,2729,34.59,643,641,2086
29.09.2017 12:00,2648,33.65,666,661,1982
29.09.2017 13:00,2576,32.68,666,668,1910
29.09.2017 14:00,2583,32.22,670,670,1913
29.09.2017 15:00,2519,31.9,658,662,1861
29.09.2017 16:00,2416,31.6,648,639,1768
29.09.2017 17:00,2327,30.93,656,637,1671
29.09.2017 18:00,2374,31.89,662,636,1712
29.09.2017 19:00,2423,32.11,687,650,1736
29.09.2017 20:00,2476,31.93,687,665,1789
29.09.2017 21:00,2320,30.91,709,686,1611
29.09.2017 22:00,2126,29.21,705,691,1421
29.09.2017 23:00,1967,28.29,679,690,1288
30.09.2017 00:00,1865,27.93,668,692,1197
30.09.2017 01:00,1811,27.28,709,711,1102
30.09.2017 02:00,1755,27.01,705,682,1050
30.09.2017 03:00,1759,26.65,682,679,1077
30.09.2017 04:00,1788,27.03,679,699,1109
30.09.2017 05:00,1783,27.2,699,713,1084
30.09.2017 06:00,1837,28.04,709,725,1128
30.09.2017 07:00,1944,28.21,741,754,1203
30.09.2017 08:00,1967,28.47,770,770,1197
30.09.2017 09:00,2106,28.96,811,806,1295
30.09.2017 10:00,2165,30.57,852,849,1313
30.09.2017 11:00,2133,31.52,913,904,1220
30.09.2017 12:00,2114,30.87,949,952,1165
30.09.2017 13:00,2099,29.68,963,968,1136
30.09.2017 14:00,2077,29.61,966,962,1111
30.09.2017 15:00,2021,29.21,955,936,1066
30.09.2017 16:00,2026,29.36,955,932,1071
30.09.2017 17:00,2136,30.08,939,927,1197
30.09.2017 18:00,2222,31.36,925,914,1297
30.09.2017 19:00,2310,31.76,914,903,1396
30.09.2017 20:00,2360,32.38,894,899,1466
30.09.2017 21:00,2265,31.4,890,893,1375
30.09.2017 22:00,2189,29.07,856,874,1333
30.09.2017 23:00,2054,28.42,857,861,1197
10.01.2017 00:00,1907,27.74,847,841,1060
10.01.2017 01:00,1861,27.14,904,886,957
10.01.2017 02:00,1833,26.05,879,875,954
10.01.2017 03:00,1803,25.28,862,857,941
10.01.2017 04:00,1790,25.09,842,836,948
10.01.2017 05:00,1761,25.07,838,832,923
10.01.2017 06:00,1776,26.05,832,818,944
10.01.2017 07:00,1833,26.29,819,810,1014
10.01.2017 08:00,1857,27.4,801,790,1056
10.01.2017 09:00,2004,28.58,773,760,1231
10.01.2017 10:00,2146,29.18,719,721,1427
10.01.2017 11:00,2265,29.04,683,703,1582
10.01.2017 12:00,2324,29.19,640,667,1684
10.01.2017 13:00,2323,29.17,603,624,1720
10.01.2017 14:00,2292,28.68,555,565,1737
10.01.2017 15:00,2299,27.1,527,534,1772
10.01.2017 16:00,2332,27.29,497,506,1835
10.01.2017 17:00,2359,27.84,447,454,1912
10.01.2017 18:00,2434,29.48,387,391,2047
10.01.2017 19:00,2478,30.12,338,342,2140
10.01.2017 20:00,2565,30.06,328,331,2237
10.01.2017 21:00,2441,29.08,319,325,2122
10.01.2017 22:00,2247,28.39,318,322,1929
10.01.2017 23:00,2093,27.27,323,330,1770
10.02.2017 00:00,1969,25.94,344,352,1625
10.02.2017 01:00,1873,26.22,390,394,1483
10.02.2017 02:00,1833,24.27,439,446,1394
10.02.2017 03:00,1834,21.4,489,508,1345
10.02.2017 04:00,1855,21.38,562,574,1293
10.02.2017 05:00,1868,22.22,685,664,1183
10.02.2017 06:00,1980,26.51,786,766,1194
10.02.2017 07:00,2347,27.97,889,877,1458
10.02.2017 08:00,2633,28.55,981,981,1652
10.02.2017 09:00,2727,28.59,1056,1056,1671
10.02.2017 10:00,2755,28.46,1120,1120,1635
10.02.2017 11:00,2892,28.18,1189,1189,1703
10.02.2017 12:00,2954,28.23,1213,1213,1741
10.02.2017 13:00,2965,28.08,1198,1198,1767
10.02.2017 14:00,3020,27.99,1170,1170,1850
10.02.2017 15:00,2978,28.06,1126,1124,1852
10.02.2017 16:00,2888,27.86,1063,1056,1825
10.02.2017 17:00,2719,27.79,962,957,1757
10.02.2017 18:00,2747,28.92,869,889,1878
10.02.2017 19:00,2708,29.2,814,840,1894
10.02.2017 20:00,2725,29.52,772,780,1953
10.02.2017 21:00,2576,28.72,760,769,1816
10.02.2017 22:00,2366,26.79,784,765,1582
10.02.2017 23:00,2167,26.36,793,783,1374
10.03.2017 00:00,1979,24.02,799,790,1180
10.03.2017 01:00,1934,13.26,833,826,1101
10.03.2017 02:00,1905,13.95,834,823,1071
10.03.2017 03:00,1901,12.31,801,791,1100
10.03.2017 04:00,1893,15.09,754,747,1139
10.03.2017 05:00,1883,19.51,713,686,1170
10.03.2017 06:00,2063,27.03,642,628,1421
10.03.2017 07:00,2477,28.28,608,594,1869
10.03.2017 08:00,2772,30.66,579,574,2193
10.03.2017 09:00,2847,35.09,563,574,2284
10.03.2017 10:00,2846,34.06,619,622,2227
10.03.2017 11:00,2813,31.26,669,671,2144
10.03.2017 12:00,2800,31.9,757,759,2043
10.03.2017 13:00,2669,29.04,818,828,1851
10.03.2017 14:00,2648,28.77,950,935,1698
10.03.2017 15:00,2640,28.48,990,991,1650
10.03.2017 16:00,2660,28.39,1057,1052,1603
10.03.2017 17:00,2633,27.81,1085,1083,1548
10.03.2017 18:00,2401,28.3,1128,1124,1273
10.03.2017 19:00,3083,29.96,1164,1164,1919
10.03.2017 20:00,3118,31.17,1179,1180,1939
10.03.2017 21:00,2786,29.47,1193,1200,1593
10.03.2017 22:00,2499,28.22,1216,1214,1283
10.03.2017 23:00,2163,27.29,1229,1224,934
10.04.2017 00:00,1930,23.99,1232,1229,698
10.04.2017 01:00,1740,12.01,1241,1240,499
10.04.2017 02:00,1388,9.29,1237,1238,151
10.04.2017 03:00,1554,9.91,1237,1235,317
10.04.2017 04:00,1736,9.92,1233,1231,503
10.04.2017 05:00,1740,13.97,1231,1220,509
10.04.2017 06:00,2002,21.55,1209,1204,793
10.04.2017 07:00,2614,29.02,1181,1175,1433
10.04.2017 08:00,2976,33,1119,1112,1857
10.04.2017 09:00,3189,33.56,1060,1046,2129
10.04.2017 10:00,3119,33.24,1046,1034,2073
10.04.2017 11:00,3244,33.36,1073,1062,2171
10.04.2017 12:00,2921,31.17,1087,1081,1834
10.04.2017 13:00,2938,29.51,1117,1116,1821
10.04.2017 14:00,2888,29.18,1151,1154,1737
10.04.2017 15:00,2930,29.1,1203,1206,1727
10.04.2017 16:00,2995,29.07,1231,1233,1764
10.04.2017 17:00,2938,28.69,1246,1246,1692
10.04.2017 18:00,2984,31.86,1183,1194,1801
10.04.2017 19:00,3054,33.8,1186,1188,1868
10.04.2017 20:00,2976,35.06,1195,1198,1781
10.04.2017 21:00,2759,30.26,1199,1200,1560
10.04.2017 22:00,2573,27.69,1190,1189,1383
10.04.2017 23:00,2350,26.23,1181,1183,1169
10.05.2017 00:00,2156,21.51,1169,1171,987
10.05.2017 01:00,2196,24.56,1260,1257,936
10.05.2017 02:00,2116,23.92,1270,1264,846
10.05.2017 03:00,1984,23.06,1249,1240,735
10.05.2017 04:00,1961,24.34,1208,1196,753
10.05.2017 05:00,2004,25.1,1141,1124,863
10.05.2017 06:00,2199,27.12,1046,1023,1153
10.05.2017 07:00,2640,31.31,910,896,1730
10.05.2017 08:00,2975,35.84,770,615,2205
10.05.2017 09:00,3034,41.92,630,505,2404
10.05.2017 10:00,3088,36.22,509,415,2579
10.05.2017 11:00,3070,36.31,407,419,2663
10.05.2017 12:00,3000,34.06,300,310,2700
10.05.2017 13:00,3014,32.98,268,280,2746
10.05.2017 14:00,2987,32.95,199,206,2788
10.05.2017 15:00,2947,32.74,221,238,2726
10.05.2017 16:00,2926,32.9,279,289,2647
10.05.2017 17:00,2854,32.22,362,348,2492
10.05.2017 18:00,2842,32.3,420,393,2422
10.05.2017 19:00,2814,32.7,419,425,2395
10.05.2017 20:00,2779,32.86,458,453,2321
10.05.2017 21:00,2643,32.12,458,459,2185
10.05.2017 22:00,2484,31.05,402,425,2082
10.05.2017 23:00,2286,29.06,385,389,1901
10.06.2017 00:00,2062,27.09,356,350,1706
10.06.2017 01:00,1992,26.31,343,336,1649
10.06.2017 02:00,1957,26.03,335,324,1622
10.06.2017 03:00,2004,25.19,316,305,1688
10.06.2017 04:00,2056,26.01,295,300,1761
10.06.2017 05:00,2048,26.34,287,279,1761
10.06.2017 06:00,2211,28.73,276,271,1935
10.06.2017 07:00,2622,31.37,269,275,2353
10.06.2017 08:00,2966,37.87,266,271,2700
10.06.2017 09:00,3042,34.94,249,261,2793
10.06.2017 10:00,3010,33.98,232,241,2778
10.06.2017 11:00,2993,32.95,210,214,2783
10.06.2017 12:00,2870,32.95,228,230,2642
10.06.2017 13:00,2746,32.13,288,299,2458
10.06.2017 14:00,2679,30.35,360,374,2319
10.06.2017 15:00,2561,29.45,465,437,2096
10.06.2017 16:00,2437,29.79,514,480,1923
10.06.2017 17:00,2391,31.63,533,498,1858
10.06.2017 18:00,2525,36.01,537,506,1988
10.06.2017 19:00,2589,45.8,476,479,2113
10.06.2017 20:00,2659,47.36,416,449,2243
10.06.2017 21:00,2445,36.41,380,396,2065
10.06.2017 22:00,2296,29.97,350,351,1946
10.06.2017 23:00,2148,29.13,316,319,1832
10.07.2017 00:00,2020,26.87,302,311,1718
10.07.2017 01:00,1944,28.29,307,324,1637
10.07.2017 02:00,1870,26.72,332,334,1538
10.07.2017 03:00,1789,26.16,376,371,1413
10.07.2017 04:00,1751,25.83,446,425,1305
10.07.2017 05:00,1817,26.25,492,489,1325
10.07.2017 06:00,1805,27.48,551,545,1254
10.07.2017 07:00,1856,28.05,596,574,1260
10.07.2017 08:00,1982,28.4,649,620,1333
10.07.2017 09:00,2174,28.39,641,649,1533
10.07.2017 10:00,2336,29.82,633,660,1703
10.07.2017 11:00,2460,30.44,646,681,1814
10.07.2017 12:00,2465,30.32,717,728,1748
10.07.2017 13:00,2443,30.18,746,734,1697
10.07.2017 14:00,2473,29.92,690,684,1783
10.07.2017 15:00,2523,29.84,618,641,1905
10.07.2017 16:00,2477,29.52,576,552,1901
10.07.2017 17:00,2448,29.98,517,478,1931
10.07.2017 18:00,2482,30.73,461,429,2021
10.07.2017 19:00,2586,32.34,417,396,2169
10.07.2017 20:00,2568,31.45,326,316,2242
10.07.2017 21:00,2474,29.86,254,271,2220
10.07.2017 22:00,2337,28.48,252,265,2085
10.07.2017 23:00,2101,28.07,286,268,1815
10.08.2017 00:00,2057,26.65,304,293,1753
10.08.2017 01:00,2001,27.37,325,329,1676
10.08.2017 02:00,1897,26.95,361,376,1536
10.08.2017 03:00,1847,26.49,384,384,1463
10.08.2017 04:00,1884,26.32,402,393,1482
10.08.2017 05:00,1919,26.37,400,396,1519
10.08.2017 06:00,1896,26.39,405,400,1491
10.08.2017 07:00,1899,26.37,405,405,1494
10.08.2017 08:00,2014,26.65,439,425,1575
10.08.2017 09:00,2216,27.97,462,463,1754
10.08.2017 10:00,2337,29.67,485,469,1852
10.08.2017 11:00,2500,32.48,545,519,1955
10.08.2017 12:00,2561,33.2,583,569,1978
10.08.2017 13:00,2539,30.21,607,624,1932
10.08.2017 14:00,2416,28.47,685,702,1731
10.08.2017 15:00,2302,27.4,768,765,1534
10.08.2017 16:00,2295,27.34,824,809,1471
10.08.2017 17:00,2352,28.12,843,818,1509
10.08.2017 18:00,2539,31.79,833,815,1706
10.08.2017 19:00,2707,39.09,812,813,1895
10.08.2017 20:00,2751,40.09,779,790,1972
10.08.2017 21:00,2590,32.99,753,777,1837
10.08.2017 22:00,2400,30.36,762,775,1638
10.08.2017 23:00,2234,29.4,751,764,1483
10.09.2017 00:00,2076,28.69,753,758,1323
10.09.2017 01:00,2046,29.36,816,815,1230
10.09.2017 02:00,2046,29.2,812,818,1234
10.09.2017 03:00,2050,29.13,811,821,1239
10.09.2017 04:00,2064,29.15,808,820,1256
10.09.2017 05:00,2108,29.28,815,822,1293
10.09.2017 06:00,2269,30.79,801,814,1468
10.09.2017 07:00,2700,36.89,796,811,1904
10.09.2017 08:00,2985,50.24,769,769,2216
10.09.2017 09:00,3066,54.75,763,747,2303
10.09.2017 10:00,3047,51.14,741,731,2306
10.09.2017 11:00,3012,51.14,758,747,2254
10.09.2017 12:00,2976,47.12,798,768,2178
10.09.2017 13:00,2955,41.21,804,783,2151
10.09.2017 14:00,2946,39.94,816,799,2130
10.09.2017 15:00,2948,40.06,798,780,2150
10.09.2017 16:00,2903,41.41,785,760,2118
10.09.2017 17:00,2905,43.79,726,706,2179
10.09.2017 18:00,3041,49.31,650,641,2391
10.09.2017 19:00,3099,59.83,588,593,2511
10.09.2017 20:00,3115,62.01,510,528,2605
10.09.2017 21:00,2964,40.89,468,483,2496
10.09.2017 22:00,2779,35.56,443,447,2336
10.09.2017 23:00,2530,33.41,425,420,2105
10.10.2017 00:00,2305,31.11,413,405,1892
10.10.2017 01:00,2166,29.85,400,383,1766
10.10.2017 02:00,2116,29.7,374,369,1742
10.10.2017 03:00,2114,29.7,356,357,1758
10.10.2017 04:00,2143,29.72,336,338,1807
10.10.2017 05:00,2216,30.01,312,317,1904
10.10.2017 06:00,2376,31.51,289,286,2087
10.10.2017 07:00,2816,37.78,253,254,2563
10.10.2017 08:00,3109,48.85,220,223,2889
10.10.2017 09:00,3154,56.94,190,192,2964
10.10.2017 10:00,3103,55.61,159,162,2944
10.10.2017 11:00,3067,44.13,145,148,2922
10.10.2017 12:00,2994,46.25,138,143,2856
10.10.2017 13:00,2908,47.01,138,140,2770
10.10.2017 14:00,2863,43.48,150,152,2713
10.10.2017 15:00,2821,43.42,160,157,2661
10.10.2017 16:00,2833,41.41,184,179,2649
10.10.2017 17:00,2812,39.02,164,158,2648
10.10.2017 18:00,2887,43.43,186,182,2701
10.10.2017 19:00,2933,50.93,190,196,2743
10.10.2017 20:00,2874,50.93,235,241,2639
10.10.2017 21:00,2705,35.86,285,280,2420
10.10.2017 22:00,2417,33.03,412,377,2005
10.10.2017 23:00,2143,31.01,489,472,1654
10.11.2017 00:00,1958,29.05,550,539,1408
10.11.2017 01:00,1939,27.28,653,661,1286
10.11.2017 02:00,1945,26.76,668,694,1277
10.11.2017 03:00,1984,26.68,661,704,1323
10.11.2017 04:00,2061,26.9,657,684,1404
10.11.2017 05:00,2110,28.12,655,659,1455
10.11.2017 06:00,2259,30.57,609,601,1650
10.11.2017 07:00,2636,39.03,513,526,2123
10.11.2017 08:00,2985,52.53,423,435,2562
10.11.2017 09:00,3048,130.05,367,367,2681
10.11.2017 10:00,3052,100.1,296,295,2756
10.11.2017 11:00,3094,84.03,241,249,2853
10.11.2017 12:00,3059,67.29,230,238,2829
10.11.2017 13:00,2975,60.79,199,217,2776
10.11.2017 14:00,2972,60.96,201,211,2771
10.11.2017 15:00,2869,52.55,233,226,2636
10.11.2017 16:00,2815,50.96,259,234,2556
10.11.2017 17:00,2823,47.28,256,276,2567
10.11.2017 18:00,2901,48.62,309,342,2592
10.11.2017 19:00,2956,61.05,391,396,2565
10.11.2017 20:00,2795,65.18,503,485,2292
10.11.2017 21:00,2641,38.95,634,616,2007
10.11.2017 22:00,2476,31.41,757,737,1719
10.11.2017 23:00,2310,29.56,834,826,1476
10.12.2017 00:00,2140,27.03,876,887,1264
10.12.2017 01:00,2115,26.86,954,967,1161
10.12.2017 02:00,2132,26.1,963,990,1169
10.12.2017 03:00,2130,25.91,1014,1024,1116
10.12.2017 04:00,2058,25.77,1046,1039,1012
10.12.2017 05:00,2071,26.09,1069,1059,1002
10.12.2017 06:00,2215,27.69,1099,1093,1116
10.12.2017 07:00,2615,29.56,1131,1126,1484
10.12.2017 08:00,2916,31.84,1149,1145,1767
10.12.2017 09:00,2998,31.99,1158,1158,1840
10.12.2017 10:00,2950,30.95,1173,1176,1777
10.12.2017 11:00,2957,30.88,1152,1152,1805
10.12.2017 12:00,2981,30.19,1215,1216,1766
10.12.2017 13:00,2979,29.98,1239,1240,1740
10.12.2017 14:00,2988,29.9,1259,1261,1729
10.12.2017 15:00,2993,29.62,1286,1288,1707
10.12.2017 16:00,2949,29.35,1318,1320,1631
10.12.2017 17:00,2893,28.86,1341,1343,1552
10.12.2017 18:00,2965,29.33,1348,1349,1617
10.12.2017 19:00,3026,29.96,1352,1353,1674
10.12.2017 20:00,3011,30.01,1346,1347,1665
10.12.2017 21:00,2854,29.23,1345,1346,1509
10.12.2017 22:00,2630,28.83,1338,1339,1292
10.12.2017 23:00,2424,27.87,1327,1327,1097
13.10.2017 00:00,2239,27.38,1315,1314,924
13.10.2017 01:00,2170,26.66,1356,1355,814
13.10.2017 02:00,2133,26.34,1330,1328,803
13.10.2017 03:00,2099,26.56,1287,1284,812
13.10.2017 04:00,2058,26.99,1226,1217,832
13.10.2017 05:00,2073,27.84,1151,1135,922
13.10.2017 06:00,2290,28.59,1021,1030,1269
13.10.2017 07:00,2719,31.11,874,888,1845
13.10.2017 08:00,3067,37.32,725,739,2342
13.10.2017 09:00,3119,49.07,600,599,2519
13.10.2017 10:00,3092,45.38,473,477,2619
13.10.2017 11:00,3095,43.05,385,387,2710
13.10.2017 12:00,3026,44.4,326,327,2700
13.10.2017 13:00,2909,38.97,295,297,2614
13.10.2017 14:00,2818,34.31,269,275,2549
13.10.2017 15:00,2749,31.99,237,240,2512
13.10.2017 16:00,2688,34.72,191,201,2497
13.10.2017 17:00,2680,36.99,165,176,2515
13.10.2017 18:00,2734,43.53,157,168,2577
13.10.2017 19:00,2786,51.21,214,214,2572
13.10.2017 20:00,2662,48.05,298,300,2364
13.10.2017 21:00,2486,38.33,372,383,2114
13.10.2017 22:00,2303,28.2,451,461,1852
13.10.2017 23:00,2148,27.7,519,529,1629
14.10.2017 00:00,2011,26.8,564,576,1447
14.10.2017 01:00,1989,26.76,652,672,1337
14.10.2017 02:00,1910,25.92,719,728,1191
14.10.2017 03:00,1846,25.4,763,767,1083
14.10.2017 04:00,1822,25.33,800,798,1022
14.10.2017 05:00,1796,25.54,808,814,988
14.10.2017 06:00,1861,26.1,799,821,1062
14.10.2017 07:00,2000,26.5,787,823,1213
14.10.2017 08:00,2114,26.65,793,816,1321
14.10.2017 09:00,2179,27.27,801,801,1378
14.10.2017 10:00,2301,27.8,846,830,1455
14.10.2017 11:00,2349,27.79,866,855,1483
14.10.2017 12:00,2425,27.19,867,880,1558
14.10.2017 13:00,2389,26.46,879,875,1510
14.10.2017 14:00,2394,25.86,869,851,1525
14.10.2017 15:00,2375,26.02,843,836,1532
14.10.2017 16:00,2387,26.42,803,816,1584
14.10.2017 17:00,2388,27.33,777,791,1611
14.10.2017 18:00,2490,28.11,742,765,1748
14.10.2017 19:00,2553,28.75,739,743,1814
14.10.2017 20:00,2454,28.48,725,719,1729
14.10.2017 21:00,2277,27.9,714,705,1563
14.10.2017 22:00,2096,27.5,689,683,1407
14.10.2017 23:00,2016,26.91,693,679,1323
15.10.2017 00:00,1855,26.01,687,676,1168
15.10.2017 01:00,1824,25.72,695,699,1129
15.10.2017 02:00,1853,25.07,666,674,1187
15.10.2017 03:00,1788,25.08,643,634,1145
15.10.2017 04:00,1787,25.34,604,597,1183
15.10.2017 05:00,1835,25.99,528,546,1307
15.10.2017 06:00,1885,26.05,449,495,1436
15.10.2017 07:00,1929,25.54,402,433,1527
15.10.2017 08:00,2016,23.13,363,381,1653
15.10.2017 09:00,2187,26.72,330,348,1857
15.10.2017 10:00,2340,27.75,277,290,2063
15.10.2017 11:00,2441,27.89,250,258,2191
15.10.2017 12:00,2484,27.83,242,253,2242
15.10.2017 13:00,2472,26.8,241,254,2231
15.10.2017 14:00,2413,25.99,257,265,2156
15.10.2017 15:00,2377,26,291,281,2086
15.10.2017 16:00,2383,26.63,326,314,2057
15.10.2017 17:00,2421,27.21,357,357,2064
15.10.2017 18:00,2430,28.51,402,402,2028
15.10.2017 19:00,2561,28.86,445,451,2116
15.10.2017 20:00,2577,28.77,483,499,2094
15.10.2017 21:00,2489,27.77,542,539,1947
15.10.2017 22:00,2321,26.86,580,572,1741
15.10.2017 23:00,2147,25.77,599,600,1548
16.10.2017 00:00,1977,21.72,605,618,1372
16.10.2017 01:00,1852,22.99,602,613,1250
16.10.2017 02:00,1781,21.26,615,614,1166
16.10.2017 03:00,1770,21.86,613,613,1157
16.10.2017 04:00,1819,21.79,605,615,1214
16.10.2017 05:00,1835,22.93,581,595,1254
16.10.2017 06:00,2012,26.16,561,582,1451
16.10.2017 07:00,2440,28,549,567,1891
16.10.2017 08:00,2767,43.02,523,525,2244
16.10.2017 09:00,2853,43.08,512,507,2341
16.10.2017 10:00,2920,42.09,502,496,2418
16.10.2017 11:00,3000,37.3,486,494,2514
16.10.2017 12:00,3002,33.16,470,483,2532
16.10.2017 13:00,2933,32.26,470,469,2463
16.10.2017 14:00,2939,31.68,474,474,2465
16.10.2017 15:00,2883,40.56,417,421,2466
16.10.2017 16:00,2911,42.5,414,421,2497
16.10.2017 17:00,2846,43.55,375,380,2471
16.10.2017 18:00,2863,43.06,354,357,2509
16.10.2017 19:00,2895,47.09,306,305,2589
16.10.2017 20:00,2856,61.91,288,280,2568
16.10.2017 21:00,2705,44.85,221,212,2484
16.10.2017 22:00,2540,28.02,211,212,2329
16.10.2017 23:00,2341,27.12,205,214,2136
17.10.2017 00:00,2137,26.1,212,222,1925
17.10.2017 01:00,2004,26.1,220,227,1784
17.10.2017 02:00,1902,25.06,261,249,1641
17.10.2017 03:00,1871,24.59,302,288,1569
17.10.2017 04:00,1906,24.52,348,348,1558
17.10.2017 05:00,1954,25.22,422,432,1532
17.10.2017 06:00,2130,26.24,500,501,1630
17.10.2017 07:00,2516,27.82,591,585,1925
17.10.2017 08:00,2851,45.05,620,625,2231
17.10.2017 09:00,2909,42.09,664,670,2245
17.10.2017 10:00,2906,36.06,696,710,2210
17.10.2017 11:00,2947,32.65,733,747,2214
17.10.2017 12:00,2923,30.11,821,810,2102
17.10.2017 13:00,2831,29.24,889,878,1942
17.10.2017 14:00,2862,29.05,955,948,1907
17.10.2017 15:00,2892,28.77,994,993,1898
17.10.2017 16:00,2942,28.75,1050,1050,1892
17.10.2017 17:00,2905,28.41,1046,1048,1859
17.10.2017 18:00,2915,28.82,1020,1011,1895
17.10.2017 19:00,3036,29.68,1004,1010,2032
17.10.2017 20:00,2949,28.43,986,987,1963
17.10.2017 21:00,2760,28.03,996,996,1764
17.10.2017 22:00,2606,27.23,1012,1005,1594
17.10.2017 23:00,2389,26.24,1021,1015,1368
18.10.2017 00:00,2132,25.19,1005,999,1127
18.10.2017 01:00,2039,25.39,1048,1035,991
18.10.2017 02:00,1995,22.23,1048,1043,947
18.10.2017 03:00,1982,21.39,1038,1033,944
18.10.2017 04:00,1924,21.57,1022,1015,902
18.10.2017 05:00,2028,24.91,994,986,1034
18.10.2017 06:00,2230,26.89,942,945,1288
18.10.2017 07:00,2625,28.05,856,852,1769
18.10.2017 08:00,3001,30.82,750,734,2251
18.10.2017 09:00,3096,38.06,641,618,2455
18.10.2017 10:00,3115,40.7,542,510,2573
18.10.2017 11:00,3114,42.02,462,417,2652
18.10.2017 12:00,3045,42.05,339,282,2706
18.10.2017 13:00,2968,46.05,267,205,2701
18.10.2017 14:00,2968,44.87,245,178,2723
18.10.2017 15:00,2925,46.01,182,113,2743
18.10.2017 16:00,2938,48.04,167,94,2771
18.10.2017 17:00,2876,48.03,162,89,2714
18.10.2017 18:00,2971,64.08,151,78,2820
18.10.2017 19:00,3016,73.41,157,83,2859
18.10.2017 20:00,2995,83.02,166,92,2829
18.10.2017 21:00,2869,63.47,177,102,2692
18.10.2017 22:00,2644,44.84,187,112,2457
18.10.2017 23:00,2427,38.09,199,123,2228
19.10.2017 00:00,2225,28.28,209,133,2016
19.10.2017 01:00,2116,28.54,264,188,1852
19.10.2017 02:00,2015,27.96,281,205,1734
19.10.2017 03:00,2062,27.91,296,222,1766
19.10.2017 04:00,2076,27.97,296,224,1780
19.10.2017 05:00,2141,28.28,301,231,1840
19.10.2017 06:00,2329,29.11,300,232,2029
19.10.2017 07:00,2687,40.28,302,236,2385
19.10.2017 08:00,2925,59.97,302,238,2623
19.10.2017 09:00,3150,68.54,319,261,2831
19.10.2017 10:00,3135,66.99,309,253,2826
19.10.2017 11:00,3162,60.58,308,255,2854
19.10.2017 12:00,3148,49.97,309,255,2839
19.10.2017 13:00,3104,46.57,302,247,2802
19.10.2017 14:00,3092,41.55,316,265,2776
19.10.2017 15:00,3044,40.53,338,285,2706
19.10.2017 16:00,3060,42.58,371,320,2689
19.10.2017 17:00,3012,43.92,375,329,2637
19.10.2017 18:00,3081,46.1,420,378,2661
19.10.2017 19:00,3045,56.61,466,433,2579
19.10.2017 20:00,2897,41.62,513,489,2384
19.10.2017 21:00,2788,35.77,545,529,2243
19.10.2017 22:00,2651,29.13,549,535,2102
19.10.2017 23:00,2519,28.46,563,554,1956
20.10.2017 00:00,2330,27.82,568,560,1762
20.10.2017 01:00,2233,28.7,589,579,1644
20.10.2017 02:00,2116,28.29,590,577,1526
20.10.2017 03:00,2075,28.05,596,577,1479
20.10.2017 04:00,2105,28.02,597,584,1508
20.10.2017 05:00,2116,28.34,599,586,1517
20.10.2017 06:00,2243,28.82,607,591,1636
20.10.2017 07:00,2635,35.74,607,587,2028
20.10.2017 08:00,3050,45.92,623,606,2427
20.10.2017 09:00,3122,50.05,629,605,2493
20.10.2017 10:00,3134,45.87,641,627,2493
20.10.2017 11:00,3112,42.11,647,628,2465
20.10.2017 12:00,3058,40.29,644,620,2414
20.10.2017 13:00,2999,37.59,622,596,2377
20.10.2017 14:00,2932,33.06,604,585,2328
20.10.2017 15:00,2854,32.1,598,573,2256
20.10.2017 16:00,2852,31.04,590,563,2262
20.10.2017 17:00,2844,30.3,588,554,2256
20.10.2017 18:00,2987,43.54,585,539,2402
20.10.2017 19:00,2971,46.71,586,539,2385
20.10.2017 20:00,2852,37.76,593,546,2259
20.10.2017 21:00,2661,29.25,593,547,2068
20.10.2017 22:00,2438,28.81,580,532,1858
20.10.2017 23:00,2303,28.48,552,505,1751
21.10.2017 00:00,2123,27.94,551,514,1572
21.10.2017 01:00,2089,29.07,641,594,1448
21.10.2017 02:00,2015,28.81,636,581,1379
21.10.2017 03:00,1987,28.55,626,568,1361
21.10.2017 04:00,2010,28.43,625,558,1385
21.10.2017 05:00,2070,28.41,628,560,1442
21.10.2017 06:00,2095,28.99,621,550,1474
21.10.2017 07:00,2166,29.01,605,529,1561
21.10.2017 08:00,2279,28.78,614,538,1665
21.10.2017 09:00,2407,29.1,621,546,1786
21.10.2017 10:00,2598,29.41,652,580,1946
21.10.2017 11:00,2737,29.83,659,587,2078
21.10.2017 12:00,2772,29.62,658,586,2114
21.10.2017 13:00,2753,29.33,666,597,2087
21.10.2017 14:00,2673,29.17,646,579,2027
21.10.2017 15:00,2597,29.09,652,583,1945
21.10.2017 16:00,2500,29.08,655,582,1845
21.10.2017 17:00,2508,29.22,670,599,1838
21.10.2017 18:00,2573,30.44,671,601,1902
21.10.2017 19:00,2578,32.64,689,621,1889
21.10.2017 20:00,2496,29.57,702,636,1794
21.10.2017 21:00,2407,29.1,703,643,1704
21.10.2017 22:00,2315,28.59,693,640,1622
21.10.2017 23:00,2211,27.5,681,638,1530
22.10.2017 00:00,2088,26.03,666,631,1422
22.10.2017 01:00,2036,27.9,702,675,1334
22.10.2017 02:00,1939,27.43,690,670,1249
22.10.2017 03:00,1893,27.07,673,652,1220
22.10.2017 04:00,1886,27.06,665,649,1221
22.10.2017 05:00,1931,27,660,643,1271
22.10.2017 06:00,1994,27.03,652,624,1342
22.10.2017 07:00,2107,27.58,639,604,1468
22.10.2017 08:00,2233,27.85,623,578,1610
22.10.2017 09:00,2389,28.44,602,550,1787
22.10.2017 10:00,2517,29.14,572,510,1945
22.10.2017 11:00,2562,29.96,541,476,2021
22.10.2017 12:00,2666,30.01,518,444,2148
22.10.2017 13:00,2683,29.9,457,382,2226
22.10.2017 14:00,2638,28.92,416,342,2222
22.10.2017 15:00,2586,28.87,390,316,2196
22.10.2017 16:00,2553,29.11,367,295,2186
22.10.2017 17:00,2592,29.35,363,293,2229
22.10.2017 18:00,2680,34.45,354,284,2326
22.10.2017 19:00,2812,48.7,345,274,2467
22.10.2017 20:00,2775,48.77,336,261,2439
22.10.2017 21:00,2665,43.07,336,263,2329
22.10.2017 22:00,2543,35.02,336,261,2207
22.10.2017 23:00,2419,29.86,350,276,2069
23.10.2017 00:00,2252,29.05,366,290,1886
23.10.2017 01:00,2027,28.61,290,214,1737
23.10.2017 02:00,2008,27.86,317,241,1691
23.10.2017 03:00,1998,27.08,345,270,1653
23.10.2017 04:00,2032,27.08,376,300,1656
23.10.2017 05:00,2080,27.9,417,342,1663
23.10.2017 06:00,2258,29.6,450,375,1808
23.10.2017 07:00,2707,41.34,487,413,2220
23.10.2017 08:00,3116,50.21,512,440,2604
23.10.2017 09:00,3171,50,527,457,2644
23.10.2017 10:00,3172,45.39,544,478,2628
23.10.2017 11:00,3159,46.02,547,482,2612
23.10.2017 12:00,3182,46.1,592,537,2590
23.10.2017 13:00,3034,43.16,624,571,2410
23.10.2017 14:00,3009,45.22,645,594,2364
23.10.2017 15:00,2961,45.62,658,612,2303
23.10.2017 16:00,3050,44.91,667,632,2383
23.10.2017 17:00,3093,44.98,666,652,2427
23.10.2017 18:00,3190,49.66,656,644,2534
23.10.2017 19:00,3271,54.2,643,631,2628
23.10.2017 20:00,3156,53.91,625,613,2531
23.10.2017 21:00,2997,45.09,595,573,2402
23.10.2017 22:00,2784,41.06,579,541,2205
23.10.2017 23:00,2567,30,551,511,2016
24.10.2017 00:00,2421,29.57,513,470,1908
24.10.2017 01:00,2346,29.58,492,447,1854
24.10.2017 02:00,2285,29.35,445,392,1840
24.10.2017 03:00,2266,28.9,431,377,1835
24.10.2017 04:00,2242,28.82,423,368,1819
24.10.2017 05:00,2220,28.97,424,373,1796
24.10.2017 06:00,2375,29.52,437,391,1938
24.10.2017 07:00,2798,42.51,448,408,2350
24.10.2017 08:00,3188,46.59,452,413,2736
24.10.2017 09:00,3322,53.91,497,465,2825
24.10.2017 10:00,3370,48.42,503,471,2867
24.10.2017 11:00,3324,49.08,469,441,2855
24.10.2017 12:00,3311,45.39,474,448,2837
24.10.2017 13:00,3339,38.58,477,465,2862
24.10.2017 14:00,3340,38.23,476,477,2864
24.10.2017 15:00,3300,36.1,464,474,2836
24.10.2017 16:00,3242,36.1,524,530,2718
24.10.2017 17:00,3055,35.24,590,594,2465
24.10.2017 18:00,3129,38.73,659,669,2470
24.10.2017 19:00,3183,43.83,704,730,2479
24.10.2017 20:00,3123,38.61,781,806,2342
24.10.2017 21:00,3039,30.28,822,840,2217
24.10.2017 22:00,2798,29.74,794,794,2004
24.10.2017 23:00,2586,28.91,801,794,1785
25.10.2017 00:00,2350,27.02,807,800,1543
25.10.2017 01:00,2231,25.8,836,828,1395
25.10.2017 02:00,2126,19.27,805,786,1321
25.10.2017 03:00,2106,18.32,772,766,1334
25.10.2017 04:00,2148,19.5,740,726,1408
25.10.2017 05:00,2098,23.95,715,701,1383
25.10.2017 06:00,2188,27.34,687,668,1501
25.10.2017 07:00,2656,33.68,629,590,2027
25.10.2017 08:00,3074,38.99,574,544,2500
25.10.2017 09:00,3136,41.27,529,500,2607
25.10.2017 10:00,3169,40.08,484,466,2685
25.10.2017 11:00,3198,30.39,458,442,2740
25.10.2017 12:00,3082,30.09,499,502,2583
25.10.2017 13:00,2586,29.79,610,627,1976
25.10.2017 14:00,2611,29.66,685,705,1926
25.10.2017 15:00,2892,29.87,763,787,2129
25.10.2017 16:00,2900,29.84,764,858,2136
25.10.2017 17:00,2789,30.01,793,1012,1996
25.10.2017 18:00,2938,34.91,779,998,2159
25.10.2017 19:00,3055,38.21,806,1023,2249
25.10.2017 20:00,3053,30.58,832,1049,2221
25.10.2017 21:00,2952,29.91,852,1068,2100
25.10.2017 22:00,2796,29.43,878,1094,1918
25.10.2017 23:00,2553,28.22,872,1088,1681
26.10.2017 00:00,2337,27.1,880,1096,1457
26.10.2017 01:00,2214,26.16,849,1067,1365
26.10.2017 02:00,2208,25.05,854,1073,1354
26.10.2017 03:00,2144,24.95,853,1071,1291
26.10.2017 04:00,2103,25.43,843,1057,1260
26.10.2017 05:00,2177,26.39,827,1039,1350
26.10.2017 06:00,2370,28.44,810,1022,1560
26.10.2017 07:00,2731,29.49,792,1001,1939
26.10.2017 08:00,3103,38.17,778,985,2325
26.10.2017 09:00,3128,40.5,769,973,2359
26.10.2017 10:00,3154,31.67,728,931,2426
26.10.2017 11:00,3198,30.58,747,938,2451
26.10.2017 12:00,3075,30.16,741,935,2334
26.10.2017 13:00,3061,29.88,738,932,2323
26.10.2017 14:00,3144,29.85,739,945,2405
26.10.2017 15:00,3039,29.77,684,889,2355
26.10.2017 16:00,3089,29.76,647,844,2442
26.10.2017 17:00,3065,29.79,588,776,2477
26.10.2017 18:00,3119,38.19,563,758,2556
26.10.2017 19:00,3208,48.01,524,707,2684
26.10.2017 20:00,3110,38.17,501,691,2609
26.10.2017 21:00,2944,29.83,486,684,2458
26.10.2017 22:00,2747,29.47,477,679,2270
26.10.2017 23:00,2573,29.01,472,683,2101
27.10.2017 00:00,2353,27.52,445,655,1908
27.10.2017 01:00,2244,26.53,384,589,1860
27.10.2017 02:00,2203,25.39,333,544,1870
27.10.2017 03:00,2200,25.43,286,500,1914
27.10.2017 04:00,2196,25.06,260,465,1936
27.10.2017 05:00,2188,25.38,255,456,1933
27.10.2017 06:00,2317,26.9,283,486,2034
27.10.2017 07:00,2773,29.11,322,528,2451
27.10.2017 08:00,3090,35.91,363,571,2727
27.10.2017 09:00,3041,32.1,366,556,2675
27.10.2017 10:00,3140,31.34,325,516,2815
27.10.2017 11:00,3164,33.67,270,474,2894
27.10.2017 12:00,3014,32.72,232,429,2782
27.10.2017 13:00,3064,29.32,216,404,2848
27.10.2017 14:00,3062,28.75,200,390,2862
27.10.2017 15:00,3052,28.14,189,373,2863
27.10.2017 16:00,2980,27.71,157,329,2823
27.10.2017 17:00,2899,29.29,140,304,2759
27.10.2017 18:00,2993,36.89,134,301,2859
27.10.2017 19:00,3116,42.17,151,316,2965
27.10.2017 20:00,2876,29.02,204,370,2672
27.10.2017 21:00,2602,28.02,254,425,2348
27.10.2017 22:00,2394,26.94,321,507,2073
27.10.2017 23:00,2304,25.8,427,629,1877
28.10.2017 00:00,2156,20.45,521,731,1635
28.10.2017 01:00,2113,24.18,651,865,1462
28.10.2017 02:00,2068,24.76,722,943,1346
28.10.2017 03:00,2045,23.52,804,1026,1241
28.10.2017 04:00,2046,22.27,872,1096,1174
28.10.2017 05:00,2039,22.13,939,1163,1100
28.10.2017 06:00,2086,23.98,996,1221,1090
28.10.2017 07:00,2211,25.23,1042,1267,1169
28.10.2017 08:00,2389,25.32,1073,1298,1316
28.10.2017 09:00,2492,25.52,1084,1310,1408
28.10.2017 10:00,2626,25.92,1059,1284,1567
28.10.2017 11:00,2711,26.15,1055,1283,1656
28.10.2017 12:00,2685,26.1,1035,1263,1650
28.10.2017 13:00,2611,25.79,1025,1253,1586
28.10.2017 14:00,2545,25.66,998,1226,1547
28.10.2017 15:00,2474,25.44,958,1186,1516
28.10.2017 16:00,2473,25.33,923,1151,1550
28.10.2017 17:00,2608,25.59,872,1098,1736
28.10.2017 18:00,2775,27.04,800,1025,1975
28.10.2017 19:00,2857,27.87,724,945,2133
28.10.2017 20:00,2749,27.68,646,865,2103
28.10.2017 21:00,2619,26.76,577,799,2042
28.10.2017 22:00,2474,25.91,551,779,1923
28.10.2017 23:00,2398,24.78,511,737,1887
29.10.2017 00:00,2317,22.18,492,719,1825
29.10.2017 01:00,2058,25.52,332,558,1726
29.10.2017 02:00,2029,24.11,321,546,1708
29.10.2017 03:00,2009,23.02,354,579,1655
29.10.2017 03:00,2057,21.63,388,612,1669
29.10.2017 04:00,2039,18.71,485,709,1554
29.10.2017 05:00,2130,21,605,831,1525
29.10.2017 06:00,2138,20.1,726,947,1412
29.10.2017 07:00,2256,21.02,821,1049,1435
29.10.2017 08:00,2325,22.5,867,1095,1458
29.10.2017 09:00,2540,21.34,891,1119,1649
29.10.2017 10:00,2684,25.45,936,1164,1748
29.10.2017 11:00,2685,25.93,949,1177,1736
29.10.2017 12:00,2715,25.4,1000,1229,1715
29.10.2017 13:00,2713,24.92,1060,1288,1653
29.10.2017 14:00,2639,24.13,1062,1291,1577
29.10.2017 15:00,2608,22.88,1053,1282,1555
29.10.2017 16:00,2654,24.13,1022,1251,1632
29.10.2017 17:00,2854,25.53,998,1226,1856
29.10.2017 18:00,3096,27.13,967,1195,2129
29.10.2017 19:00,3078,27.62,961,1189,2117
29.10.2017 20:00,2965,28.23,937,1166,2028
29.10.2017 21:00,2862,24.85,931,1159,1931
29.10.2017 22:00,2703,19.96,916,1144,1787
29.10.2017 23:00,2570,17.86,894,1123,1676
30.10.2017 00:00,2505,17.6,884,1112,1621
30.10.2017 01:00,2573,3,940,1167,1633
30.10.2017 02:00,2575,2.99,943,1170,1632
30.10.2017 03:00,2544,3.37,938,1166,1606
30.10.2017 04:00,2543,4.05,935,1155,1608
30.10.2017 05:00,2585,4.89,924,1142,1661
30.10.2017 06:00,2776,25.59,911,1128,1865
30.10.2017 07:00,3183,28.42,888,1106,2295
30.10.2017 08:00,3513,33.54,838,1055,2675
30.10.2017 09:00,3652,33.48,809,1023,2843
30.10.2017 10:00,3515,30.38,759,971,2756
30.10.2017 11:00,3459,29.74,725,932,2734
30.10.2017 12:00,3425,29.46,708,913,2717
30.10.2017 13:00,3298,29.7,664,867,2634
30.10.2017 14:00,3228,29.98,620,822,2608
30.10.2017 15:00,3142,35.49,561,756,2581
30.10.2017 16:00,3274,36.1,530,721,2744
30.10.2017 17:00,3437,39.12,470,659,2967
30.10.2017 18:00,3641,44.85,441,618,3200
30.10.2017 19:00,3538,42.84,411,582,3127
30.10.2017 20:00,3410,38.84,374,529,3036
30.10.2017 21:00,3205,36.54,338,485,2867
30.10.2017 22:00,3051,32.24,303,442,2748
30.10.2017 23:00,2917,29.26,281,411,2636
31.10.2017 00:00,2758,28.52,245,373,2513
31.10.2017 01:00,2657,28.8,236,367,2421
31.10.2017 02:00,2612,28.63,219,349,2393
31.10.2017 03:00,2626,28.6,193,322,2433
31.10.2017 04:00,2666,28.39,165,294,2501
31.10.2017 05:00,2682,28.89,154,281,2528
31.10.2017 06:00,2814,30.34,157,287,2657
31.10.2017 07:00,3080,34.83,175,305,2905
31.10.2017 08:00,3295,38.73,165,300,3130
31.10.2017 09:00,3389,41.09,182,322,3207
31.10.2017 10:00,3338,40.45,152,298,3186
31.10.2017 11:00,3341,40.4,162,311,3179
31.10.2017 12:00,3284,41.43,184,340,3100
31.10.2017 13:00,3241,36.95,213,374,3028
31.10.2017 14:00,3266,34.14,234,394,3032
31.10.2017 15:00,3230,35.65,234,397,2996
31.10.2017 16:00,3227,38.99,231,387,2996
31.10.2017 17:00,3317,42.45,221,378,3096
31.10.2017 18:00,3444,46.96,228,395,3216
31.10.2017 19:00,3308,47.36,220,379,3088
31.10.2017 20:00,3174,40.98,204,364,2970
31.10.2017 21:00,2988,37.61,197,365,2791
31.10.2017 22:00,2800,30.19,190,348,2610
31.10.2017 23:00,2593,29.58,190,346,2403
11.01.2017 00:00,2375,28.88,179,335,2196
11.01.2017 01:00,2302,28.25,175,333,2127
11.01.2017 02:00,2199,27.4,169,326,2030
11.01.2017 03:00,2196,26.69,161,317,2035
11.01.2017 04:00,2208,26.21,147,301,2061
11.01.2017 05:00,2204,26.66,142,292,2062
11.01.2017 06:00,2378,27.79,149,306,2229
11.01.2017 07:00,2769,29.07,160,318,2609
11.01.2017 08:00,3009,31,164,323,2845
11.01.2017 09:00,3122,36.06,174,332,2948
11.01.2017 10:00,3172,32.25,211,375,2961
11.01.2017 11:00,3278,31.61,268,442,3010
11.01.2017 12:00,3293,30.13,301,486,2992
11.01.2017 13:00,3220,29.79,358,554,2862
11.01.2017 14:00,3194,29.06,446,638,2748
11.01.2017 15:00,3128,29.18,495,700,2633
11.01.2017 16:00,3050,29.35,579,788,2471
11.01.2017 17:00,3114,31.66,674,882,2440
11.01.2017 18:00,3221,35.26,753,963,2468
11.01.2017 19:00,3168,29.73,802,1016,2366
11.01.2017 20:00,3103,29.25,829,1047,2274
11.01.2017 21:00,2966,28.48,843,1049,2123
11.01.2017 22:00,2722,27.4,838,1038,1884
11.01.2017 23:00,2535,26.33,828,1035,1707
11.02.2017 00:00,2394,23.33,814,1025,1580
11.02.2017 01:00,2305,20.68,766,985,1539
11.02.2017 02:00,2198,18.01,732,951,1466
11.02.2017 03:00,2183,16.92,704,916,1479
11.02.2017 04:00,2199,15.57,670,877,1529
11.02.2017 05:00,2246,23.58,628,838,1618
11.02.2017 06:00,2403,25.97,580,786,1823
11.02.2017 07:00,2753,28.2,539,731,2214
11.02.2017 08:00,3044,35.21,501,689,2543
11.02.2017 09:00,3174,38.38,453,641,2721
11.02.2017 10:00,3190,34.74,438,622,2752
11.02.2017 11:00,3264,31.55,437,628,2827
11.02.2017 12:00,3257,31.59,429,618,2828
11.02.2017 13:00,3144,30.57,386,556,2758
11.02.2017 14:00,3155,31.71,370,545,2785
11.02.2017 15:00,3185,33.13,503,513,2682
11.02.2017 16:00,3116,39.1,478,479,2638
11.02.2017 17:00,3106,44.85,456,463,2650
11.02.2017 18:00,3254,47.9,433,438,2821
11.02.2017 19:00,3176,47.04,420,424,2756
11.02.2017 20:00,3104,46.01,368,376,2736
11.02.2017 21:00,2974,41.76,353,345,2621
11.02.2017 22:00,2849,36.09,284,279,2565
11.02.2017 23:00,2747,29.13,251,261,2496
11.03.2017 00:00,2607,28.72,219,229,2388
11.03.2017 01:00,2456,27.88,142,150,2314
11.03.2017 02:00,2422,27.58,113,116,2309
11.03.2017 03:00,2393,27.56,86,87,2307
11.03.2017 04:00,2422,27.51,72,72,2350
11.03.2017 05:00,2469,28.16,63,60,2406
11.03.2017 06:00,2632,33.8,64,67,2568
11.03.2017 07:00,2923,39.94,74,79,2849
11.03.2017 08:00,3115,49.04,108,98,3007
11.03.2017 09:00,3175,64.23,122,108,3053
11.03.2017 10:00,3203,52.09,133,140,3070
11.03.2017 11:00,3206,54.9,164,163,3042
11.03.2017 12:00,3140,57.27,186,194,2954
11.03.2017 13:00,3071,53.25,225,243,2846
11.03.2017 14:00,3032,51.5,286,292,2746
11.03.2017 15:00,2993,49.95,315,330,2678
11.03.2017 16:00,2986,49.82,354,360,2632
11.03.2017 17:00,3063,57.66,393,395,2670
11.03.2017 18:00,3136,64.41,410,400,2726
11.03.2017 19:00,3113,49.02,402,419,2711
11.03.2017 20:00,2978,46.82,432,438,2546
11.03.2017 21:00,2739,36.42,458,456,2281
11.03.2017 22:00,2542,27.78,474,460,2068
11.03.2017 23:00,2416,28.06,473,471,1943
11.04.2017 00:00,2332,27.07,468,482,1864
11.04.2017 01:00,2292,26.96,528,543,1764
11.04.2017 02:00,2255,26.56,543,560,1712
11.04.2017 03:00,2181,26.13,577,583,1604
11.04.2017 04:00,2154,26.13,578,601,1576
11.04.2017 05:00,2201,26.09,591,597,1610
11.04.2017 06:00,2252,26.85,587,600,1665
11.04.2017 07:00,2342,27.07,580,601,1762
11.04.2017 08:00,2513,27.13,560,582,1953
11.04.2017 09:00,2609,28.15,538,544,2071
11.04.2017 10:00,2680,28.47,511,520,2169
11.04.2017 11:00,2779,28.71,482,485,2297
11.04.2017 12:00,2792,28.67,455,462,2337
11.04.2017 13:00,2788,28.56,411,427,2377
11.04.2017 14:00,2800,28.42,373,390,2427
11.04.2017 15:00,2798,28.44,333,348,2465
11.04.2017 16:00,2765,31.36,311,325,2454
11.04.2017 17:00,2892,36.14,323,339,2569
11.04.2017 18:00,2959,40.35,362,380,2597
11.04.2017 19:00,2846,34.65,423,432,2423
11.04.2017 20:00,2692,28.79,481,464,2211
11.04.2017 21:00,2515,28.26,489,467,2026
11.04.2017 22:00,2447,27.06,462,480,1985
11.04.2017 23:00,2353,26.53,458,485,1895
11.05.2017 00:00,2274,24.96,456,470,1818
11.05.2017 01:00,2234,25.09,497,511,1737
11.05.2017 02:00,2166,24.54,513,529,1653
11.05.2017 03:00,2163,24.03,525,538,1638
11.05.2017 04:00,2117,23.29,569,562,1548
11.05.2017 05:00,2154,23.73,607,598,1547
11.05.2017 06:00,2166,24.44,642,632,1524
11.05.2017 07:00,2224,24.96,673,667,1551
11.05.2017 08:00,2330,25.21,652,659,1678
11.05.2017 09:00,2405,27.61,631,648,1774
11.05.2017 10:00,2568,28.37,589,599,1979
11.05.2017 11:00,2676,28.79,529,541,2147
11.05.2017 12:00,2720,28.82,454,466,2266
11.05.2017 13:00,2773,28.62,389,398,2384
11.05.2017 14:00,2800,28.58,320,331,2480
11.05.2017 15:00,2774,28.62,252,263,2522
11.05.2017 16:00,2786,30.1,220,229,2566
11.05.2017 17:00,2867,35,193,194,2674
11.05.2017 18:00,2974,40.54,182,184,2792
11.05.2017 19:00,2946,40.74,171,175,2775
11.05.2017 20:00,2823,40.59,180,182,2643
11.05.2017 21:00,2703,32.89,184,186,2519
11.05.2017 22:00,2578,28.74,183,190,2395
11.05.2017 23:00,2389,28.39,189,193,2200
11.06.2017 00:00,2250,28.05,194,192,2056
11.06.2017 01:00,2162,27.82,209,208,1953
11.06.2017 02:00,2111,27.16,221,221,1890
11.06.2017 03:00,2065,26.98,229,231,1836
11.06.2017 04:00,2088,26.94,236,239,1852
11.06.2017 05:00,2183,27.42,251,251,1932
11.06.2017 06:00,2388,28.25,263,262,2125
11.06.2017 07:00,2861,29.29,276,276,2585
11.06.2017 08:00,3204,30.31,277,274,2927
11.06.2017 09:00,3267,35.06,271,267,2996
11.06.2017 10:00,3242,35.07,265,259,2977
11.06.2017 11:00,3259,35.05,255,255,3004
11.06.2017 12:00,3275,33.19,263,258,3012
11.06.2017 13:00,3277,30.31,276,269,3001
11.06.2017 14:00,3314,33.11,269,255,3045
11.06.2017 15:00,3261,33.18,251,236,3010
11.06.2017 16:00,3272,40.02,239,221,3033
11.06.2017 17:00,3193,47.76,214,199,2979
11.06.2017 18:00,3215,76.4,212,200,3003
11.06.2017 19:00,3136,52.02,202,199,2934
11.06.2017 20:00,3106,35.05,198,202,2908
11.06.2017 21:00,3050,29.91,191,193,2859
11.06.2017 22:00,3076,29.54,172,177,2904
11.06.2017 23:00,2582,28.9,156,160,2426
11.07.2017 00:00,2049,28.19,148,150,1901
11.07.2017 01:00,2152,28.41,151,152,2001
11.07.2017 02:00,2027,28.02,132,132,1895
11.07.2017 03:00,2063,27.88,114,115,1949
11.07.2017 04:00,2111,27.93,105,106,2006
11.07.2017 05:00,2260,28.34,93,94,2167
11.07.2017 06:00,3047,29.15,83,85,2964
11.07.2017 07:00,3469,29.92,81,82,3388
11.07.2017 08:00,3314,46.7,81,83,3233
11.07.2017 09:00,3240,50.11,82,82,3158
11.07.2017 10:00,3173,46.58,79,80,3094
11.07.2017 11:00,3227,47.15,78,80,3149
11.07.2017 12:00,3277,38.09,73,75,3204
11.07.2017 13:00,3336,38.05,66,68,3270
11.07.2017 14:00,3384,46.05,63,61,3321
11.07.2017 15:00,3356,45.77,68,66,3288
11.07.2017 16:00,3376,46.9,76,75,3300
11.07.2017 17:00,3254,49.65,91,96,3163
11.07.2017 18:00,3302,56.27,114,125,3188
11.07.2017 19:00,3309,48.86,161,164,3148
11.07.2017 20:00,3357,35.05,195,191,3162
11.07.2017 21:00,3311,30.57,188,193,3123
11.07.2017 22:00,3160,29.88,202,203,2958
11.07.2017 23:00,2584,28.99,213,215,2371
11.08.2017 00:00,2334,28.23,221,216,2113
11.08.2017 01:00,2189,28.79,189,190,2000
11.08.2017 02:00,2161,28.52,189,187,1972
11.08.2017 03:00,2110,28.45,187,185,1923
11.08.2017 04:00,2080,28.51,183,179,1897
11.08.2017 05:00,2117,28.96,189,189,1928
11.08.2017 06:00,2463,29.54,177,182,2286
11.08.2017 07:00,3350,31.14,172,176,3178
11.08.2017 08:00,3302,40.05,161,161,3141
11.08.2017 09:00,3238,43.56,150,151,3088
11.08.2017 10:00,3311,42.19,125,133,3186
11.08.2017 11:00,3334,42.68,104,113,3230
11.08.2017 12:00,3356,42.72,87,96,3269
11.08.2017 13:00,3308,42.18,73,79,3235
11.08.2017 14:00,3236,49.14,63,69,3173
11.08.2017 15:00,3260,47.26,82,84,3178
11.08.2017 16:00,3275,48.7,81,81,3194
11.08.2017 17:00,3306,50.49,83,86,3223
11.08.2017 18:00,3502,53.34,91,97,3411
11.08.2017 19:00,3701,49.03,106,111,3595
11.08.2017 20:00,3559,42.08,98,101,3461
11.08.2017 21:00,3434,30.33,93,95,3341
11.08.2017 22:00,3241,29.9,89,88,3152
11.08.2017 23:00,2851,29.3,83,83,2768
11.09.2017 00:00,2672,28.51,96,96,2576
11.09.2017 01:00,2519,28.96,66,64,2453
11.09.2017 02:00,2449,28.02,64,62,2385
11.09.2017 03:00,2433,27.28,67,68,2366
11.09.2017 04:00,2433,27.07,78,80,2355
11.09.2017 05:00,2446,28.19,97,98,2349
11.09.2017 06:00,2597,28.99,134,130,2463
11.09.2017 07:00,3037,30.22,172,170,2865
11.09.2017 08:00,3352,38.07,216,220,3136
11.09.2017 09:00,3403,38.09,264,263,3139
11.09.2017 10:00,3199,30.35,345,339,2854
11.09.2017 11:00,3526,30.06,445,438,3081
11.09.2017 12:00,3511,29.74,517,521,2994
11.09.2017 13:00,3406,29.6,614,600,2792
11.09.2017 14:00,3419,29.6,687,690,2732
11.09.2017 15:00,3395,29.77,761,773,2634
11.09.2017 16:00,3379,30.03,826,821,2553
11.09.2017 17:00,3426,30.32,875,868,2551
11.09.2017 18:00,3476,30.59,912,893,2564
11.09.2017 19:00,3387,30.52,932,911,2455
11.09.2017 20:00,3319,30.02,911,893,2408
11.09.2017 21:00,3130,29.41,860,848,2270
11.09.2017 22:00,2949,28.91,775,783,2174
11.09.2017 23:00,2751,28.12,749,750,2002
11.10.2017 00:00,2518,25.61,739,721,1779
11.10.2017 01:00,2417,26.41,768,741,1649
11.10.2017 02:00,2382,25.35,775,764,1607
11.10.2017 03:00,2344,25.96,779,758,1565
11.10.2017 04:00,2340,26.65,757,747,1583
11.10.2017 05:00,2354,27.1,721,724,1633
11.10.2017 06:00,2569,28.85,693,699,1876
11.10.2017 07:00,2991,30.28,667,667,2324
11.10.2017 08:00,3362,30.95,664,655,2698
11.10.2017 09:00,3437,31.16,669,663,2768
11.10.2017 10:00,3555,30.91,738,724,2817
11.10.2017 11:00,3586,30.85,790,778,2796
11.10.2017 12:00,3662,30.69,797,807,2865
11.10.2017 13:00,3633,30.57,801,827,2832
11.10.2017 14:00,3508,30.41,807,826,2701
11.10.2017 15:00,3452,30.16,808,821,2644
11.10.2017 16:00,3531,30.12,759,811,2772
11.10.2017 17:00,3545,30.52,804,801,2741
11.10.2017 18:00,3562,30.84,781,768,2781
11.10.2017 19:00,3380,30.72,766,751,2614
11.10.2017 20:00,3266,30.31,779,780,2487
11.10.2017 21:00,3124,29.39,813,814,2311
11.10.2017 22:00,3020,28.36,847,848,2173
11.10.2017 23:00,2709,27.42,922,923,1787
11.11.2017 00:00,2559,26.06,978,979,1581
11.11.2017 01:00,2458,27.97,1000,1001,1458
11.11.2017 02:00,2415,27.37,1038,1039,1377
11.11.2017 03:00,2333,27.08,1069,1069,1264
11.11.2017 04:00,2278,26.87,1098,1099,1180
11.11.2017 05:00,2300,26.37,1133,1134,1167
11.11.2017 06:00,2366,26.29,1160,1162,1206
11.11.2017 07:00,2472,27.72,1182,1184,1290
11.11.2017 08:00,2550,27.74,1193,1195,1357
11.11.2017 09:00,2669,28.51,1197,1198,1472
11.11.2017 10:00,2789,28.96,1202,1201,1587
11.11.2017 11:00,2826,29.14,1210,1208,1616
11.11.2017 12:00,2818,29.13,1217,1216,1601
11.11.2017 13:00,2793,28.95,1214,1212,1579
11.11.2017 14:00,2745,28.83,1184,1185,1561
11.11.2017 15:00,2707,28.9,1127,1127,1580
11.11.2017 16:00,2745,29.78,1061,1062,1684
11.11.2017 17:00,2951,30.7,1015,1013,1936
11.11.2017 18:00,3086,31.17,1007,1003,2079
11.11.2017 19:00,3000,30.9,974,969,2026
11.11.2017 20:00,2867,30.36,934,932,1933
11.11.2017 21:00,2769,29.9,933,929,1836
11.11.2017 22:00,2625,29.74,898,893,1727
11.11.2017 23:00,2494,29.48,886,879,1608
11.12.2017 00:00,2373,28.29,871,866,1502
11.12.2017 01:00,2348,28.26,862,855,1486
11.12.2017 02:00,2267,27.43,811,812,1456
11.12.2017 03:00,2251,27.09,768,767,1483
11.12.2017 04:00,2234,26.96,718,713,1516
11.12.2017 05:00,2310,27.1,664,658,1646
11.12.2017 06:00,2323,27.3,614,605,1709
11.12.2017 07:00,2373,27.44,574,563,1799
11.12.2017 08:00,2492,28.41,506,505,1986
11.12.2017 09:00,2624,29.58,449,442,2175
11.12.2017 10:00,2752,30.58,391,372,2361
11.12.2017 11:00,2820,30.93,329,323,2491
11.12.2017 12:00,2834,31.06,288,286,2546
11.12.2017 13:00,2802,30.92,254,254,2548
11.12.2017 14:00,2824,30.81,219,220,2605
11.12.2017 15:00,2888,30.82,189,190,2699
11.12.2017 16:00,2954,30.99,176,177,2778
11.12.2017 17:00,3151,39.84,185,178,2966
11.12.2017 18:00,3200,44.35,163,161,3037
11.12.2017 19:00,3191,43,139,137,3052
11.12.2017 20:00,3133,37.3,146,150,2987
11.12.2017 21:00,3089,30.94,136,140,2953
11.12.2017 22:00,3000,30.69,162,163,2838
11.12.2017 23:00,2883,30.25,175,173,2708
13.11.2017 00:00,2725,29.73,176,181,2549
13.11.2017 01:00,2646,29.85,179,180,2467
13.11.2017 02:00,2625,29.68,186,192,2439
13.11.2017 03:00,2570,29.64,201,198,2369
13.11.2017 04:00,2551,29.66,219,197,2332
13.11.2017 05:00,2643,29.79,228,223,2415
13.11.2017 06:00,2897,30.92,223,232,2674
13.11.2017 07:00,3320,40.6,237,253,3083
13.11.2017 08:00,3627,47.89,245,260,3382
13.11.2017 09:00,3678,53.03,240,244,3438
13.11.2017 10:00,3750,46.99,227,227,3523
13.11.2017 11:00,3757,44.73,201,196,3556
13.11.2017 12:00,3691,45.49,182,171,3509
13.11.2017 13:00,3558,41.48,154,144,3404
13.11.2017 14:00,3513,48.08,156,139,3357
13.11.2017 15:00,3487,49.59,170,156,3317
13.11.2017 16:00,3581,53.61,193,180,3388
13.11.2017 17:00,3727,55.92,200,191,3527
13.11.2017 18:00,3831,70.08,193,193,3638
13.11.2017 19:00,3735,62.3,185,193,3550
13.11.2017 20:00,3634,56.34,187,194,3447
13.11.2017 21:00,3507,44.09,168,169,3339
13.11.2017 22:00,3423,39.47,152,154,3271
13.11.2017 23:00,3300,31.04,142,146,3158
14.11.2017 00:00,3112,30.38,143,142,2969
14.11.2017 01:00,2906,30.87,135,132,2771
14.11.2017 02:00,2809,30.62,148,146,2661
14.11.2017 03:00,2781,30.39,167,171,2614
14.11.2017 04:00,2741,30.13,217,204,2524
14.11.2017 05:00,2743,30.39,248,233,2495
14.11.2017 06:00,2993,31.07,277,269,2716
14.11.2017 07:00,3444,36.56,296,295,3148
14.11.2017 08:00,3707,42.48,320,327,3387
14.11.2017 09:00,3711,48.39,380,382,3331
14.11.2017 10:00,3710,36.31,422,419,3288
14.11.2017 11:00,3772,32.67,483,482,3289
14.11.2017 12:00,3735,32.32,539,532,3196
14.11.2017 13:00,3736,32.13,606,614,3130
14.11.2017 14:00,3775,31.98,678,670,3097
14.11.2017 15:00,3730,32.04,724,714,3006
14.11.2017 16:00,3665,32,758,738,2907
14.11.2017 17:00,3691,32.52,736,733,2955
14.11.2017 18:00,3725,38.67,730,726,2995
14.11.2017 19:00,3606,32.77,672,667,2934
14.11.2017 20:00,3494,32.38,614,623,2880
14.11.2017 21:00,3372,31.81,539,562,2833
14.11.2017 22:00,3218,31.44,493,514,2725
14.11.2017 23:00,3028,30.66,483,488,2545
15.11.2017 00:00,2842,29.74,490,492,2352
15.11.2017 01:00,2698,29.89,463,459,2235
15.11.2017 02:00,2577,29.54,477,466,2100
15.11.2017 03:00,2487,29.46,476,482,2011
15.11.2017 04:00,2503,29.43,495,506,2008
15.11.2017 05:00,2608,29.67,521,531,2087
15.11.2017 06:00,2770,30.54,558,562,2212
15.11.2017 07:00,3235,31.47,594,591,2641
15.11.2017 08:00,3573,33.69,612,612,2961
15.11.2017 09:00,3562,38.66,611,626,2951
15.11.2017 10:00,3559,31.95,643,650,2916
15.11.2017 11:00,3508,31.63,676,684,2832
15.11.2017 12:00,3495,31.48,685,699,2810
15.11.2017 13:00,3433,31.47,718,731,2715
15.11.2017 14:00,3384,31.57,712,716,2672
15.11.2017 15:00,3363,31.53,670,684,2693
15.11.2017 16:00,3404,38.6,617,638,2787
15.11.2017 17:00,3530,53.01,593,591,2937
15.11.2017 18:00,3593,74.84,548,539,3045
15.11.2017 19:00,3515,49.07,496,490,3019
15.11.2017 20:00,3434,44.03,457,450,2977
15.11.2017 21:00,3298,31.35,416,422,2882
15.11.2017 22:00,3150,31.1,369,379,2781
15.11.2017 23:00,2945,30.41,337,341,2608
16.11.2017 00:00,2750,29.39,319,321,2431
16.11.2017 01:00,2638,29.81,288,292,2350
16.11.2017 02:00,2568,29.24,268,268,2300
16.11.2017 03:00,2571,29.35,249,250,2322
16.11.2017 04:00,2605,29.28,228,230,2377
16.11.2017 05:00,2673,29.86,210,211,2463
16.11.2017 06:00,2880,30.51,198,199,2682
16.11.2017 07:00,3315,32.64,191,192,3124
16.11.2017 08:00,3693,47.93,184,184,3509
16.11.2017 09:00,3749,53.29,197,196,3552
16.11.2017 10:00,3696,41.09,208,208,3488
16.11.2017 11:00,3681,43.01,241,237,3440
16.11.2017 12:00,3681,38.66,275,281,3406
16.11.2017 13:00,3621,33.5,313,321,3308
16.11.2017 14:00,3568,38.64,391,373,3177
16.11.2017 15:00,3556,31.08,456,459,3100
16.11.2017 16:00,3591,31.04,569,567,3022
16.11.2017 17:00,3651,31.02,668,667,2983
16.11.2017 18:00,3606,31.08,795,782,2811
16.11.2017 19:00,3447,30.84,882,874,2565
16.11.2017 20:00,3388,30.37,952,960,2436
16.11.2017 21:00,3263,29.82,1000,1027,2263
16.11.2017 22:00,3045,29.42,1027,1057,2018
16.11.2017 23:00,2773,28.63,1039,1036,1734
17.11.2017 00:00,2585,27.56,1019,1018,1566
17.11.2017 01:00,2644,27.82,998,1042,1646
17.11.2017 02:00,2649,27.28,986,1020,1663
17.11.2017 03:00,2560,27.04,991,1003,1569
17.11.2017 04:00,2511,27.02,987,965,1524
17.11.2017 05:00,2587,27.78,981,964,1606
17.11.2017 06:00,2715,28.49,986,960,1729
17.11.2017 07:00,3177,29.74,981,961,2196
17.11.2017 08:00,3552,30.75,931,934,2621
17.11.2017 09:00,3621,30.91,901,913,2720
17.11.2017 10:00,3610,30.59,870,886,2740
17.11.2017 11:00,3580,30.2,845,858,2735
17.11.2017 12:00,3474,29.97,829,827,2645
17.11.2017 13:00,3350,29.93,822,825,2528
17.11.2017 14:00,3370,29.96,826,837,2544
17.11.2017 15:00,3354,29.97,848,856,2506
17.11.2017 16:00,3426,29.99,868,869,2558
17.11.2017 17:00,3576,30.32,874,887,2702
17.11.2017 18:00,3533,30.63,917,915,2616
17.11.2017 19:00,3429,30.36,968,955,2461
17.11.2017 20:00,3306,29.74,993,985,2313
17.11.2017 21:00,3142,28.97,1001,996,2141
17.11.2017 22:00,2929,28.52,1025,1008,1904
17.11.2017 23:00,2753,27.93,1052,1046,1701
18.11.2017 00:00,2624,27.53,1097,1081,1527
18.11.2017 01:00,2416,27.11,1096,1075,1320
18.11.2017 02:00,2340,23.56,1117,1100,1223
18.11.2017 03:00,2339,20.04,1128,1134,1211
18.11.2017 04:00,2333,18.25,1129,1142,1204
18.11.2017 05:00,2311,23.01,1135,1147,1176
18.11.2017 06:00,2342,26.73,1126,1139,1216
18.11.2017 07:00,2420,27.29,1119,1133,1301
18.11.2017 08:00,2547,28.08,1078,1095,1469
18.11.2017 09:00,2709,28.23,1036,1051,1673
18.11.2017 10:00,2905,28.61,998,1018,1907
18.11.2017 11:00,2952,28.8,950,965,2002
18.11.2017 12:00,3026,28.68,886,900,2140
18.11.2017 13:00,3084,28.5,803,824,2281
18.11.2017 14:00,3033,28.43,778,778,2255
18.11.2017 15:00,3024,28.52,690,725,2334
18.11.2017 16:00,3041,28.91,702,709,2339
18.11.2017 17:00,3207,29.5,706,707,2501
18.11.2017 18:00,3210,29.77,698,682,2512
18.11.2017 19:00,3119,29.7,723,720,2396
18.11.2017 20:00,2980,28.93,737,749,2243
18.11.2017 21:00,2850,28.53,768,767,2082
18.11.2017 22:00,2683,28.53,792,789,1891
18.11.2017 23:00,2558,28.18,794,792,1764
19.11.2017 00:00,2438,28.08,784,787,1654
19.11.2017 01:00,2262,27.88,713,710,1549
19.11.2017 02:00,2201,27.6,692,690,1509
19.11.2017 03:00,2116,27.51,654,652,1462
19.11.2017 04:00,2157,27.16,606,603,1551
19.11.2017 05:00,2223,27.51,567,568,1656
19.11.2017 06:00,2304,27.35,507,508,1797
19.11.2017 07:00,2404,27.47,443,450,1961
19.11.2017 08:00,2526,27.92,415,418,2111
19.11.2017 09:00,2660,28.21,413,414,2247
19.11.2017 10:00,2827,28.46,421,447,2406
19.11.2017 11:00,2970,28.56,524,537,2446
19.11.2017 12:00,3030,28.67,621,624,2409
19.11.2017 13:00,3094,28.61,725,719,2369
19.11.2017 14:00,3103,28.45,811,816,2292
19.11.2017 15:00,3130,28.76,886,889,2244
19.11.2017 16:00,3206,29.21,911,914,2295
19.11.2017 17:00,3298,29.7,912,915,2386
19.11.2017 18:00,3335,30.33,876,879,2459
19.11.2017 19:00,3253,30.4,822,825,2431
19.11.2017 20:00,3178,29.95,748,748,2430
19.11.2017 21:00,3104,29.62,673,665,2431
19.11.2017 22:00,3035,29.39,599,577,2436
19.11.2017 23:00,2958,29.2,495,492,2463
20.11.2017 00:00,2894,28.7,412,447,2482
20.11.2017 01:00,2855,28.66,414,438,2441
20.11.2017 02:00,2786,28.13,360,372,2426
20.11.2017 03:00,2786,28.2,328,327,2458
20.11.2017 04:00,2806,28.48,279,289,2527
20.11.2017 05:00,2861,28.98,254,263,2607
20.11.2017 06:00,3063,29.86,229,234,2834
20.11.2017 07:00,3529,33.9,213,221,3316
20.11.2017 08:00,3984,40.41,190,198,3794
20.11.2017 09:00,4012,43.92,186,187,3826
20.11.2017 10:00,3997,42.85,168,166,3829
20.11.2017 11:00,3971,42.63,151,152,3820
20.11.2017 12:00,3921,42.89,129,132,3792
20.11.2017 13:00,3832,43.3,119,123,3713
20.11.2017 14:00,3830,47.87,114,118,3716
20.11.2017 15:00,3835,52.17,102,105,3733
20.11.2017 16:00,3940,50.99,91,94,3849
20.11.2017 17:00,4037,59.3,88,90,3949
20.11.2017 18:00,4087,66.02,90,92,3997
20.11.2017 19:00,4001,53.38,94,96,3907
20.11.2017 20:00,3964,46.78,96,97,3868
20.11.2017 21:00,3827,42.9,86,86,3741
20.11.2017 22:00,3661,37.7,89,88,3572
20.11.2017 23:00,3442,33.78,93,91,3349
21.11.2017 00:00,3275,32.82,88,86,3187
21.11.2017 01:00,3070,33.03,60,62,3010
21.11.2017 02:00,3028,31.93,55,59,2973
21.11.2017 03:00,3011,32.12,56,60,2955
21.11.2017 04:00,3024,32.12,60,63,2964
21.11.2017 05:00,3065,33.91,65,69,3000
21.11.2017 06:00,3219,37.92,71,74,3148
21.11.2017 07:00,3614,46.51,84,85,3530
21.11.2017 08:00,3972,67.86,86,86,3886
21.11.2017 09:00,4000,72.63,78,79,3922
21.11.2017 10:00,3947,54.99,71,71,3876
21.11.2017 11:00,3980,54.26,63,61,3917
21.11.2017 12:00,3988,63.44,52,52,3936
21.11.2017 13:00,3958,55.27,44,45,3914
21.11.2017 14:00,3958,64.91,50,45,3908
21.11.2017 15:00,3924,62.65,62,54,3862
21.11.2017 16:00,3971,62.65,89,74,3882
21.11.2017 17:00,4080,64.19,111,101,3969
21.11.2017 18:00,4138,69.72,138,129,4000
21.11.2017 19:00,3984,57.46,166,157,3818
21.11.2017 20:00,3920,43.99,200,186,3720
21.11.2017 21:00,3799,35.42,244,217,3555
21.11.2017 22:00,3661,32.64,277,249,3384
21.11.2017 23:00,3461,31.31,320,296,3141
22.11.2017 00:00,3260,29.69,381,363,2879
22.11.2017 01:00,3030,29.27,425,400,2605
22.11.2017 02:00,2947,28.92,450,467,2497
22.11.2017 03:00,2937,28.71,562,557,2375
22.11.2017 04:00,2908,28.61,672,660,2236
22.11.2017 05:00,2886,28.86,767,751,2119
22.11.2017 06:00,3023,29.25,867,858,2156
22.11.2017 07:00,3411,30.96,958,950,2453
22.11.2017 08:00,3801,36.34,990,981,2811
22.11.2017 09:00,3856,35.72,987,988,2869
22.11.2017 10:00,3821,32.49,969,977,2852
22.11.2017 11:00,3854,31.98,925,946,2929
22.11.2017 12:00,3847,31.8,877,874,2970
22.11.2017 13:00,3812,31.03,806,798,3006
22.11.2017 14:00,3847,31.3,730,750,3117
22.11.2017 15:00,3833,32.56,670,700,3163
22.11.2017 16:00,3881,33.44,662,686,3219
22.11.2017 17:00,3823,34.16,666,682,3157
22.11.2017 18:00,3746,34,707,708,3039
22.11.2017 19:00,3577,31.85,744,747,2833
22.11.2017 20:00,3408,31.04,791,784,2617
22.11.2017 21:00,3189,30.03,826,810,2363
22.11.2017 22:00,3014,29.74,864,845,2150
22.11.2017 23:00,2815,28.66,884,877,1931
23.11.2017 00:00,2623,27.04,888,879,1735
23.11.2017 01:00,2586,27.53,927,923,1659
23.11.2017 02:00,2518,24.92,940,933,1578
23.11.2017 03:00,2515,21.7,950,944,1565
23.11.2017 04:00,2551,21.19,962,954,1589
23.11.2017 05:00,2590,26.21,979,976,1611
23.11.2017 06:00,2720,27.15,998,993,1722
23.11.2017 07:00,3020,28.47,1017,1013,2003
23.11.2017 08:00,3360,31.05,1025,1022,2335
23.11.2017 09:00,3440,31.09,1036,1033,2404
23.11.2017 10:00,3469,29.96,1048,1044,2421
23.11.2017 11:00,3524,29.12,1041,1038,2483
23.11.2017 12:00,3542,28.98,1038,1039,2504
23.11.2017 13:00,3561,29.09,1055,1053,2506
23.11.2017 14:00,3490,28.98,1081,1079,2409
23.11.2017 15:00,3493,28.94,1100,1098,2393
23.11.2017 16:00,3483,30.02,1129,1128,2354
23.11.2017 17:00,3526,30.75,1158,1155,2368
23.11.2017 18:00,3551,30.88,1183,1185,2368
23.11.2017 19:00,3513,30.21,1175,1180,2338
23.11.2017 20:00,3427,29.69,1151,1152,2276
23.11.2017 21:00,3252,28.81,1085,1094,2167
23.11.2017 22:00,3006,28.64,1035,1014,1971
23.11.2017 23:00,2835,27.41,938,950,1897
24.11.2017 00:00,2621,24.05,952,960,1669
24.11.2017 01:00,2398,26.93,888,866,1510
24.11.2017 02:00,2352,27.08,901,888,1451
24.11.2017 03:00,2386,27.37,911,924,1475
24.11.2017 04:00,2372,27.1,920,924,1452
24.11.2017 05:00,2400,28.22,892,893,1508
24.11.2017 06:00,2696,29.55,813,830,1883
24.11.2017 07:00,3150,31.24,723,741,2427
24.11.2017 08:00,3487,32.88,632,627,2855
24.11.2017 09:00,3558,34.25,545,536,3013
24.11.2017 10:00,3587,45.79,423,424,3164
24.11.2017 11:00,3648,44.34,339,344,3309
24.11.2017 12:00,3570,45.39,270,242,3300
24.11.2017 13:00,3480,38.62,187,171,3293
24.11.2017 14:00,3476,40.14,132,150,3344
24.11.2017 15:00,3425,42.1,120,134,3305
24.11.2017 16:00,3435,42.1,117,127,3318
24.11.2017 17:00,3490,45.82,106,123,3384
24.11.2017 18:00,3484,45.19,120,130,3364
24.11.2017 19:00,3366,41.64,137,130,3229
24.11.2017 20:00,3179,40.74,151,140,3028
24.11.2017 21:00,3028,31.6,172,168,2856
24.11.2017 22:00,2858,31.18,203,202,2655
24.11.2017 23:00,2776,30.18,210,214,2566
25.11.2017 00:00,2653,29.34,200,216,2453
25.11.2017 01:00,2620,29.99,204,213,2416
25.11.2017 02:00,2524,29.54,218,211,2306
25.11.2017 03:00,2477,29.37,212,204,2265
25.11.2017 04:00,2485,29.31,202,197,2283
25.11.2017 05:00,2550,29.52,187,185,2363
25.11.2017 06:00,2653,29.75,164,164,2489
25.11.2017 07:00,2829,29.95,158,164,2671
25.11.2017 08:00,3019,31.81,143,148,2876
25.11.2017 09:00,3154,35.45,130,134,3024
25.11.2017 10:00,3232,40.78,106,108,3126
25.11.2017 11:00,3300,41.35,99,100,3201
25.11.2017 12:00,3325,41.21,89,89,3236
25.11.2017 13:00,3281,40.57,83,83,3198
25.11.2017 14:00,3221,38.96,75,79,3146
25.11.2017 15:00,3203,35.2,76,79,3127
25.11.2017 16:00,3256,34.44,77,81,3179
25.11.2017 17:00,3389,38.62,72,73,3317
25.11.2017 18:00,3439,40.07,75,75,3364
25.11.2017 19:00,3354,37.49,84,79,3270
25.11.2017 20:00,3216,34.19,101,84,3115
25.11.2017 21:00,3080,31.84,111,97,2969
25.11.2017 22:00,2929,30.18,143,123,2786
25.11.2017 23:00,2791,29.37,164,147,2627
26.11.2017 00:00,2649,28.27,210,183,2439
26.11.2017 01:00,2547,28.64,244,227,2303
26.11.2017 02:00,2463,28.26,270,247,2193
26.11.2017 03:00,2413,28.07,311,284,2102
26.11.2017 04:00,2447,27.9,332,329,2115
26.11.2017 05:00,2495,27.52,365,364,2130
26.11.2017 06:00,2555,27.5,408,423,2147
26.11.2017 07:00,2672,27.89,480,474,2192
26.11.2017 08:00,2750,28.11,570,549,2180
26.11.2017 09:00,2786,28.21,651,631,2135
26.11.2017 10:00,2930,28.49,728,710,2202
26.11.2017 11:00,3037,29.03,759,744,2278
26.11.2017 12:00,3184,29.06,787,780,2397
26.11.2017 13:00,3290,29.04,821,811,2469
26.11.2017 14:00,3278,28.84,844,832,2434
26.11.2017 15:00,3254,28.84,862,852,2392
26.11.2017 16:00,3277,28.99,862,857,2415
26.11.2017 17:00,3445,29.73,865,879,2580
26.11.2017 18:00,3460,30.06,918,915,2542
26.11.2017 19:00,3402,29.79,942,939,2460
26.11.2017 20:00,3266,29.51,962,961,2304
26.11.2017 21:00,3106,29.07,992,991,2114
26.11.2017 22:00,2888,29.01,1023,1009,1865
26.11.2017 23:00,2698,28.37,1044,1031,1654
27.11.2017 00:00,2577,28.02,1066,1060,1511
27.11.2017 01:00,2486,27.5,1066,1059,1420
27.11.2017 02:00,2453,27.36,1091,1085,1362
27.11.2017 03:00,2412,27.29,1098,1092,1314
27.11.2017 04:00,2388,27.27,1088,1080,1300
27.11.2017 05:00,2479,27.79,1061,1049,1418
27.11.2017 06:00,2623,28.94,1018,1002,1605
27.11.2017 07:00,3108,31.93,967,949,2141
27.11.2017 08:00,3514,35.26,888,879,2626
27.11.2017 09:00,3548,39.1,811,812,2737
27.11.2017 10:00,3531,35.57,768,769,2763
27.11.2017 11:00,3550,34.06,722,730,2828
27.11.2017 12:00,3631,33.89,689,704,2942
27.11.2017 13:00,3588,32.25,684,685,2904
27.11.2017 14:00,3632,32.38,699,683,2933
27.11.2017 15:00,3691,33.33,726,725,2965
27.11.2017 16:00,3762,34.82,752,753,3010
27.11.2017 17:00,3790,35.7,809,812,2981
27.11.2017 18:00,3800,40.32,888,890,2912
27.11.2017 19:00,3705,36.7,929,931,2776
27.11.2017 20:00,3566,35.26,919,920,2647
27.11.2017 21:00,3471,33.95,895,887,2576
27.11.2017 22:00,3281,31.36,815,819,2466
27.11.2017 23:00,3054,30,726,741,2328
28.11.2017 00:00,2872,28.63,649,672,2223
28.11.2017 01:00,2756,28.74,541,564,2215
28.11.2017 02:00,2673,28.47,465,500,2208
28.11.2017 03:00,2558,28.27,463,452,2095
28.11.2017 04:00,2566,28.08,426,423,2140
28.11.2017 05:00,2581,28.68,430,420,2151
28.11.2017 06:00,2735,29.57,422,430,2313
28.11.2017 07:00,3183,32.65,443,442,2740
28.11.2017 08:00,3591,39.16,473,475,3118
28.11.2017 09:00,3668,37.78,497,487,3171
28.11.2017 10:00,3687,36.39,511,515,3176
28.11.2017 11:00,3668,35.84,544,548,3124
28.11.2017 12:00,3664,36.05,560,560,3104
28.11.2017 13:00,3677,39.91,591,591,3086
28.11.2017 14:00,3703,43.99,614,615,3089
28.11.2017 15:00,3654,43.4,628,627,3026
28.11.2017 16:00,3695,47.08,636,639,3059
28.11.2017 17:00,3742,51.97,651,651,3091
28.11.2017 18:00,3744,58.27,653,647,3091
28.11.2017 19:00,3652,48.02,639,626,3013
28.11.2017 20:00,3553,36.83,617,604,2936
28.11.2017 21:00,3418,34.98,596,592,2822
28.11.2017 22:00,3306,33.58,562,573,2744
28.11.2017 23:00,3123,32.22,513,528,2610
29.11.2017 00:00,2916,30.82,455,462,2461
29.11.2017 01:00,2820,30.48,404,401,2416
29.11.2017 02:00,2771,30.04,367,363,2404
29.11.2017 03:00,2773,29.8,332,332,2441
29.11.2017 04:00,2777,30.21,310,301,2467
29.11.2017 05:00,2815,31.13,285,273,2530
29.11.2017 06:00,2988,33.05,263,250,2725
29.11.2017 07:00,3375,44.65,238,238,3137
29.11.2017 08:00,3767,56.71,220,224,3547
29.11.2017 09:00,3827,68.83,193,194,3634
29.11.2017 10:00,3829,53.26,190,192,3639
29.11.2017 11:00,3848,49.37,162,167,3686
29.11.2017 12:00,3814,48.04,160,154,3654
29.11.2017 13:00,3738,46.91,145,142,3593
29.11.2017 14:00,3744,67.75,136,137,3608
29.11.2017 15:00,3754,68.93,132,136,3622
29.11.2017 16:00,3833,88.23,117,123,3716
29.11.2017 17:00,3889,95.45,132,131,3757
29.11.2017 18:00,3898,114.7,117,115,3781
29.11.2017 19:00,3841,71.36,119,123,3722
29.11.2017 20:00,3765,48.06,113,118,3652
29.11.2017 21:00,3656,43.62,98,102,3558
29.11.2017 22:00,3503,36,98,102,3405
29.11.2017 23:00,3320,33.36,85,89,3235
30.11.2017 00:00,3131,32,70,71,3061
30.11.2017 01:00,3015,31.73,67,68,2948
30.11.2017 02:00,2974,30.84,56,57,2918
30.11.2017 03:00,2950,30.65,46,47,2904
30.11.2017 04:00,2968,30.86,37,38,2931
30.11.2017 05:00,2994,31.96,30,30,2964
30.11.2017 06:00,3160,33.14,24,25,3136
30.11.2017 07:00,3547,37.29,23,24,3524
30.11.2017 08:00,3890,54.94,24,26,3866
30.11.2017 09:00,3921,70.41,24,29,3897
30.11.2017 10:00,3906,56.94,27,29,3879
30.11.2017 11:00,3924,56.51,27,29,3897
30.11.2017 12:00,3919,53.55,30,31,3889
30.11.2017 13:00,3877,50.49,31,33,3846
30.11.2017 14:00,3846,51.29,36,39,3810
30.11.2017 15:00,3831,49.7,53,56,3778
30.11.2017 16:00,3894,59.97,79,80,3815
30.11.2017 17:00,3953,68.65,99,102,3854
30.11.2017 18:00,3998,61.64,135,140,3863
30.11.2017 19:00,3923,48.67,164,166,3759
30.11.2017 20:00,3850,45.1,178,180,3672
30.11.2017 21:00,3749,35.72,216,218,3533
30.11.2017 22:00,3581,34.38,231,230,3350
30.11.2017 23:00,3370,32.88,257,260,3113
12.01.2017 00:00,3140,30.92,280,285,2860
12.01.2017 01:00,2996,31.24,309,313,2687
12.01.2017 02:00,2951,30.02,365,364,2586
12.01.2017 03:00,2952,29.76,414,414,2538
12.01.2017 04:00,2922,29.77,459,457,2463
12.01.2017 05:00,2950,30.4,500,499,2450
12.01.2017 06:00,3082,31.83,533,532,2549
12.01.2017 07:00,3542,35.57,576,572,2966
12.01.2017 08:00,3927,45.12,602,604,3325
12.01.2017 09:00,3963,50.85,581,581,3382
12.01.2017 10:00,3930,53.29,576,576,3354
12.01.2017 11:00,3921,47.02,563,553,3358
12.01.2017 12:00,3902,47.51,519,522,3383
12.01.2017 13:00,3825,47.36,504,511,3321
12.01.2017 14:00,3789,47.51,475,471,3314
12.01.2017 15:00,3707,47.51,459,440,3248
12.01.2017 16:00,3768,48.69,435,417,3333
12.01.2017 17:00,3941,57.39,424,419,3517
12.01.2017 18:00,3915,65.7,385,389,3530
12.01.2017 19:00,3769,52.1,342,337,3427
12.01.2017 20:00,3657,48.29,315,309,3342
12.01.2017 21:00,3526,41.43,269,265,3257
12.01.2017 22:00,3391,35.07,244,235,3147
12.01.2017 23:00,3254,32.2,204,206,3050
12.02.2017 00:00,3085,30.98,176,182,2909
12.02.2017 01:00,2966,31.47,162,160,2804
12.02.2017 02:00,2935,30.56,148,145,2787
12.02.2017 03:00,2906,29.92,137,136,2769
12.02.2017 04:00,2866,29.8,141,136,2725
12.02.2017 05:00,2868,29.83,151,149,2717
12.02.2017 06:00,2977,30.32,172,179,2805
12.02.2017 07:00,3074,30.8,213,221,2861
12.02.2017 08:00,3218,30.95,278,280,2940
12.02.2017 09:00,3328,30.93,341,337,2987
12.02.2017 10:00,3423,31.54,404,402,3019
12.02.2017 11:00,3461,31.88,449,447,3012
12.02.2017 12:00,3440,31.65,506,487,2934
12.02.2017 13:00,3415,31.11,548,527,2867
12.02.2017 14:00,3377,30.74,582,570,2795
12.02.2017 15:00,3342,30.71,602,589,2740
12.02.2017 16:00,3367,31.05,651,632,2716
12.02.2017 17:00,3526,31.67,688,672,2838
12.02.2017 18:00,3546,31.9,718,713,2828
12.02.2017 19:00,3437,31.23,735,754,2702
12.02.2017 20:00,3316,30.02,811,796,2505
12.02.2017 21:00,3190,29.43,850,837,2340
12.02.2017 22:00,3060,28.82,876,867,2184
12.02.2017 23:00,2927,28.35,918,918,2009
12.03.2017 00:00,2762,27.73,961,946,1801
12.03.2017 01:00,2667,28.12,1042,1026,1625
12.03.2017 02:00,2661,27.69,1072,1060,1589
12.03.2017 03:00,2592,27.49,1100,1088,1492
12.03.2017 04:00,2605,27.5,1120,1116,1485
12.03.2017 05:00,2650,27.74,1127,1124,1523
12.03.2017 06:00,2701,27.96,1117,1112,1584
12.03.2017 07:00,2774,28.01,1100,1096,1674
12.03.2017 08:00,2877,27.72,1063,1058,1814
12.03.2017 09:00,2978,28.35,1027,1023,1951
12.03.2017 10:00,3101,28.77,973,972,2128
12.03.2017 11:00,3210,29.25,919,909,2291
12.03.2017 12:00,3269,29.57,850,837,2419
12.03.2017 13:00,3266,29.72,769,757,2497
12.03.2017 14:00,3258,29.61,682,690,2576
12.03.2017 15:00,3260,29.72,603,629,2657
12.03.2017 16:00,3300,30.2,561,572,2739
12.03.2017 17:00,3430,30.92,541,539,2889
12.03.2017 18:00,3469,31.31,532,518,2937
12.03.2017 19:00,3409,31.05,508,505,2901
12.03.2017 20:00,3393,30.64,483,492,2910
12.03.2017 21:00,3325,30.22,461,470,2864
12.03.2017 22:00,3153,30.17,434,438,2719
12.03.2017 23:00,2956,29.42,412,434,2544
12.04.2017 00:00,2750,28.25,417,434,2333
12.04.2017 01:00,2731,26.7,454,457,2277
12.04.2017 02:00,2688,26.23,453,460,2235
12.04.2017 03:00,2669,26.18,450,458,2219
12.04.2017 04:00,2697,27.01,442,454,2255
12.04.2017 05:00,2723,27.86,440,445,2283
12.04.2017 06:00,2943,28.69,439,440,2504
12.04.2017 07:00,3480,32.39,437,436,3043
12.04.2017 08:00,3895,38.56,427,423,3468
12.04.2017 09:00,3927,41.88,400,406,3527
12.04.2017 10:00,3917,38.29,376,384,3541
12.04.2017 11:00,3890,37.06,350,358,3540
12.04.2017 12:00,3835,38.94,318,330,3517
12.04.2017 13:00,3768,36.36,290,309,3478
12.04.2017 14:00,3747,39.45,289,298,3458
12.04.2017 15:00,3704,42.92,319,305,3385
12.04.2017 16:00,3782,45.04,344,335,3438
12.04.2017 17:00,3903,50.96,361,370,3542
12.04.2017 18:00,3972,51.04,372,383,3600
12.04.2017 19:00,3880,47.68,354,370,3526
12.04.2017 20:00,3713,41.44,358,362,3355
12.04.2017 21:00,3634,36.01,353,360,3281
12.04.2017 22:00,3570,33.66,353,363,3217
12.04.2017 23:00,3326,32.49,359,368,2967
12.05.2017 00:00,3052,30.03,369,363,2683
12.05.2017 01:00,2851,28.69,404,381,2447
12.05.2017 02:00,2798,28.17,412,404,2386
12.05.2017 03:00,2764,27.82,409,415,2355
12.05.2017 04:00,2750,27.93,425,440,2325
12.05.2017 05:00,2757,28.23,471,474,2286
12.05.2017 06:00,2914,29.99,557,543,2357
12.05.2017 07:00,3307,31.73,668,661,2639
12.05.2017 08:00,3689,33.77,769,764,2920
12.05.2017 09:00,3747,33.88,827,822,2920
12.05.2017 10:00,3629,33.05,865,862,2764
12.05.2017 11:00,3671,32.43,926,923,2745
12.05.2017 12:00,3643,31.9,972,970,2671
12.05.2017 13:00,3621,31.57,1044,1046,2577
12.05.2017 14:00,3655,30.95,1096,1099,2559
12.05.2017 15:00,3611,30.91,1158,1158,2453
12.05.2017 16:00,3700,31.45,1241,1244,2459
12.05.2017 17:00,3714,31.96,1246,1249,2468
12.05.2017 18:00,3770,32.18,1264,1262,2506
12.05.2017 19:00,3627,31.8,1255,1253,2372
12.05.2017 20:00,3556,30.97,1246,1249,2310
12.05.2017 21:00,3418,29.98,1208,1212,2210
12.05.2017 22:00,3314,29.22,1170,1175,2144
12.05.2017 23:00,3126,28.06,1114,1118,2012
12.06.2017 00:00,2916,27.02,1060,1064,1856
12.06.2017 01:00,2749,27.02,984,987,1765
12.06.2017 02:00,2668,26.67,960,965,1708
12.06.2017 03:00,2624,26.4,956,961,1668
12.06.2017 04:00,2593,26.49,954,956,1639
12.06.2017 05:00,2608,27.2,946,948,1662
12.06.2017 06:00,2795,27.7,935,940,1860
12.06.2017 07:00,3211,29.57,923,929,2288
12.06.2017 08:00,3668,32.48,903,908,2765
12.06.2017 09:00,3747,33.3,885,884,2862
12.06.2017 10:00,3754,32.84,825,842,2929
12.06.2017 11:00,3786,32.43,838,840,2948
12.06.2017 12:00,3774,32.65,855,857,2919
12.06.2017 13:00,3620,32.44,827,822,2793
12.06.2017 14:00,3600,32.22,837,841,2763
12.06.2017 15:00,3551,32.58,827,830,2724
12.06.2017 16:00,3614,33.03,811,811,2803
12.06.2017 17:00,3596,34.8,802,805,2794
12.06.2017 18:00,3638,35.36,807,815,2831
12.06.2017 19:00,3506,34.96,801,804,2705
12.06.2017 20:00,3364,33.49,815,815,2549
12.06.2017 21:00,3254,32.35,868,869,2386
12.06.2017 22:00,3041,31.75,889,907,2152
12.06.2017 23:00,2903,30,926,966,1977
12.07.2017 00:00,2644,27.95,974,994,1670
12.07.2017 01:00,2542,27.38,1048,1052,1494
12.07.2017 02:00,2465,26.82,1077,1074,1388
12.07.2017 03:00,2445,26.57,1103,1100,1342
12.07.2017 04:00,2449,26.51,1117,1112,1332
12.07.2017 05:00,2529,26.83,1134,1130,1395
12.07.2017 06:00,2759,27.46,1148,1146,1611
12.07.2017 07:00,3137,28.46,1158,1158,1979
12.07.2017 08:00,3502,30.2,1177,1177,2325
12.07.2017 09:00,3547,30.74,1151,1153,2396
12.07.2017 10:00,3529,30.12,1186,1179,2343
12.07.2017 11:00,3546,29.84,1197,1190,2349
12.07.2017 12:00,3623,29.44,1196,1196,2427
12.07.2017 13:00,3607,29.11,1198,1211,2409
12.07.2017 14:00,3614,29.02,1202,1211,2412
12.07.2017 15:00,3653,28.96,1213,1221,2440
12.07.2017 16:00,3713,29.05,1218,1220,2495
12.07.2017 17:00,3748,29.48,1247,1246,2501
12.07.2017 18:00,3778,29.7,1269,1270,2509
12.07.2017 19:00,3707,29.56,1286,1289,2421
12.07.2017 20:00,3620,28.81,1283,1289,2337
12.07.2017 21:00,3447,27.82,1257,1264,2190
12.07.2017 22:00,3251,27.5,1229,1232,2022
12.07.2017 23:00,3010,26.42,1205,1194,1805
12.08.2017 00:00,2813,22.61,1168,1157,1645
12.08.2017 01:00,2701,13.45,1069,1076,1632
12.08.2017 02:00,2617,12.2,1050,1045,1567
12.08.2017 03:00,2555,10.5,1041,1029,1514
12.08.2017 04:00,2594,18.93,1038,1028,1556
12.08.2017 05:00,2599,24.65,1038,1030,1561
12.08.2017 06:00,2798,26.14,1048,1040,1750
12.08.2017 07:00,3268,28.63,1044,1042,2224
12.08.2017 08:00,3665,30.34,1036,1037,2629
12.08.2017 09:00,3701,30.7,1032,1026,2669
12.08.2017 10:00,3644,30.15,1023,1004,2621
12.08.2017 11:00,3633,29.93,1041,1025,2592
12.08.2017 12:00,3624,29.72,1084,1069,2540
12.08.2017 13:00,3606,29.3,1101,1091,2505
12.08.2017 14:00,3567,29.09,1107,1099,2460
12.08.2017 15:00,3627,29.03,1147,1155,2480
12.08.2017 16:00,3660,29.22,1141,1146,2519
12.08.2017 17:00,3784,29.73,1173,1163,2611
12.08.2017 18:00,3771,29.82,1205,1194,2566
12.08.2017 19:00,3689,29.54,1227,1227,2462
12.08.2017 20:00,3517,28.88,1237,1240,2280
12.08.2017 21:00,3356,28.21,1246,1246,2110
12.08.2017 22:00,3200,27.81,1254,1250,1946
12.08.2017 23:00,3062,26.97,1270,1269,1792
12.09.2017 00:00,2891,25.36,1269,1267,1622
12.09.2017 01:00,2794,26.76,1257,1254,1537
12.09.2017 02:00,2700,26.41,1256,1254,1444
12.09.2017 03:00,2656,25.57,1244,1243,1412
12.09.2017 04:00,2641,25.54,1225,1225,1416
12.09.2017 05:00,2575,26.01,1195,1194,1380
12.09.2017 06:00,2626,26.49,1156,1153,1470
12.09.2017 07:00,2746,26.62,1111,1106,1635
12.09.2017 08:00,2916,27.2,1054,1051,1862
12.09.2017 09:00,3044,27.5,1016,1013,2028
12.09.2017 10:00,3192,27.51,988,984,2204
12.09.2017 11:00,3330,27.62,984,986,2346
12.09.2017 12:00,3276,27.64,938,937,2338
12.09.2017 13:00,3224,27.61,930,929,2294
12.09.2017 14:00,3286,27.55,960,960,2326
12.09.2017 15:00,3350,27.6,935,935,2415
12.09.2017 16:00,3479,27.89,953,953,2526
12.09.2017 17:00,3529,28.3,924,922,2605
12.09.2017 18:00,3658,29.88,938,936,2720
12.09.2017 19:00,3613,28.45,953,953,2660
12.09.2017 20:00,3416,27.79,945,942,2471
12.09.2017 21:00,3244,27.46,935,930,2309
12.09.2017 22:00,3092,27.31,917,916,2175
12.09.2017 23:00,2967,27.09,897,891,2070
12.10.2017 00:00,2841,27.01,877,867,1964
12.10.2017 01:00,2752,27.38,823,815,1929
12.10.2017 02:00,2715,27.14,762,761,1953
12.10.2017 03:00,2700,27.04,722,720,1978
12.10.2017 04:00,2697,27,687,681,2010
12.10.2017 05:00,2631,26.99,656,645,1975
12.10.2017 06:00,2699,27.19,606,611,2093
12.10.2017 07:00,2798,27.39,575,583,2223
12.10.2017 08:00,2947,27.43,560,550,2387
12.10.2017 09:00,3023,27.85,525,514,2498
12.10.2017 10:00,3203,28.56,505,510,2698
12.10.2017 11:00,3321,29.15,469,483,2852
12.10.2017 12:00,3412,29.57,487,484,2925
12.10.2017 13:00,3460,29.26,484,486,2976
12.10.2017 14:00,3488,28.94,450,463,3038
12.10.2017 15:00,3483,28.94,431,444,3052
12.10.2017 16:00,3565,29.44,461,451,3104
12.10.2017 17:00,3735,30.27,450,452,3285
12.10.2017 18:00,3780,29.96,505,506,3275
12.10.2017 19:00,3694,29.46,507,516,3187
12.10.2017 20:00,3650,29.27,497,501,3153
12.10.2017 21:00,3470,28.71,483,501,2987
12.10.2017 22:00,3276,28.43,479,489,2797
12.10.2017 23:00,3182,27.93,463,493,2719
12.11.2017 00:00,3066,27.52,456,503,2610
12.11.2017 01:00,2911,27.25,403,437,2508
12.11.2017 02:00,2871,26.94,406,442,2465
12.11.2017 03:00,2886,26.81,428,450,2458
12.11.2017 04:00,2916,26.94,440,444,2476
12.11.2017 05:00,2927,27.88,444,449,2483
12.11.2017 06:00,3121,29.43,446,443,2675
12.11.2017 07:00,3612,33.47,430,427,3182
12.11.2017 08:00,3993,47.64,413,418,3580
12.11.2017 09:00,4124,61.49,366,385,3758
12.11.2017 10:00,4007,56.66,379,378,3628
12.11.2017 11:00,3998,49.01,364,363,3634
12.11.2017 12:00,4082,52.28,276,274,3806
12.11.2017 13:00,4148,50.82,245,260,3903
12.11.2017 14:00,4085,51.1,212,210,3873
12.11.2017 15:00,3984,52.54,183,181,3801
12.11.2017 16:00,4015,51.91,202,204,3813
12.11.2017 17:00,3986,53.38,240,230,3746
12.11.2017 18:00,3966,50.62,262,253,3704
12.11.2017 19:00,3899,46.26,267,258,3632
12.11.2017 20:00,3823,38.73,287,273,3536
12.11.2017 21:00,3694,36.04,243,248,3451
12.11.2017 22:00,3577,32.67,199,209,3378
12.11.2017 23:00,3359,30.58,198,204,3161
12.12.2017 00:00,3123,28.21,203,207,2920
12.12.2017 01:00,2945,27.96,215,216,2730
12.12.2017 02:00,2873,27.4,211,214,2662
12.12.2017 03:00,2854,27.16,202,208,2652
12.12.2017 04:00,2846,27.03,204,203,2642
12.12.2017 05:00,2876,27.38,213,207,2663
12.12.2017 06:00,3043,28.04,222,215,2821
12.12.2017 07:00,3544,30.15,234,231,3310
12.12.2017 08:00,3949,32.32,254,255,3695
12.12.2017 09:00,4037,35.19,282,283,3755
12.12.2017 10:00,3979,34.7,306,304,3673
12.12.2017 11:00,4021,34.75,376,361,3645
12.12.2017 12:00,4019,35.22,415,402,3604
12.12.2017 13:00,3987,36.04,446,448,3541
12.12.2017 14:00,4063,38.17,481,481,3582
12.12.2017 15:00,3889,38.09,526,513,3363
12.12.2017 16:00,3952,39.47,566,569,3386
12.12.2017 17:00,4071,44.99,602,611,3469
12.12.2017 18:00,4041,44.94,576,586,3465
12.12.2017 19:00,3937,40.61,551,570,3386
12.12.2017 20:00,3827,34.89,532,546,3295
12.12.2017 21:00,3748,32.52,533,535,3215
12.12.2017 22:00,3593,31.51,487,501,3106
12.12.2017 23:00,3309,29.79,525,512,2784
13.12.2017 00:00,3030,27.96,584,566,2446
13.12.2017 01:00,2932,27.61,787,765,2145
13.12.2017 02:00,2901,27.04,893,885,2008
13.12.2017 03:00,2926,26.98,985,983,1941
13.12.2017 04:00,2947,26.93,1044,1044,1903
13.12.2017 05:00,2913,27.32,1094,1093,1819
13.12.2017 06:00,2986,27.86,1135,1133,1851
13.12.2017 07:00,3447,29.46,1149,1147,2298
13.12.2017 08:00,3884,31.04,1151,1154,2733
13.12.2017 09:00,3986,31.73,1150,1157,2836
13.12.2017 10:00,3971,31.08,1143,1146,2828
13.12.2017 11:00,4009,30.54,1150,1154,2859
13.12.2017 12:00,3973,29.83,1165,1170,2808
13.12.2017 13:00,3939,29.7,1164,1169,2775
13.12.2017 14:00,3911,29.98,1173,1180,2738
13.12.2017 15:00,3892,30.29,1186,1190,2706
13.12.2017 16:00,4061,31.07,1221,1226,2840
13.12.2017 17:00,4115,31.77,1227,1232,2888
13.12.2017 18:00,4125,32.06,1214,1218,2911
13.12.2017 19:00,4029,31.59,1197,1201,2832
13.12.2017 20:00,3920,30.24,1174,1179,2746
13.12.2017 21:00,3731,29.1,1145,1150,2586
13.12.2017 22:00,3509,28.01,1071,1077,2438
13.12.2017 23:00,3270,27.32,1002,1008,2268
14.12.2017 00:00,3083,26.57,976,981,2107
14.12.2017 01:00,3050,26.44,983,987,2067
14.12.2017 02:00,3048,25.72,902,927,2146
14.12.2017 03:00,3056,25.66,844,877,2212
14.12.2017 04:00,3072,26.07,795,828,2277
14.12.2017 05:00,3024,26.69,783,798,2241
14.12.2017 06:00,3175,27.43,763,775,2412
14.12.2017 07:00,3643,29.71,730,756,2913
14.12.2017 08:00,4177,35.83,681,734,3496
14.12.2017 09:00,4394,35.87,638,716,3756
14.12.2017 10:00,4379,33.03,663,717,3716
14.12.2017 11:00,4247,32.06,672,632,3575
14.12.2017 12:00,4239,31.82,683,653,3556
14.12.2017 13:00,4197,31.54,725,709,3472
14.12.2017 14:00,4189,31.46,761,763,3428
14.12.2017 15:00,4162,31.75,767,764,3395
14.12.2017 16:00,4235,32.47,761,759,3474
14.12.2017 17:00,4181,33.21,755,749,3426
14.12.2017 18:00,4062,34.19,799,789,3263
14.12.2017 19:00,3975,32.33,815,801,3160
14.12.2017 20:00,3877,31.58,823,813,3054
14.12.2017 21:00,3720,30.44,812,802,2908
14.12.2017 22:00,3514,30.07,802,789,2712
14.12.2017 23:00,3341,29.42,800,786,2541
15.12.2017 00:00,3105,28.26,797,785,2308
15.12.2017 01:00,2900,28.66,804,791,2096
15.12.2017 02:00,2798,28.41,786,772,2012
15.12.2017 03:00,2817,28.25,770,758,2047
15.12.2017 04:00,2840,28.28,751,743,2089
15.12.2017 05:00,2855,28.89,728,723,2127
15.12.2017 06:00,3052,30.24,701,695,2351
15.12.2017 07:00,3549,32.75,660,674,2889
15.12.2017 08:00,3951,46.11,629,652,3322
15.12.2017 09:00,4070,53.01,603,625,3467
15.12.2017 10:00,4068,52.63,591,594,3477
15.12.2017 11:00,4152,46.01,511,526,3641
15.12.2017 12:00,4108,45.06,473,486,3635
15.12.2017 13:00,4005,47.06,422,428,3583
15.12.2017 14:00,3910,46.77,395,393,3515
15.12.2017 15:00,3852,46.99,354,358,3498
15.12.2017 16:00,3889,49.5,320,324,3569
15.12.2017 17:00,3981,56.53,294,297,3687
15.12.2017 18:00,3994,49.32,279,279,3715
15.12.2017 19:00,3886,45.07,268,264,3618
15.12.2017 20:00,3738,40.96,269,264,3469
15.12.2017 21:00,3583,31.21,234,232,3349
15.12.2017 22:00,3428,30.54,216,215,3212
15.12.2017 23:00,3262,29.76,208,203,3054
16.12.2017 00:00,3074,29.04,224,208,2850
16.12.2017 01:00,2862,29.94,115,113,2747
16.12.2017 02:00,2793,29.08,104,106,2689
16.12.2017 03:00,2705,28.97,119,112,2586
16.12.2017 04:00,2637,28.9,143,113,2494
16.12.2017 05:00,2683,29,129,116,2554
16.12.2017 06:00,2809,29.28,120,125,2689
16.12.2017 07:00,2917,30.2,127,128,2790
16.12.2017 08:00,3050,30.63,113,112,2937
16.12.2017 09:00,3243,30.71,128,133,3115
16.12.2017 10:00,3405,31.15,130,132,3275
16.12.2017 11:00,3459,31.75,132,132,3327
16.12.2017 12:00,3446,32.1,128,126,3318
16.12.2017 13:00,3419,31.56,134,127,3285
16.12.2017 14:00,3414,31.29,137,130,3277
16.12.2017 15:00,3438,31.49,128,135,3310
16.12.2017 16:00,3565,39.04,137,143,3428
16.12.2017 17:00,3735,45.06,129,138,3606
16.12.2017 18:00,3748,46.04,132,136,3616
16.12.2017 19:00,3701,43.13,135,139,3566
16.12.2017 20:00,3603,39.33,146,147,3457
16.12.2017 21:00,3490,30.7,157,161,3333
16.12.2017 22:00,3378,30.55,171,176,3207
16.12.2017 23:00,3278,30.09,178,190,3100
17.12.2017 00:00,3137,29.02,183,199,2954
17.12.2017 01:00,2999,28.9,142,160,2857
17.12.2017 02:00,2966,28.2,152,180,2814
17.12.2017 03:00,2951,28.2,187,199,2764
17.12.2017 04:00,2933,27.94,220,222,2713
17.12.2017 05:00,2937,28.21,219,225,2718
17.12.2017 06:00,3005,28.38,228,230,2777
17.12.2017 07:00,3095,28.58,215,216,2880
17.12.2017 08:00,3225,29.4,194,190,3031
17.12.2017 09:00,3413,30.23,149,156,3264
17.12.2017 10:00,3557,33.65,123,126,3434
17.12.2017 11:00,3635,36.03,88,89,3547
17.12.2017 12:00,3650,39.81,59,56,3591
17.12.2017 13:00,3646,40.55,46,43,3600
17.12.2017 14:00,3615,39.06,35,35,3580
17.12.2017 15:00,3615,34.93,40,42,3575
17.12.2017 16:00,3730,39.92,48,48,3682
17.12.2017 17:00,3878,44.5,51,52,3827
17.12.2017 18:00,3916,45.84,78,73,3838
17.12.2017 19:00,3900,44.81,101,93,3799
17.12.2017 20:00,3851,41.88,117,114,3734
17.12.2017 21:00,3724,35.54,145,150,3579
17.12.2017 22:00,3566,30.24,173,171,3393
17.12.2017 23:00,3377,29.68,203,196,3174
18.12.2017 00:00,3181,28.59,232,224,2949
18.12.2017 01:00,3104,28.22,277,265,2827
18.12.2017 02:00,3082,27.9,293,288,2789
18.12.2017 03:00,3095,27.55,312,306,2783
18.12.2017 04:00,3031,27.39,328,319,2703
18.12.2017 05:00,3045,28.04,338,323,2707
18.12.2017 06:00,3283,29.94,325,327,2958
18.12.2017 07:00,3689,39.97,335,334,3354
18.12.2017 08:00,4039,47.33,338,340,3701
18.12.2017 09:00,4257,52.22,349,359,3908
18.12.2017 10:00,4189,51.25,336,341,3853
18.12.2017 11:00,4173,45.08,343,342,3830
18.12.2017 12:00,4143,48.01,312,309,3831
18.12.2017 13:00,4092,50.09,280,277,3812
18.12.2017 14:00,4065,50.84,279,279,3786
18.12.2017 15:00,4002,50.08,290,278,3712
18.12.2017 16:00,4088,63.93,285,279,3803
18.12.2017 17:00,4081,71.74,285,280,3796
18.12.2017 18:00,4069,77.81,282,285,3787
18.12.2017 19:00,3966,66.62,278,282,3688
18.12.2017 20:00,3850,47.33,272,266,3578
18.12.2017 21:00,3679,44.03,299,252,3380
18.12.2017 22:00,3547,35.09,243,230,3304
18.12.2017 23:00,3386,31.33,197,235,3189
19.12.2017 00:00,3180,30.38,181,202,2999
19.12.2017 01:00,3084,30.44,137,146,2947
19.12.2017 02:00,2993,29.43,112,120,2881
19.12.2017 03:00,2939,29.35,98,106,2841
19.12.2017 04:00,2938,29.68,88,89,2850
19.12.2017 05:00,2997,31.57,82,83,2915
19.12.2017 06:00,3177,32.64,72,75,3105
19.12.2017 07:00,3532,46.08,79,70,3453
19.12.2017 08:00,3882,66.53,73,65,3809
19.12.2017 09:00,3970,75.06,70,62,3900
19.12.2017 10:00,3946,75.21,69,64,3877
19.12.2017 11:00,3970,56.79,61,54,3909
19.12.2017 12:00,3947,60.5,49,43,3898
19.12.2017 13:00,3896,69.15,46,42,3850
19.12.2017 14:00,3907,68.88,35,35,3872
19.12.2017 15:00,3875,61.97,34,33,3841
19.12.2017 16:00,3982,68.63,34,32,3948
19.12.2017 17:00,4069,74,32,32,4037
19.12.2017 18:00,4080,76.4,32,36,4048
19.12.2017 19:00,4014,65.22,39,42,3975
19.12.2017 20:00,3921,59.44,42,42,3879
19.12.2017 21:00,3757,47.4,45,45,3712
19.12.2017 22:00,3604,38.34,56,56,3548
19.12.2017 23:00,3388,29.82,71,72,3317
20.12.2017 00:00,3195,29.1,89,90,3106
20.12.2017 01:00,3052,29.18,113,114,2939
20.12.2017 02:00,2974,28.53,133,132,2841
20.12.2017 03:00,2911,28.08,155,148,2756
20.12.2017 04:00,2894,28.11,173,165,2721
20.12.2017 05:00,2958,28.87,188,186,2770
20.12.2017 06:00,3134,29.72,209,211,2925
20.12.2017 07:00,3530,44.3,239,244,3291
20.12.2017 08:00,3864,49.92,270,275,3594
20.12.2017 09:00,3960,65.44,300,307,3660
20.12.2017 10:00,3924,63.94,324,330,3600
20.12.2017 11:00,3953,55.64,347,348,3606
20.12.2017 12:00,3914,65.6,380,381,3534
20.12.2017 13:00,3846,59.79,394,400,3452
20.12.2017 14:00,3842,59.82,419,416,3423
20.12.2017 15:00,3863,50.96,449,448,3414
20.12.2017 16:00,3953,53.01,470,479,3483
20.12.2017 17:00,4033,59.34,492,505,3541
20.12.2017 18:00,4024,59.79,497,512,3527
20.12.2017 19:00,3850,49.05,502,509,3348
20.12.2017 20:00,3697,37.01,503,510,3194
20.12.2017 21:00,3505,35.51,523,525,2982
20.12.2017 22:00,3370,30.05,530,537,2840
20.12.2017 23:00,3162,29.04,546,541,2616
21.12.2017 00:00,2919,28,556,537,2363
21.12.2017 01:00,2799,27.57,571,550,2228
21.12.2017 02:00,2757,27.08,532,536,2225
21.12.2017 03:00,2729,26.98,521,529,2208
21.12.2017 04:00,2671,26.95,519,518,2152
21.12.2017 05:00,2745,27.37,514,510,2231
21.12.2017 06:00,2985,28,510,521,2475
21.12.2017 07:00,3420,29.42,521,525,2899
21.12.2017 08:00,3676,42.49,567,532,3109
21.12.2017 09:00,3812,42.06,544,522,3268
21.12.2017 10:00,3858,45.1,523,536,3335
21.12.2017 11:00,3871,30.1,532,555,3339
21.12.2017 12:00,3739,30.2,580,569,3159
21.12.2017 13:00,3721,30.14,584,579,3137
21.12.2017 14:00,3732,30.11,606,611,3126
21.12.2017 15:00,3731,38.63,616,647,3115
21.12.2017 16:00,3780,41.04,671,681,3109
21.12.2017 17:00,3889,41.07,738,722,3151
21.12.2017 18:00,4204,42.42,780,738,3424
21.12.2017 19:00,4017,38.6,760,754,3257
21.12.2017 20:00,3606,30.06,757,752,2849
21.12.2017 21:00,3454,29.55,770,767,2684
21.12.2017 22:00,3336,29.17,775,745,2561
21.12.2017 23:00,3092,28.06,764,740,2328
22.12.2017 00:00,2871,27.32,743,728,2128
22.12.2017 01:00,2720,27.1,715,701,2005
22.12.2017 02:00,2626,26.45,697,692,1929
22.12.2017 03:00,2657,26.2,662,678,1995
22.12.2017 04:00,2696,26.36,647,662,2049
22.12.2017 05:00,2761,26.92,648,661,2113
22.12.2017 06:00,2887,27.54,675,663,2212
22.12.2017 07:00,3302,28.75,673,668,2629
22.12.2017 08:00,3641,30.06,672,672,2969
22.12.2017 09:00,3793,30.81,653,661,3140
22.12.2017 10:00,3771,30.69,655,672,3116
22.12.2017 11:00,3802,30.63,674,694,3128
22.12.2017 12:00,3720,30.3,662,680,3058
22.12.2017 13:00,3654,29.85,684,705,2970
22.12.2017 14:00,3562,29.65,730,731,2832
22.12.2017 15:00,3437,29.69,761,759,2676
22.12.2017 16:00,3445,29.87,770,769,2675
22.12.2017 17:00,3639,30.32,778,780,2861
22.12.2017 18:00,3717,30.79,780,766,2937
22.12.2017 19:00,3714,30.44,685,697,3029
22.12.2017 20:00,3525,29.81,619,634,2906
22.12.2017 21:00,3348,29.06,567,577,2781
22.12.2017 22:00,3139,28.86,538,526,2601
22.12.2017 23:00,2826,27.87,517,503,2309
23.12.2017 00:00,2609,26.97,502,511,2107
23.12.2017 01:00,2437,26.33,626,633,1811
23.12.2017 02:00,2216,22.47,747,745,1469
23.12.2017 03:00,2232,18.72,888,877,1344
23.12.2017 04:00,2315,11.95,1028,1026,1287
23.12.2017 05:00,2351,12.4,1122,1122,1229
23.12.2017 06:00,2373,8.81,1180,1185,1193
23.12.2017 07:00,2501,14.94,1230,1234,1271
23.12.2017 08:00,2661,13.39,1273,1277,1388
23.12.2017 09:00,2833,20.28,1309,1313,1524
23.12.2017 10:00,2970,18.79,1339,1343,1631
23.12.2017 11:00,3018,20.08,1358,1363,1660
23.12.2017 12:00,3024,17.92,1359,1363,1665
23.12.2017 13:00,3039,14.77,1390,1395,1649
23.12.2017 14:00,3021,13.32,1382,1386,1639
23.12.2017 15:00,2996,16.79,1395,1399,1601
23.12.2017 16:00,3057,21.56,1403,1407,1654
23.12.2017 17:00,3180,25.22,1405,1409,1775
23.12.2017 18:00,3212,24.96,1408,1412,1804
23.12.2017 19:00,3129,23.21,1406,1409,1723
23.12.2017 20:00,2948,21.18,1386,1390,1562
23.12.2017 21:00,2823,18.28,1397,1400,1426
23.12.2017 22:00,2717,14.11,1415,1418,1302
23.12.2017 23:00,2655,11.11,1417,1420,1238
24.12.2017 00:00,2525,4.12,1410,1412,1115
24.12.2017 01:00,2433,16.69,1417,1419,1016
24.12.2017 02:00,2323,16.65,1394,1396,929
24.12.2017 03:00,2343,16.64,1352,1354,991
24.12.2017 04:00,2390,16.66,1269,1272,1121
24.12.2017 05:00,2414,16.7,1193,1196,1221
24.12.2017 06:00,2398,18.86,1126,1129,1272
24.12.2017 07:00,2412,19.61,1073,1077,1339
24.12.2017 08:00,2502,24.87,1009,1019,1493
24.12.2017 09:00,2618,26.06,966,962,1652
24.12.2017 10:00,2660,26.71,934,922,1726
24.12.2017 11:00,2765,27.01,889,877,1876
24.12.2017 12:00,2828,26.97,816,836,2012
24.12.2017 13:00,2850,26.7,783,809,2067
24.12.2017 14:00,2908,26.7,748,781,2160
24.12.2017 15:00,2783,26.66,726,729,2057
24.12.2017 16:00,2717,26.93,733,730,1984
24.12.2017 17:00,2632,27.18,762,758,1870
24.12.2017 18:00,2572,26.94,797,800,1775
24.12.2017 19:00,2526,26.31,842,846,1684
24.12.2017 20:00,2486,25.95,876,879,1610
24.12.2017 21:00,2492,25.96,873,880,1619
24.12.2017 22:00,2456,26.36,863,871,1593
24.12.2017 23:00,2416,26.17,861,863,1555
25.12.2017 00:00,2375,25.99,836,834,1539
25.12.2017 01:00,2300,26.38,799,800,1501
25.12.2017 02:00,2259,26.06,760,768,1499
25.12.2017 03:00,2246,25.26,725,735,1521
25.12.2017 04:00,2289,25.03,671,709,1618
25.12.2017 05:00,2379,24.4,696,707,1683
25.12.2017 06:00,2404,25.2,714,708,1690
25.12.2017 07:00,2435,26.16,782,786,1653
25.12.2017 08:00,2488,26.28,870,867,1618
25.12.2017 09:00,2597,26.07,964,964,1633
25.12.2017 10:00,2662,25.98,1029,1032,1633
25.12.2017 11:00,2736,26.11,1098,1103,1638
25.12.2017 12:00,2795,26.18,1157,1163,1638
25.12.2017 13:00,2846,26.2,1209,1212,1637
25.12.2017 14:00,2808,26.12,1239,1242,1569
25.12.2017 15:00,2797,26.16,1261,1263,1536
25.12.2017 16:00,2875,26.53,1272,1274,1603
25.12.2017 17:00,2921,26.78,1268,1270,1653
25.12.2017 18:00,2940,26.74,1266,1266,1674
25.12.2017 19:00,2904,27.12,1247,1248,1657
25.12.2017 20:00,2824,26.96,1239,1238,1585
25.12.2017 21:00,2742,26.27,1229,1227,1513
25.12.2017 22:00,2615,26.14,1180,1193,1435
25.12.2017 23:00,2528,25.98,1132,1166,1396
26.12.2017 00:00,2416,25.1,1109,1140,1307
26.12.2017 01:00,2295,25.47,1103,1080,1192
26.12.2017 02:00,2242,23.74,1065,1043,1177
26.12.2017 03:00,2232,23.2,1006,1000,1226
26.12.2017 04:00,2268,23.26,966,977,1302
26.12.2017 05:00,2297,25.02,949,940,1348
26.12.2017 06:00,2345,25.76,920,911,1425
26.12.2017 07:00,2463,25.89,914,901,1549
26.12.2017 08:00,2588,26.05,894,886,1694
26.12.2017 09:00,2728,26.18,903,897,1825
26.12.2017 10:00,2748,26.6,924,922,1824
26.12.2017 11:00,2752,26.41,957,958,1795
26.12.2017 12:00,2896,26.68,1020,1024,1876
26.12.2017 13:00,3020,26.45,1080,1084,1940
26.12.2017 14:00,3064,26.27,1153,1157,1911
26.12.2017 15:00,3017,26.16,1215,1219,1802
26.12.2017 16:00,3095,26.57,1264,1268,1831
26.12.2017 17:00,3227,27.32,1285,1289,1942
26.12.2017 18:00,3217,27.17,1294,1298,1923
26.12.2017 19:00,3191,27.01,1293,1296,1898
26.12.2017 20:00,3142,26.44,1281,1284,1861
26.12.2017 21:00,3025,26.12,1256,1258,1769
26.12.2017 22:00,2882,26,1258,1258,1624
26.12.2017 23:00,2745,24.5,1256,1255,1489
27.12.2017 00:00,2645,16.78,1247,1246,1398
27.12.2017 01:00,2457,25.37,1154,1162,1303
27.12.2017 02:00,2398,15.09,1132,1131,1266
27.12.2017 03:00,2369,13.93,1080,1075,1289
27.12.2017 04:00,2376,13.81,1014,1011,1362
27.12.2017 05:00,2430,24.39,905,931,1525
27.12.2017 06:00,2566,25.74,829,833,1737
27.12.2017 07:00,2827,26.47,743,743,2084
27.12.2017 08:00,3115,28.21,668,660,2447
27.12.2017 09:00,3247,31.23,590,595,2657
27.12.2017 10:00,3303,34.07,529,539,2774
27.12.2017 11:00,3434,34.45,481,496,2953
27.12.2017 12:00,3495,31.53,419,444,3076
27.12.2017 13:00,3363,31.92,426,406,2937
27.12.2017 14:00,3341,32.54,389,374,2952
27.12.2017 15:00,3317,33.43,406,401,2911
27.12.2017 16:00,3403,38.46,453,458,2950
27.12.2017 17:00,3501,38.88,506,504,2995
27.12.2017 18:00,3471,41.77,528,535,2943
27.12.2017 19:00,3364,38.17,577,559,2787
27.12.2017 20:00,3256,35.44,576,561,2680
27.12.2017 21:00,3136,31.31,560,530,2576
27.12.2017 22:00,3106,30.37,500,510,2606
27.12.2017 23:00,2971,29.38,439,465,2532
28.12.2017 00:00,2777,28.22,400,420,2377
28.12.2017 01:00,2642,28.87,351,350,2291
28.12.2017 02:00,2558,28.12,300,295,2258
28.12.2017 03:00,2499,27.2,256,263,2243
28.12.2017 04:00,2458,26.43,223,225,2235
28.12.2017 05:00,2438,27.22,207,204,2231
28.12.2017 06:00,2584,28.89,183,179,2401
28.12.2017 07:00,2866,30.74,165,156,2701
28.12.2017 08:00,3157,35.11,151,142,3006
28.12.2017 09:00,3319,37.5,140,133,3179
28.12.2017 10:00,3360,38.97,130,127,3230
28.12.2017 11:00,3447,39.15,109,111,3338
28.12.2017 12:00,3470,39.01,101,98,3369
28.12.2017 13:00,3493,39.2,102,99,3391
28.12.2017 14:00,3506,38.3,100,91,3406
28.12.2017 15:00,3467,35.55,92,91,3375
28.12.2017 16:00,3508,39.07,84,84,3424
28.12.2017 17:00,3613,42.98,92,93,3521
28.12.2017 18:00,3587,41.98,115,108,3472
28.12.2017 19:00,3500,41.14,144,136,3356
28.12.2017 20:00,3386,34.09,173,162,3213
28.12.2017 21:00,3254,29.08,200,192,3054
28.12.2017 22:00,3034,28.3,214,215,2820
28.12.2017 23:00,2862,27.5,241,240,2621
29.12.2017 00:00,2738,26.87,263,274,2475
29.12.2017 01:00,2616,26.33,300,301,2316
29.12.2017 02:00,2523,25.63,336,336,2187
29.12.2017 03:00,2478,25.39,384,381,2094
29.12.2017 04:00,2467,25.45,445,439,2022
29.12.2017 05:00,2470,26.05,495,488,1975
29.12.2017 06:00,2549,26.83,551,537,1998
29.12.2017 07:00,2789,27.27,604,589,2185
29.12.2017 08:00,3114,27.9,604,611,2510
29.12.2017 09:00,3275,29.08,587,592,2688
29.12.2017 10:00,3285,30.03,587,572,2698
29.12.2017 11:00,3352,29.83,583,576,2769
29.12.2017 12:00,3359,29.47,572,572,2787
29.12.2017 13:00,3324,29.2,555,565,2769
29.12.2017 14:00,3372,29.45,536,534,2836
29.12.2017 15:00,3346,30.02,526,526,2820
29.12.2017 16:00,3362,31,502,493,2860
29.12.2017 17:00,3471,32.72,486,481,2985
29.12.2017 18:00,3550,34.11,476,469,3074
29.12.2017 19:00,3503,32.01,441,457,3062
29.12.2017 20:00,3408,29.81,406,430,3002
29.12.2017 21:00,3264,28.49,404,415,2860
29.12.2017 22:00,3120,27.73,391,386,2729
29.12.2017 23:00,2966,26.9,375,363,2591
30.12.2017 00:00,2796,26.68,366,355,2430
30.12.2017 01:00,2802,27.31,362,370,2440
30.12.2017 02:00,2760,26.86,351,368,2409
30.12.2017 03:00,2678,26.39,374,366,2304
30.12.2017 04:00,2679,26.06,408,384,2271
30.12.2017 05:00,2658,26.06,439,418,2219
30.12.2017 06:00,2645,26.37,486,468,2159
30.12.2017 07:00,2733,26.79,546,540,2187
30.12.2017 08:00,2779,26.71,607,597,2172
30.12.2017 09:00,2931,26.95,676,670,2255
30.12.2017 10:00,3088,27.36,733,729,2355
30.12.2017 11:00,3233,27.45,773,775,2460
30.12.2017 12:00,3326,27.44,796,798,2530
30.12.2017 13:00,3332,27.34,820,819,2512
30.12.2017 14:00,3348,27.31,822,820,2526
30.12.2017 15:00,3375,27.39,790,805,2585
30.12.2017 16:00,3481,27.59,779,801,2702
30.12.2017 17:00,3596,27.85,765,772,2831
30.12.2017 18:00,3576,27.94,755,751,2821
30.12.2017 19:00,3565,27.66,683,699,2882
30.12.2017 20:00,3592,27.35,719,726,2873
30.12.2017 21:00,3390,26.63,634,616,2756
30.12.2017 22:00,3295,26.31,570,563,2725
30.12.2017 23:00,3260,24.56,538,551,2722
31.12.2017 00:00,3112,24.44,475,492,2637
31.12.2017 01:00,2665,26.98,156,162,2509
31.12.2017 02:00,2587,26.44,126,122,2461
31.12.2017 03:00,2543,26.2,115,108,2428
31.12.2017 04:00,2524,25.9,106,105,2418
31.12.2017 05:00,2542,25.37,98,101,2444
31.12.2017 06:00,2552,25.59,89,95,2463
31.12.2017 07:00,2640,25.97,90,95,2550
31.12.2017 08:00,2735,26.01,102,101,2633
31.12.2017 09:00,2822,26.41,110,112,2712
31.12.2017 10:00,2927,27.01,112,119,2815
31.12.2017 11:00,3072,27.53,162,163,2910
31.12.2017 12:00,3069,27.57,232,205,2837
31.12.2017 13:00,3025,27.53,298,275,2727
31.12.2017 14:00,3057,27.44,400,391,2657
31.12.2017 15:00,3162,27.58,523,517,2639
31.12.2017 16:00,3282,27.87,646,642,2636
31.12.2017 17:00,3316,28.09,736,732,2580
31.12.2017 18:00,3250,27.95,789,789,2461
31.12.2017 19:00,3219,27.59,728,763,2491
31.12.2017 20:00,3148,26.84,697,730,2451
31.12.2017 21:00,2891,25.94,650,672,2241
31.12.2017 22:00,2758,25.34,603,606,2155
31.12.2017 23:00,2704,25.68,550,541,2154
01.01.2018 00:00,2567,25.65,518,510,2049
