CET_TimeStamp,Actual_Total_Load,Day_Ahead_Price,Wind_Onshore_Gen_Actual,Wind_Onshore_generation_forecast,Residual_load
01.01.2019 01:00,2386,28.32,1321,1320,1065
01.01.2019 02:00,2348,10.07,1348,1350,1000
01.01.2019 03:00,2339,10.03,1378,1378,961
01.01.2019 04:00,2285,4.56,1396,1396,889
01.01.2019 05:00,2263,4.83,1408,1408,855
01.01.2019 06:00,2301,8.09,1418,1419,883
01.01.2019 07:00,2399,25.54,1414,1415,985
01.01.2019 08:00,2510,39.16,1427,1428,1083
01.01.2019 09:00,2570,37.66,1427,1428,1143
01.01.2019 10:00,2647,21.52,1425,1426,1222
01.01.2019 11:00,2749,28.25,1409,1410,1340
01.01.2019 12:00,2834,19.29,1398,1406,1436
01.01.2019 13:00,2805,19.32,1352,1360,1453
01.01.2019 14:00,2824,16.21,1329,1336,1495
01.01.2019 15:00,2898,21.47,1321,1323,1577
01.01.2019 16:00,2982,32.69,1279,1281,1703
01.01.2019 17:00,3215,29.34,1250,1250,1965
01.01.2019 18:00,3260,30.19,1239,1243,2021
01.01.2019 19:00,3182,30.09,1241,1244,1941
01.01.2019 20:00,3068,29.58,1261,1258,1807
01.01.2019 21:00,2988,36.91,1307,1307,1681
01.01.2019 22:00,2901,33.14,1325,1326,1576
01.01.2019 23:00,2821,21.61,1339,1340,1482
01.02.2019 00:00,2686,4.04,1346,1347,1340
01.02.2019 01:00,2632,9.7,1356,1357,1276
01.02.2019 02:00,2582,6.32,1349,1359,1233
01.02.2019 03:00,2596,4.35,1348,1363,1248
01.02.2019 04:00,2622,8.81,1344,1357,1278
01.02.2019 05:00,2721,22.67,1337,1352,1384
01.02.2019 06:00,2921,43.28,1325,1334,1596
01.02.2019 07:00,3185,44.64,1302,1309,1883
01.02.2019 08:00,3529,49.64,1282,1287,2247
01.02.2019 09:00,3690,49.96,1269,1265,2421
01.02.2019 10:00,3763,50.74,1246,1243,2517
01.02.2019 11:00,3754,49.99,1228,1228,2526
01.02.2019 12:00,3670,50.25,1218,1219,2452
01.02.2019 13:00,3629,49.94,1202,1207,2427
01.02.2019 14:00,3626,49.97,1178,1182,2448
01.02.2019 15:00,3656,50.93,1155,1158,2501
01.02.2019 16:00,3788,52.38,1125,1127,2663
01.02.2019 17:00,3991,54.67,1091,1092,2900
01.02.2019 18:00,4059,55.58,1028,1027,3031
01.02.2019 19:00,3966,55.39,990,992,2976
01.02.2019 20:00,3834,54.9,937,940,2897
01.02.2019 21:00,3733,53.86,891,903,2842
01.02.2019 22:00,3557,52.71,813,828,2744
01.02.2019 23:00,3393,52.09,764,789,2629
01.03.2019 00:00,3147,50.76,729,766,2418
01.03.2019 01:00,3013,49.8,729,743,2284
01.03.2019 02:00,2827,48.89,730,725,2097
01.03.2019 03:00,2686,48.31,745,712,1941
01.03.2019 04:00,2665,48.4,728,698,1937
01.03.2019 05:00,2756,48.79,692,680,2064
01.03.2019 06:00,3007,49.61,642,643,2365
01.03.2019 07:00,3369,51.17,603,609,2766
01.03.2019 08:00,3684,53.91,570,561,3114
01.03.2019 09:00,3885,58.86,492,497,3393
01.03.2019 10:00,3889,59.14,433,442,3456
01.03.2019 11:00,3896,58.19,363,390,3533
01.03.2019 12:00,3891,61.47,292,319,3599
01.03.2019 13:00,3828,62,231,251,3597
01.03.2019 14:00,3816,63.12,183,196,3633
01.03.2019 15:00,3810,63.67,152,159,3658
01.03.2019 16:00,3913,66.13,137,142,3776
01.03.2019 17:00,4079,68.41,123,124,3956
01.03.2019 18:00,4030,69.55,115,116,3915
01.03.2019 19:00,3953,65.67,105,108,3848
01.03.2019 20:00,3833,61.51,99,101,3734
01.03.2019 21:00,3654,57.6,95,95,3559
01.03.2019 22:00,3435,54.44,122,122,3313
01.03.2019 23:00,3232,52.09,164,161,3068
01.04.2019 00:00,2981,49.98,212,213,2769
01.04.2019 01:00,2908,49.87,316,302,2592
01.04.2019 02:00,2757,47.97,345,340,2412
01.04.2019 03:00,2729,47.07,364,362,2365
01.04.2019 04:00,2735,47.05,380,379,2355
01.04.2019 05:00,2773,47.43,403,386,2370
01.04.2019 06:00,2902,48.58,398,390,2504
01.04.2019 07:00,3199,50.87,402,398,2797
01.04.2019 08:00,3552,53.99,395,396,3157
01.04.2019 09:00,3771,54.44,389,391,3382
01.04.2019 10:00,3734,54.18,389,388,3345
01.04.2019 11:00,3819,53.9,407,393,3412
01.04.2019 12:00,3774,53.01,422,403,3352
01.04.2019 13:00,3663,51.74,438,428,3225
01.04.2019 14:00,3611,51.6,470,455,3141
01.04.2019 15:00,3498,51.41,495,485,3003
01.04.2019 16:00,3420,51.69,555,527,2865
01.04.2019 17:00,3523,52.59,583,569,2940
01.04.2019 18:00,3590,53.34,617,591,2973
01.04.2019 19:00,3490,52.81,594,599,2896
01.04.2019 20:00,3266,51.79,573,585,2693
01.04.2019 21:00,3130,51.04,580,568,2550
01.04.2019 22:00,2971,50.45,526,548,2445
01.04.2019 23:00,2827,49.79,512,516,2315
01.05.2019 00:00,2720,49.02,490,487,2230
01.05.2019 01:00,2629,48.42,465,469,2164
01.05.2019 02:00,2567,47.52,469,467,2098
01.05.2019 03:00,2545,47.19,459,479,2086
01.05.2019 04:00,2508,47,459,490,2049
01.05.2019 05:00,2535,47.01,467,497,2068
01.05.2019 06:00,2564,47.33,450,498,2114
01.05.2019 07:00,2668,47.59,436,490,2232
01.05.2019 08:00,2763,48.22,418,467,2345
01.05.2019 09:00,2936,49.99,423,440,2513
01.05.2019 10:00,3002,50.73,406,408,2596
01.05.2019 11:00,3112,50.93,379,358,2733
01.05.2019 12:00,3192,51.02,307,310,2885
01.05.2019 13:00,3130,51.36,274,269,2856
01.05.2019 14:00,3087,51.74,247,243,2840
01.05.2019 15:00,3054,51.92,246,224,2808
01.05.2019 16:00,3186,53.22,234,214,2952
01.05.2019 17:00,3342,55.26,240,213,3102
01.05.2019 18:00,3393,55.87,234,210,3159
01.05.2019 19:00,3361,60.16,227,202,3134
01.05.2019 20:00,3300,58.01,209,181,3091
01.05.2019 21:00,3181,52.75,179,157,3002
01.05.2019 22:00,3066,51.9,158,134,2908
01.05.2019 23:00,2963,51.13,137,110,2826
01.06.2019 00:00,2891,50.21,106,90,2785
01.06.2019 01:00,2854,50.29,100,92,2754
01.06.2019 02:00,2797,49.03,80,69,2717
01.06.2019 03:00,2774,48.81,58,54,2716
01.06.2019 04:00,2774,48.66,45,43,2729
01.06.2019 05:00,2785,47.82,40,40,2745
01.06.2019 06:00,2837,48.72,38,40,2799
01.06.2019 07:00,2944,49.38,41,45,2903
01.06.2019 08:00,3026,49.65,44,46,2982
01.06.2019 09:00,3090,50.44,44,45,3046
01.06.2019 10:00,3259,51.68,49,49,3210
01.06.2019 11:00,3352,52.35,51,44,3301
01.06.2019 12:00,3395,52.77,49,40,3346
01.06.2019 13:00,3368,52.86,48,39,3320
01.06.2019 14:00,3294,52.44,54,41,3240
01.06.2019 15:00,3255,51.52,58,48,3197
01.06.2019 16:00,3275,51.57,70,57,3205
01.06.2019 17:00,3502,53.4,84,67,3418
01.06.2019 18:00,3564,61.91,99,76,3465
01.06.2019 19:00,3518,61.36,113,87,3405
01.06.2019 20:00,3388,58.57,130,94,3258
01.06.2019 21:00,3287,51.95,128,99,3159
01.06.2019 22:00,3149,51.57,134,100,3015
01.06.2019 23:00,2983,50.71,141,108,2842
01.07.2019 00:00,2864,49.94,147,123,2717
01.07.2019 01:00,2806,48.62,184,169,2622
01.07.2019 02:00,2734,47.98,179,168,2555
01.07.2019 03:00,2693,47.84,170,166,2523
01.07.2019 04:00,2716,46.96,170,165,2546
01.07.2019 05:00,2748,48.09,163,160,2585
01.07.2019 06:00,2904,49.87,154,153,2750
01.07.2019 07:00,3372,53.51,152,146,3220
01.07.2019 08:00,3754,66.97,133,139,3621
01.07.2019 09:00,3841,72.85,127,133,3714
01.07.2019 10:00,3829,73.13,124,133,3705
01.07.2019 11:00,3903,72.32,133,152,3770
01.07.2019 12:00,3931,69.52,155,187,3776
01.07.2019 13:00,3908,67.13,198,236,3710
01.07.2019 14:00,3861,65.15,234,282,3627
01.07.2019 15:00,3822,60.98,297,337,3525
01.07.2019 16:00,3919,53.25,368,401,3551
01.07.2019 17:00,3967,53.26,437,487,3530
01.07.2019 18:00,3958,53,527,592,3431
01.07.2019 19:00,3791,51.32,662,695,3129
01.07.2019 20:00,3637,50.89,807,811,2830
01.07.2019 21:00,3431,50.6,948,941,2483
01.07.2019 22:00,3284,50.03,1055,1052,2229
01.07.2019 23:00,3092,49.11,1093,1078,1999
01.08.2019 00:00,2878,46.75,1074,1039,1804
01.08.2019 01:00,2678,46.94,999,972,1679
01.08.2019 02:00,2662,46.34,915,909,1747
01.08.2019 03:00,2657,46.24,848,851,1809
01.08.2019 04:00,2605,46.28,779,794,1826
01.08.2019 05:00,2648,46.7,680,678,1968
01.08.2019 06:00,2817,47.86,540,537,2277
01.08.2019 07:00,3217,50.08,429,404,2788
01.08.2019 08:00,3684,51.31,295,279,3389
01.08.2019 09:00,3770,51.7,187,179,3583
01.08.2019 10:00,3709,51.48,95,123,3614
01.08.2019 11:00,3755,51.48,92,142,3663
01.08.2019 12:00,3732,51.21,165,214,3567
01.08.2019 13:00,3702,50.88,297,311,3405
01.08.2019 14:00,3709,50.63,337,409,3372
01.08.2019 15:00,3770,50.7,474,505,3296
01.08.2019 16:00,3810,50.69,550,600,3260
01.08.2019 17:00,3894,51.15,660,708,3234
01.08.2019 18:00,3939,51.05,774,829,3165
01.08.2019 19:00,3886,50.62,893,943,2993
01.08.2019 20:00,3766,49.98,984,1031,2782
01.08.2019 21:00,3633,49.71,1070,1099,2563
01.08.2019 22:00,3506,49.49,1127,1153,2379
01.08.2019 23:00,3313,49.03,1160,1186,2153
01.09.2019 00:00,3143,46.45,1194,1207,1949
01.09.2019 01:00,3004,45.75,1203,1189,1801
01.09.2019 02:00,2917,44.41,1222,1212,1695
01.09.2019 03:00,2913,43.87,1238,1231,1675
01.09.2019 04:00,2933,43.93,1253,1248,1680
01.09.2019 05:00,2981,45.55,1262,1259,1719
01.09.2019 06:00,3190,48.03,1267,1264,1923
01.09.2019 07:00,3606,49.46,1266,1267,2340
01.09.2019 08:00,3958,50.74,1253,1256,2705
01.09.2019 09:00,4100,50.98,1247,1236,2853
01.09.2019 10:00,4051,50.94,1215,1221,2836
01.09.2019 11:00,4046,51.02,1165,1197,2881
01.09.2019 12:00,4095,50.96,1153,1166,2942
01.09.2019 13:00,4092,50.76,1121,1132,2971
01.09.2019 14:00,4036,50.69,1069,1099,2967
01.09.2019 15:00,4074,50.88,1036,1070,3038
01.09.2019 16:00,4134,51.42,1001,1032,3133
01.09.2019 17:00,4229,53.69,955,989,3274
01.09.2019 18:00,4312,54.59,924,946,3388
01.09.2019 19:00,4219,54.19,872,905,3347
01.09.2019 20:00,4108,54.19,818,851,3290
01.09.2019 21:00,4004,52.98,731,787,3273
01.09.2019 22:00,3881,51.68,669,728,3212
01.09.2019 23:00,3694,50.96,626,675,3068
01.10.2019 00:00,3467,49.96,571,626,2896
01.10.2019 01:00,3262,50.51,438,473,2824
01.10.2019 02:00,3170,49.98,402,426,2768
01.10.2019 03:00,3129,49.55,366,382,2763
01.10.2019 04:00,3144,49.98,325,341,2819
01.10.2019 05:00,3223,49.94,291,300,2932
01.10.2019 06:00,3400,51.9,249,255,3151
01.10.2019 07:00,3872,56.61,214,214,3658
01.10.2019 08:00,4224,70.86,169,173,4055
01.10.2019 09:00,4288,79.23,131,133,4157
01.10.2019 10:00,4274,79.17,101,101,4173
01.10.2019 11:00,4291,78.55,91,71,4200
01.10.2019 12:00,4241,77.92,67,46,4174
01.10.2019 13:00,4091,74.56,23,31,4068
01.10.2019 14:00,4065,73.2,23,28,4042
01.10.2019 15:00,4093,74.24,34,41,4059
01.10.2019 16:00,4159,73.59,65,70,4094
01.10.2019 17:00,4226,74.94,118,113,4108
01.10.2019 18:00,4247,81.45,172,170,4075
01.10.2019 19:00,4135,77.82,246,243,3889
01.10.2019 20:00,4030,74.38,315,318,3715
01.10.2019 21:00,3881,52.78,396,391,3485
01.10.2019 22:00,3652,52.01,474,466,3178
01.10.2019 23:00,3391,49.99,562,542,2829
01.11.2019 00:00,3209,48.11,646,621,2563
01.11.2019 01:00,3033,47.84,695,680,2338
01.11.2019 02:00,2944,46.58,754,721,2190
01.11.2019 03:00,2911,45.74,769,750,2142
01.11.2019 04:00,2972,43.81,786,770,2186
01.11.2019 05:00,3060,46.24,776,766,2284
01.11.2019 06:00,3268,47.69,727,744,2541
01.11.2019 07:00,3645,50.06,684,720,2961
01.11.2019 08:00,3957,53.03,658,687,3299
01.11.2019 09:00,3961,54.25,595,650,3366
01.11.2019 10:00,3913,53.69,569,616,3344
01.11.2019 11:00,3958,53.63,549,585,3409
01.11.2019 12:00,3928,53.32,525,569,3403
01.11.2019 13:00,3794,51.89,506,563,3288
01.11.2019 14:00,3635,50.8,528,544,3107
01.11.2019 15:00,3570,49.26,535,521,3035
01.11.2019 16:00,3594,49.07,548,515,3046
01.11.2019 17:00,3682,49.54,526,518,3156
01.11.2019 18:00,3814,51.51,511,525,3303
01.11.2019 19:00,3742,50.44,510,536,3232
01.11.2019 20:00,3624,49.64,525,543,3099
01.11.2019 21:00,3469,48.93,517,545,2952
01.11.2019 22:00,3327,48.34,500,542,2827
01.11.2019 23:00,3153,47.54,486,534,2667
01.12.2019 00:00,2954,45.03,485,519,2469
01.12.2019 01:00,2840,47.24,429,427,2411
01.12.2019 02:00,2850,45.88,389,389,2461
01.12.2019 03:00,2903,44.61,357,350,2546
01.12.2019 04:00,2885,42.9,325,312,2560
01.12.2019 05:00,2830,42.03,307,290,2523
01.12.2019 06:00,2895,42,300,293,2595
01.12.2019 07:00,2990,44.06,332,316,2658
01.12.2019 08:00,3200,46.39,317,324,2883
01.12.2019 09:00,3345,48.02,326,317,3019
01.12.2019 10:00,3410,49.91,306,298,3104
01.12.2019 11:00,3363,50.3,289,281,3074
01.12.2019 12:00,3336,50.32,304,277,3032
01.12.2019 13:00,3341,50.32,303,282,3038
01.12.2019 14:00,3314,49.95,298,281,3016
01.12.2019 15:00,3279,50.09,276,273,3003
01.12.2019 16:00,3365,50.82,239,268,3126
01.12.2019 17:00,3509,51.7,253,261,3256
01.12.2019 18:00,3562,52.96,242,263,3320
01.12.2019 19:00,3467,52.33,259,270,3208
01.12.2019 20:00,3329,51.23,251,270,3078
01.12.2019 21:00,3187,50.02,245,262,2942
01.12.2019 22:00,3125,49.23,237,260,2888
01.12.2019 23:00,3028,48.29,217,259,2811
13.01.2019 00:00,2936,47.22,209,259,2727
13.01.2019 01:00,2760,49.02,181,196,2579
13.01.2019 02:00,2683,48.18,172,193,2511
13.01.2019 03:00,2619,48.06,170,184,2449
13.01.2019 04:00,2604,48.03,166,177,2438
13.01.2019 05:00,2539,47.5,179,187,2360
13.01.2019 06:00,2606,47.33,176,209,2430
13.01.2019 07:00,2729,47.42,232,258,2497
13.01.2019 08:00,2772,47.53,349,333,2423
13.01.2019 09:00,2778,48,428,414,2350
13.01.2019 10:00,2892,48.78,480,484,2412
13.01.2019 11:00,3101,49.47,528,541,2573
13.01.2019 12:00,3134,49.85,610,583,2524
13.01.2019 13:00,2991,49.87,664,634,2327
13.01.2019 14:00,2960,49.36,720,687,2240
13.01.2019 15:00,3026,48.73,786,755,2240
13.01.2019 16:00,3140,49.21,822,825,2318
13.01.2019 17:00,3324,50.17,815,826,2509
13.01.2019 18:00,3379,50.29,778,783,2601
13.01.2019 19:00,3380,49.57,741,735,2639
13.01.2019 20:00,3325,48.63,713,735,2612
13.01.2019 21:00,3217,47.3,770,792,2447
13.01.2019 22:00,3062,45.81,840,881,2222
13.01.2019 23:00,2843,43.56,934,977,1909
14.01.2019 00:00,2718,39.23,1040,1060,1678
14.01.2019 01:00,2757,27.75,1132,1147,1625
14.01.2019 02:00,2885,20.7,1133,1165,1752
14.01.2019 03:00,2914,16.54,1117,1152,1797
14.01.2019 04:00,2972,22.75,1093,1134,1879
14.01.2019 05:00,3101,35.45,1063,1122,2038
14.01.2019 06:00,3336,44.66,1054,1124,2282
14.01.2019 07:00,3734,48.07,1095,1131,2639
14.01.2019 08:00,4208,51.22,1082,1130,3126
14.01.2019 09:00,4262,51.66,1098,1135,3164
14.01.2019 10:00,4279,50.68,1113,1152,3166
14.01.2019 11:00,4324,50.6,1109,1178,3215
14.01.2019 12:00,4274,50.27,1139,1189,3135
14.01.2019 13:00,4058,49.89,1141,1191,2917
14.01.2019 14:00,3888,49.92,1175,1188,2713
14.01.2019 15:00,3843,50.04,1204,1185,2639
14.01.2019 16:00,3923,50.18,1239,1177,2684
14.01.2019 17:00,3996,50.93,1242,1179,2754
14.01.2019 18:00,4126,51.25,1234,1180,2892
14.01.2019 19:00,4032,50.93,1216,1183,2816
14.01.2019 20:00,3983,50.52,1203,1172,2780
14.01.2019 21:00,3829,49.61,1183,1155,2646
14.01.2019 22:00,3586,46,1167,1137,2419
14.01.2019 23:00,3379,44.4,1147,1120,2232
15.01.2019 00:00,3218,39.55,1133,1099,2085
15.01.2019 01:00,3116,37.67,1108,1100,2008
15.01.2019 02:00,3088,36.7,1075,1059,2013
15.01.2019 03:00,3071,37.06,1032,1008,2039
15.01.2019 04:00,3096,40.64,957,945,2139
15.01.2019 05:00,3143,44.31,904,887,2239
15.01.2019 06:00,3315,48.46,843,823,2472
15.01.2019 07:00,3848,50.91,720,755,3128
15.01.2019 08:00,4233,53.73,647,679,3586
15.01.2019 09:00,4303,57.02,576,606,3727
15.01.2019 10:00,4227,58.38,481,535,3746
15.01.2019 11:00,4283,56.54,380,456,3903
15.01.2019 12:00,4254,55,298,378,3956
15.01.2019 13:00,4155,53.92,237,313,3918
15.01.2019 14:00,4066,53.31,252,272,3814
15.01.2019 15:00,3921,52.63,326,264,3595
15.01.2019 16:00,3697,52.63,485,289,3212
15.01.2019 17:00,3760,53.91,602,357,3158
15.01.2019 18:00,3873,54.5,676,448,3197
15.01.2019 19:00,1936,54.27,705,556,1231
15.01.2019 20:00,1310,53.32,747,610,563
15.01.2019 21:00,1257,52.5,723,606,534
15.01.2019 22:00,1220,51.65,702,591,518
15.01.2019 23:00,1163,50.4,670,570,493
16.01.2019 00:00,1110,48.66,631,545,479
16.01.2019 01:00,2943,49.48,586,587,2357
16.01.2019 02:00,2903,49.01,520,507,2383
16.01.2019 03:00,2804,48.91,429,411,2375
16.01.2019 04:00,2832,49.06,310,316,2522
16.01.2019 05:00,2896,49.12,219,257,2677
16.01.2019 06:00,3128,51.06,179,226,2949
16.01.2019 07:00,3494,52.82,205,231,3289
16.01.2019 08:00,3887,56.67,281,285,3606
16.01.2019 09:00,3935,59.41,400,384,3535
16.01.2019 10:00,3777,56.37,539,508,3238
16.01.2019 11:00,3706,55.56,613,612,3093
16.01.2019 12:00,3713,54.92,714,688,2999
16.01.2019 13:00,3601,54.15,797,762,2804
16.01.2019 14:00,3586,53.16,880,834,2706
16.01.2019 15:00,3592,53.55,936,909,2656
16.01.2019 16:00,3666,53.72,993,985,2673
16.01.2019 17:00,3750,54.83,1077,1053,2673
16.01.2019 18:00,3794,54.01,1132,1106,2662
16.01.2019 19:00,3661,52.67,1185,1154,2476
16.01.2019 20:00,3563,52.16,1221,1200,2342
16.01.2019 21:00,3393,51.35,1258,1236,2135
16.01.2019 22:00,3215,50.09,1283,1265,1932
16.01.2019 23:00,2981,46.4,1299,1285,1682
17.01.2019 00:00,2819,43.21,1314,1290,1505
17.01.2019 01:00,2733,46.22,1317,1309,1416
17.01.2019 02:00,2669,44.05,1298,1285,1371
17.01.2019 03:00,2685,43.9,1231,1241,1454
17.01.2019 04:00,2758,44.07,1182,1198,1576
17.01.2019 05:00,2798,48.25,1154,1164,1644
17.01.2019 06:00,2922,50.3,1129,1130,1793
17.01.2019 07:00,3362,52.74,1070,1091,2292
17.01.2019 08:00,3790,53.94,995,1020,2795
17.01.2019 09:00,3939,54.42,914,929,3025
17.01.2019 10:00,3940,54.74,811,832,3129
17.01.2019 11:00,3995,54.8,671,732,3324
17.01.2019 12:00,4010,54.62,606,623,3404
17.01.2019 13:00,3962,54.43,514,518,3448
17.01.2019 14:00,3950,54.47,421,427,3529
17.01.2019 15:00,3938,55,374,346,3564
17.01.2019 16:00,4032,55.9,334,285,3698
17.01.2019 17:00,4121,57.43,301,255,3820
17.01.2019 18:00,4108,58.72,371,249,3737
17.01.2019 19:00,4015,55.06,407,263,3608
17.01.2019 20:00,3936,53.85,431,285,3505
17.01.2019 21:00,3776,53.05,447,324,3329
17.01.2019 22:00,3638,52.75,474,369,3164
17.01.2019 23:00,3463,51.19,474,400,2989
18.01.2019 00:00,3298,50.03,481,421,2817
18.01.2019 01:00,3278,51.16,471,454,2807
18.01.2019 02:00,3191,50.47,432,434,2759
18.01.2019 03:00,3100,50.12,408,423,2692
18.01.2019 04:00,3123,50.15,394,417,2729
18.01.2019 05:00,3134,50.65,387,406,2747
18.01.2019 06:00,3278,53.03,386,390,2892
18.01.2019 07:00,3748,55.94,389,376,3359
18.01.2019 08:00,4165,71.33,402,365,3763
18.01.2019 09:00,4261,75.02,407,355,3854
18.01.2019 10:00,4261,74.07,381,340,3880
18.01.2019 11:00,4247,70.51,360,307,3887
18.01.2019 12:00,4179,69.02,345,266,3834
18.01.2019 13:00,4022,67.29,299,241,3723
18.01.2019 14:00,3921,63.71,301,247,3620
18.01.2019 15:00,3868,65.83,335,280,3533
18.01.2019 16:00,3861,66.5,403,338,3458
18.01.2019 17:00,3948,67.34,435,390,3513
18.01.2019 18:00,4050,73.24,462,420,3588
18.01.2019 19:00,3970,73.7,476,445,3494
18.01.2019 20:00,3824,60.48,523,452,3301
18.01.2019 21:00,3643,57.96,510,445,3133
18.01.2019 22:00,3480,56.33,509,432,2971
18.01.2019 23:00,3322,55.34,449,404,2873
19.01.2019 00:00,3174,53.16,408,377,2766
19.01.2019 01:00,3066,53.76,353,351,2713
19.01.2019 02:00,3012,53.18,333,331,2679
19.01.2019 03:00,3048,53.41,321,322,2727
19.01.2019 04:00,2987,52.46,323,320,2664
19.01.2019 05:00,3019,52.25,339,320,2680
19.01.2019 06:00,3025,51.99,341,319,2684
19.01.2019 07:00,3021,51.72,342,321,2679
19.01.2019 08:00,3179,52.75,342,325,2837
19.01.2019 09:00,3366,54.65,346,330,3020
19.01.2019 10:00,3534,56.62,347,330,3187
19.01.2019 11:00,3627,60.12,333,324,3294
19.01.2019 12:00,3530,57.04,333,326,3197
19.01.2019 13:00,3408,55.26,354,345,3054
19.01.2019 14:00,3351,54.38,377,372,2974
19.01.2019 15:00,3278,53.84,407,402,2871
19.01.2019 16:00,3366,55.41,452,443,2914
19.01.2019 17:00,3665,61.42,490,478,3175
19.01.2019 18:00,3737,64.74,506,490,3231
19.01.2019 19:00,3689,62.72,508,496,3181
19.01.2019 20:00,3526,57.04,498,490,3028
19.01.2019 21:00,3397,54.61,476,478,2921
19.01.2019 22:00,3253,53.6,457,464,2796
19.01.2019 23:00,3079,52.8,436,443,2643
20.01.2019 00:00,2956,50.75,404,415,2552
20.01.2019 01:00,2906,51,191,188,2715
20.01.2019 02:00,2825,49.73,183,176,2642
20.01.2019 03:00,2793,50,173,169,2620
20.01.2019 04:00,2810,50.11,172,157,2638
20.01.2019 05:00,2852,50.85,157,141,2695
20.01.2019 06:00,2895,51.11,147,126,2748
20.01.2019 07:00,3000,50.99,130,117,2870
20.01.2019 08:00,3138,51.83,115,103,3023
20.01.2019 09:00,3234,52.14,104,93,3130
20.01.2019 10:00,3349,53.68,91,86,3258
20.01.2019 11:00,3415,54.48,75,81,3340
20.01.2019 12:00,3471,54.7,69,74,3402
20.01.2019 13:00,3478,54.17,75,69,3403
20.01.2019 14:00,3443,53.71,57,68,3386
20.01.2019 15:00,3408,54.04,54,69,3354
20.01.2019 16:00,3478,55.39,58,72,3420
20.01.2019 17:00,3665,58.02,79,51,3586
20.01.2019 18:00,3789,65.08,72,53,3717
20.01.2019 19:00,3756,67.77,65,50,3691
20.01.2019 20:00,3658,63.62,61,21,3597
20.01.2019 21:00,3540,59.82,59,21,3481
20.01.2019 22:00,3343,57.37,65,22,3278
20.01.2019 23:00,3172,57.01,66,24,3106
21.01.2019 00:00,2994,54.62,75,27,2919
21.01.2019 01:00,2970,54.94,118,19,2852
21.01.2019 02:00,2898,53.1,148,22,2750
21.01.2019 03:00,2884,52.1,171,26,2713
21.01.2019 04:00,2977,51.83,212,30,2765
21.01.2019 05:00,3066,52.71,251,30,2815
21.01.2019 06:00,3269,55.05,280,34,2989
21.01.2019 07:00,3778,65.33,314,35,3464
21.01.2019 08:00,4176,77.71,353,38,3823
21.01.2019 09:00,4195,85.95,385,41,3810
21.01.2019 10:00,4146,83.95,389,44,3757
21.01.2019 11:00,4212,78.25,372,44,3840
21.01.2019 12:00,4226,75,358,43,3868
21.01.2019 13:00,4202,70.65,340,42,3862
21.01.2019 14:00,4236,71.56,283,41,3953
21.01.2019 15:00,4234,70.31,247,41,3987
21.01.2019 16:00,4203,74.65,225,41,3978
21.01.2019 17:00,4204,81.08,219,40,3985
21.01.2019 18:00,4281,88.35,157,40,4124
21.01.2019 19:00,4160,88.37,106,43,4054
21.01.2019 20:00,4046,78.01,88,42,3958
21.01.2019 21:00,3879,68.8,74,41,3805
21.01.2019 22:00,3690,61.6,88,40,3602
21.01.2019 23:00,3463,57.94,69,39,3394
22.01.2019 00:00,3213,54.93,53,39,3160
22.01.2019 01:00,3013,54.64,41,75,2972
22.01.2019 02:00,2944,54.05,43,71,2901
22.01.2019 03:00,2907,53.52,40,64,2867
22.01.2019 04:00,2898,52.48,42,58,2856
22.01.2019 05:00,2957,53.44,39,53,2918
22.01.2019 06:00,3185,55.17,39,51,3146
22.01.2019 07:00,3619,62.33,49,53,3570
22.01.2019 08:00,3992,73.91,57,54,3935
22.01.2019 09:00,4024,80.23,58,53,3966
22.01.2019 10:00,3983,76.6,63,56,3920
22.01.2019 11:00,4014,74.19,72,62,3942
22.01.2019 12:00,3996,70.06,85,69,3911
22.01.2019 13:00,3962,62.07,79,76,3883
22.01.2019 14:00,3960,58.85,82,84,3878
22.01.2019 15:00,3963,59.69,87,92,3876
22.01.2019 16:00,3974,65.09,97,102,3877
22.01.2019 17:00,4026,70.21,115,122,3911
22.01.2019 18:00,4119,78.8,148,149,3971
22.01.2019 19:00,4029,74.13,180,188,3849
22.01.2019 20:00,3917,60.1,211,230,3706
22.01.2019 21:00,3745,56.94,231,268,3514
22.01.2019 22:00,3592,55.38,242,305,3350
22.01.2019 23:00,3412,55.23,285,326,3127
23.01.2019 00:00,3157,53.3,293,334,2864
23.01.2019 01:00,3051,53.2,296,300,2755
23.01.2019 02:00,3001,52.62,296,310,2705
23.01.2019 03:00,2966,52.14,299,318,2667
23.01.2019 04:00,2952,51.19,301,321,2651
23.01.2019 05:00,2969,52.07,326,322,2643
23.01.2019 06:00,3185,55.68,349,323,2836
23.01.2019 07:00,3655,62.43,342,327,3313
23.01.2019 08:00,4068,79.48,337,326,3731
23.01.2019 09:00,4155,88.38,348,320,3807
23.01.2019 10:00,4186,84.1,321,309,3865
23.01.2019 11:00,4174,85.35,293,289,3881
23.01.2019 12:00,4108,85.96,262,264,3846
23.01.2019 13:00,4023,77.65,234,238,3789
23.01.2019 14:00,3969,76.4,209,217,3760
23.01.2019 15:00,3953,83.53,194,203,3759
23.01.2019 16:00,3991,82.83,200,202,3791
23.01.2019 17:00,4106,82.92,226,219,3880
23.01.2019 18:00,4230,87.85,249,246,3981
23.01.2019 19:00,4082,85.03,273,277,3809
23.01.2019 20:00,4009,62.25,292,296,3717
23.01.2019 21:00,3873,58.06,338,305,3535
23.01.2019 22:00,3714,57.55,347,305,3367
23.01.2019 23:00,3475,56.83,338,292,3137
24.01.2019 00:00,3269,54.96,317,269,2952
24.01.2019 01:00,3075,55.98,284,223,2791
24.01.2019 02:00,3058,55.8,248,198,2810
24.01.2019 03:00,3064,55.57,214,171,2850
24.01.2019 04:00,3072,55.33,194,148,2878
24.01.2019 05:00,3136,55.8,181,138,2955
24.01.2019 06:00,3381,60.05,177,137,3204
24.01.2019 07:00,3812,75.98,175,142,3637
24.01.2019 08:00,4259,96.7,180,155,4079
24.01.2019 09:00,4261,109.45,200,170,4061
24.01.2019 10:00,4285,108.56,214,188,4071
24.01.2019 11:00,4301,102.76,251,203,4050
24.01.2019 12:00,4283,101.2,250,220,4033
24.01.2019 13:00,4184,95.97,252,234,3932
24.01.2019 14:00,4133,90.41,233,232,3900
24.01.2019 15:00,4151,87.7,211,219,3940
24.01.2019 16:00,4167,88.28,185,206,3982
24.01.2019 17:00,4237,95.01,183,201,4054
24.01.2019 18:00,4290,106.82,194,203,4096
24.01.2019 19:00,4130,100.29,205,209,3925
24.01.2019 20:00,4084,73.38,203,208,3881
24.01.2019 21:00,3931,60.35,212,199,3719
24.01.2019 22:00,3732,59.75,229,188,3503
24.01.2019 23:00,3507,58.45,200,173,3307
25.01.2019 00:00,3293,57.19,163,154,3130
25.01.2019 01:00,3210,57.32,140,125,3070
25.01.2019 02:00,3194,56.47,116,105,3078
25.01.2019 03:00,3166,55.95,104,93,3062
25.01.2019 04:00,3203,55.44,99,84,3104
25.01.2019 05:00,3288,55.28,85,77,3203
25.01.2019 06:00,3494,58.98,75,71,3419
25.01.2019 07:00,3909,69.39,67,67,3842
25.01.2019 08:00,4225,84.48,66,62,4159
25.01.2019 09:00,4370,94.67,58,59,4312
25.01.2019 10:00,4406,91.4,51,57,4355
25.01.2019 11:00,4449,82.96,42,53,4407
25.01.2019 12:00,4443,78,36,49,4407
25.01.2019 13:00,4387,71.81,28,46,4359
25.01.2019 14:00,4361,69.87,33,44,4328
25.01.2019 15:00,4285,68.64,24,42,4261
25.01.2019 16:00,4243,65.58,25,44,4218
25.01.2019 17:00,4297,65.08,30,51,4267
25.01.2019 18:00,4365,70.87,37,65,4328
25.01.2019 19:00,4275,71.74,54,86,4221
25.01.2019 20:00,4114,57.28,77,104,4037
25.01.2019 21:00,3920,55.43,90,127,3830
25.01.2019 22:00,3742,54.36,111,152,3631
25.01.2019 23:00,3571,53.59,116,170,3455
26.01.2019 00:00,3386,52.35,130,186,3256
26.01.2019 01:00,3210,51.91,102,113,3108
26.01.2019 02:00,3151,51.52,109,121,3042
26.01.2019 03:00,3081,50.98,127,126,2954
26.01.2019 04:00,3084,50.85,128,128,2956
26.01.2019 05:00,3106,51.52,121,119,2985
26.01.2019 06:00,3178,52.01,115,107,3063
26.01.2019 07:00,3310,52.44,111,101,3199
26.01.2019 08:00,3411,53.35,117,102,3294
26.01.2019 09:00,3557,53.99,126,104,3431
26.01.2019 10:00,3726,56.28,135,109,3591
26.01.2019 11:00,3873,58.62,143,106,3730
26.01.2019 12:00,3911,59.18,133,104,3778
26.01.2019 13:00,3884,56.72,129,103,3755
26.01.2019 14:00,3804,56.16,129,105,3675
26.01.2019 15:00,3738,54.61,143,108,3595
26.01.2019 16:00,3702,54.1,155,118,3547
26.01.2019 17:00,3821,55.17,178,140,3643
26.01.2019 18:00,3931,56.73,216,180,3715
26.01.2019 19:00,3877,57.92,266,229,3611
26.01.2019 20:00,3749,55.11,315,279,3434
26.01.2019 21:00,3606,53.06,354,331,3252
26.01.2019 22:00,3411,52.42,407,386,3004
26.01.2019 23:00,3275,51.92,454,439,2821
27.01.2019 00:00,3105,51.14,510,499,2595
27.01.2019 01:00,3111,51.48,617,616,2494
27.01.2019 02:00,3068,51.02,679,691,2389
27.01.2019 03:00,3058,50.71,768,772,2290
27.01.2019 04:00,2991,50.66,850,851,2141
27.01.2019 05:00,2985,50.76,924,908,2061
27.01.2019 06:00,3063,50.84,963,946,2100
27.01.2019 07:00,3221,51.4,962,975,2259
27.01.2019 08:00,3374,51.46,967,990,2407
27.01.2019 09:00,3438,51.45,982,994,2456
27.01.2019 10:00,3541,51.66,987,992,2554
27.01.2019 11:00,3622,52.61,980,981,2642
27.01.2019 12:00,3687,52.64,960,959,2727
27.01.2019 13:00,3688,52.25,935,933,2753
27.01.2019 14:00,3666,52.04,893,900,2773
27.01.2019 15:00,3638,52.05,853,861,2785
27.01.2019 16:00,3637,52.17,811,819,2826
27.01.2019 17:00,3773,53.49,781,780,2992
27.01.2019 18:00,3897,54.31,745,742,3152
27.01.2019 19:00,3850,54.38,704,700,3146
27.01.2019 20:00,3747,54.26,656,652,3091
27.01.2019 21:00,3615,53.61,601,598,3014
27.01.2019 22:00,3476,52.8,538,545,2938
27.01.2019 23:00,3325,52.5,484,488,2841
28.01.2019 00:00,3101,51.53,434,429,2667
28.01.2019 01:00,3039,51.02,429,433,2610
28.01.2019 02:00,3006,50.51,392,385,2614
28.01.2019 03:00,2984,50.32,342,337,2642
28.01.2019 04:00,2989,50.39,302,292,2687
28.01.2019 05:00,3085,50.97,258,247,2827
28.01.2019 06:00,3235,53.57,235,216,3000
28.01.2019 07:00,3639,55.14,217,194,3422
28.01.2019 08:00,4082,64.04,196,178,3886
28.01.2019 09:00,4106,64.88,178,165,3928
28.01.2019 10:00,4079,62.2,153,157,3926
28.01.2019 11:00,4091,58.38,148,144,3943
28.01.2019 12:00,4010,57.3,116,127,3894
28.01.2019 13:00,3918,56.93,104,120,3814
28.01.2019 14:00,3902,56.9,104,122,3798
28.01.2019 15:00,3920,57.37,119,129,3801
28.01.2019 16:00,3951,58,133,139,3818
28.01.2019 17:00,3998,59.67,157,148,3841
28.01.2019 18:00,4121,61.38,172,160,3949
28.01.2019 19:00,4059,59.64,179,175,3880
28.01.2019 20:00,3941,56.44,177,180,3764
28.01.2019 21:00,3779,55.17,172,181,3607
28.01.2019 22:00,3583,54.79,184,181,3399
28.01.2019 23:00,3353,53.68,191,188,3162
29.01.2019 00:00,3104,52.36,204,208,2900
29.01.2019 01:00,3044,51.31,244,249,2800
29.01.2019 02:00,2990,50.69,259,268,2731
29.01.2019 03:00,2970,50.59,300,287,2670
29.01.2019 04:00,2947,51,320,311,2627
29.01.2019 05:00,3026,51.56,316,318,2710
29.01.2019 06:00,3195,54.18,318,309,2877
29.01.2019 07:00,3691,56.58,307,297,3384
29.01.2019 08:00,4068,67.67,292,271,3776
29.01.2019 09:00,4095,72.8,274,238,3821
29.01.2019 10:00,4092,70.63,236,211,3856
29.01.2019 11:00,4125,70.38,216,194,3909
29.01.2019 12:00,4121,67.51,193,186,3928
29.01.2019 13:00,4024,64.03,181,177,3843
29.01.2019 14:00,3988,63.84,161,167,3827
29.01.2019 15:00,3962,66.56,142,155,3820
29.01.2019 16:00,4003,66,131,152,3872
29.01.2019 17:00,4066,69.33,134,162,3932
29.01.2019 18:00,4229,71.45,145,183,4084
29.01.2019 19:00,4138,72.82,163,205,3975
29.01.2019 20:00,4116,68.14,167,213,3949
29.01.2019 21:00,3982,58.08,159,213,3823
29.01.2019 22:00,3752,55.74,167,215,3585
29.01.2019 23:00,3552,53.83,161,209,3391
30.01.2019 00:00,3357,52.64,144,204,3213
30.01.2019 01:00,3257,51.46,126,132,3131
30.01.2019 02:00,3185,51.12,111,125,3074
30.01.2019 03:00,3174,50.69,97,110,3077
30.01.2019 04:00,3182,50.82,85,98,3097
30.01.2019 05:00,3233,51.47,81,93,3152
30.01.2019 06:00,3409,53.97,81,92,3328
30.01.2019 07:00,3870,56.09,88,99,3782
30.01.2019 08:00,4264,66.59,92,107,4172
30.01.2019 09:00,4297,68.22,96,116,4201
30.01.2019 10:00,4230,67.49,103,122,4127
30.01.2019 11:00,4273,66.09,104,122,4169
30.01.2019 12:00,4211,63.73,113,122,4098
30.01.2019 13:00,4097,60.21,108,127,3989
30.01.2019 14:00,4093,57.84,119,144,3974
30.01.2019 15:00,4079,56.97,136,168,3943
30.01.2019 16:00,4064,57.68,189,200,3875
30.01.2019 17:00,4099,61.57,210,251,3889
30.01.2019 18:00,4269,68.2,262,321,4007
30.01.2019 19:00,4242,62.53,340,399,3902
30.01.2019 20:00,4120,57.86,419,472,3701
30.01.2019 21:00,3913,54.41,493,539,3420
30.01.2019 22:00,3729,53.83,550,600,3179
30.01.2019 23:00,3488,51.99,577,637,2911
31.01.2019 00:00,3295,50.86,610,658,2685
31.01.2019 01:00,3117,51,574,584,2543
31.01.2019 02:00,3010,50.55,633,630,2377
31.01.2019 03:00,3010,50.47,677,676,2333
31.01.2019 04:00,3040,50.52,685,723,2355
31.01.2019 05:00,3103,50.92,749,765,2354
31.01.2019 06:00,3284,53.75,791,799,2493
31.01.2019 07:00,3718,57.36,826,827,2892
31.01.2019 08:00,4095,69.07,830,834,3265
31.01.2019 09:00,4212,70.06,830,826,3382
31.01.2019 10:00,4174,67.42,834,810,3340
31.01.2019 11:00,4224,65.73,818,791,3406
31.01.2019 12:00,4212,66.31,787,772,3425
31.01.2019 13:00,4231,65.21,767,749,3464
31.01.2019 14:00,4226,64.63,713,710,3513
31.01.2019 15:00,4245,64.57,632,653,3613
31.01.2019 16:00,4260,64.57,588,598,3672
31.01.2019 17:00,4223,63.78,545,553,3678
31.01.2019 18:00,4316,66.68,491,513,3825
31.01.2019 19:00,4211,65.37,450,477,3761
31.01.2019 20:00,4064,56.57,424,445,3640
31.01.2019 21:00,3876,55.68,384,415,3492
31.01.2019 22:00,3619,54.28,360,386,3259
31.01.2019 23:00,3413,52.62,354,366,3059
02.01.2019 00:00,3192,51.46,336,353,2856
02.01.2019 01:00,3051,51.31,334,344,2717
02.01.2019 02:00,2984,50.47,326,332,2658
02.01.2019 03:00,2983,50.03,322,330,2661
02.01.2019 04:00,2977,50.1,320,333,2657
02.01.2019 05:00,3040,50.72,323,343,2717
02.01.2019 06:00,3214,52.56,334,356,2880
02.01.2019 07:00,3628,53.98,341,368,3287
02.01.2019 08:00,4001,55.29,349,374,3652
02.01.2019 09:00,4069,56.66,339,374,3730
02.01.2019 10:00,4128,55.93,363,377,3765
02.01.2019 11:00,4149,55.89,350,387,3799
02.01.2019 12:00,4084,56.53,335,398,3749
02.01.2019 13:00,4024,56.05,349,409,3675
02.01.2019 14:00,3949,55.64,349,405,3600
02.01.2019 15:00,3874,55.66,336,387,3538
02.01.2019 16:00,3856,55.59,324,375,3532
02.01.2019 17:00,3858,62.37,320,377,3538
02.01.2019 18:00,4020,65.98,322,387,3698
02.01.2019 19:00,3962,64.96,331,399,3631
02.01.2019 20:00,3782,55.08,339,394,3443
02.01.2019 21:00,3523,54.18,330,378,3193
02.01.2019 22:00,3328,53.99,329,357,2999
02.01.2019 23:00,3208,52.71,329,357,2879
02.02.2019 00:00,3077,50.92,340,368,2737
02.02.2019 01:00,2944,50.04,349,345,2595
02.02.2019 02:00,2852,48.67,354,366,2498
02.02.2019 03:00,2868,48.1,374,391,2494
02.02.2019 04:00,2896,48.05,409,418,2487
02.02.2019 05:00,2912,48.5,434,446,2478
02.02.2019 06:00,2969,49.07,459,468,2510
02.02.2019 07:00,3074,49.21,461,483,2613
02.02.2019 08:00,3257,49.68,472,495,2785
02.02.2019 09:00,3379,51.47,481,510,2898
02.02.2019 10:00,3557,53.28,505,531,3052
02.02.2019 11:00,3618,54.1,489,554,3129
02.02.2019 12:00,3720,53.87,495,573,3225
02.02.2019 13:00,3787,53.46,507,591,3280
02.02.2019 14:00,3703,52.14,525,607,3178
02.02.2019 15:00,3571,50.97,551,614,3020
02.02.2019 16:00,3494,51.05,568,621,2926
02.02.2019 17:00,3613,52.19,557,602,3056
02.02.2019 18:00,3801,54.06,518,560,3283
02.02.2019 19:00,3739,54.98,496,504,3243
02.02.2019 20:00,3605,53.28,451,455,3154
02.02.2019 21:00,3331,51.66,417,409,2914
02.02.2019 22:00,3183,49.9,382,366,2801
02.02.2019 23:00,3055,49.46,356,322,2699
02.03.2019 00:00,2873,48.04,328,287,2545
02.03.2019 01:00,2847,48.5,359,323,2488
02.03.2019 02:00,2827,47.55,336,329,2491
02.03.2019 03:00,2812,47.1,333,341,2479
02.03.2019 04:00,2824,46.74,352,353,2472
02.03.2019 05:00,2855,47.12,362,354,2493
02.03.2019 06:00,2840,47.39,339,339,2501
02.03.2019 07:00,2897,47.93,312,321,2585
02.03.2019 08:00,3002,48.34,333,323,2669
02.03.2019 09:00,3125,48.89,355,331,2770
02.03.2019 10:00,3282,49.86,350,333,2932
02.03.2019 11:00,3407,50.54,334,318,3073
02.03.2019 12:00,3559,51.11,306,292,3253
02.03.2019 13:00,3588,50.73,270,275,3318
02.03.2019 14:00,3520,50.43,272,275,3248
02.03.2019 15:00,3466,50.28,290,286,3176
02.03.2019 16:00,3472,50.58,282,295,3190
02.03.2019 17:00,3604,51.61,285,296,3319
02.03.2019 18:00,3872,53.43,280,295,3592
02.03.2019 19:00,3891,55.32,294,294,3597
02.03.2019 20:00,3818,55.14,266,283,3552
02.03.2019 21:00,3587,53.38,237,258,3350
02.03.2019 22:00,3452,51.94,202,225,3250
02.03.2019 23:00,3349,51.04,175,191,3174
02.04.2019 00:00,3253,49.46,154,164,3099
02.04.2019 01:00,3152,50.18,131,134,3021
02.04.2019 02:00,3038,50.05,130,126,2908
02.04.2019 03:00,3018,49.82,133,131,2885
02.04.2019 04:00,3054,50,147,150,2907
02.04.2019 05:00,3129,50.56,169,171,2960
02.04.2019 06:00,3329,52.13,189,199,3140
02.04.2019 07:00,3789,53.65,229,235,3560
02.04.2019 08:00,4177,60.67,254,270,3923
02.04.2019 09:00,4224,62.38,284,300,3940
02.04.2019 10:00,4191,61.09,317,340,3874
02.04.2019 11:00,4124,60,399,399,3725
02.04.2019 12:00,4042,54.96,471,472,3571
02.04.2019 13:00,3962,54.23,541,553,3421
02.04.2019 14:00,4013,53.8,630,629,3383
02.04.2019 15:00,4021,54.09,726,715,3295
02.04.2019 16:00,4014,54.01,805,803,3209
02.04.2019 17:00,3941,54.52,877,887,3064
02.04.2019 18:00,4033,55.5,967,968,3066
02.04.2019 19:00,3986,54.2,1036,1038,2950
02.04.2019 20:00,3868,52.96,1097,1099,2771
02.04.2019 21:00,3760,52.18,1151,1152,2609
02.04.2019 22:00,3616,51.66,1201,1193,2415
02.04.2019 23:00,3358,50.59,1227,1215,2131
02.05.2019 00:00,3190,49.09,1239,1224,1951
02.05.2019 01:00,3095,47.74,1286,1302,1809
02.05.2019 02:00,3054,47.47,1293,1292,1761
02.05.2019 03:00,3043,47.36,1273,1270,1770
02.05.2019 04:00,3031,47.5,1241,1240,1790
02.05.2019 05:00,3107,47.78,1229,1219,1878
02.05.2019 06:00,3267,49.77,1214,1210,2053
02.05.2019 07:00,3685,51.38,1215,1209,2470
02.05.2019 08:00,4143,55.25,1221,1204,2922
02.05.2019 09:00,4082,55.07,1202,1196,2880
02.05.2019 10:00,4002,54.83,1188,1188,2814
02.05.2019 11:00,4020,54.55,1200,1174,2820
02.05.2019 12:00,4000,54.09,1164,1145,2836
02.05.2019 13:00,3902,53.49,1109,1098,2793
02.05.2019 14:00,3898,53.4,1037,1045,2861
02.05.2019 15:00,3881,53.61,985,987,2896
02.05.2019 16:00,3884,53.63,948,925,2936
02.05.2019 17:00,3867,54.53,856,867,3011
02.05.2019 18:00,4062,57.12,814,811,3248
02.05.2019 19:00,4045,56.65,749,750,3296
02.05.2019 20:00,3887,55.19,683,689,3204
02.05.2019 21:00,3730,53.69,627,629,3103
02.05.2019 22:00,3550,52.6,577,566,2973
02.05.2019 23:00,3324,50.9,501,489,2823
02.06.2019 00:00,3145,49.58,429,409,2716
02.06.2019 01:00,2977,49.33,394,369,2583
02.06.2019 02:00,2904,49.03,319,298,2585
02.06.2019 03:00,2918,48.92,226,232,2692
02.06.2019 04:00,2929,49.03,178,175,2751
02.06.2019 05:00,2969,49.65,142,126,2827
02.06.2019 06:00,3181,51.17,103,93,3078
02.06.2019 07:00,3650,52.34,79,81,3571
02.06.2019 08:00,4060,60.05,93,98,3967
02.06.2019 09:00,4069,63.88,124,135,3945
02.06.2019 10:00,4052,54.84,162,186,3890
02.06.2019 11:00,4098,53.73,229,255,3869
02.06.2019 12:00,4058,53.32,335,341,3723
02.06.2019 13:00,4051,53.19,443,441,3608
02.06.2019 14:00,4069,52.81,515,522,3554
02.06.2019 15:00,4100,52.93,571,589,3529
02.06.2019 16:00,4142,53.8,630,649,3512
02.06.2019 17:00,4158,55.37,652,685,3506
02.06.2019 18:00,4232,60.27,624,695,3608
02.06.2019 19:00,4133,60.9,598,692,3535
02.06.2019 20:00,4020,57.06,573,672,3447
02.06.2019 21:00,3904,52.89,546,633,3358
02.06.2019 22:00,3683,51.63,509,587,3174
02.06.2019 23:00,3406,50.2,467,525,2939
02.07.2019 00:00,3201,48.17,424,457,2777
02.07.2019 01:00,3003,47.39,346,355,2657
02.07.2019 02:00,2883,46.32,292,304,2591
02.07.2019 03:00,2824,45.84,243,259,2581
02.07.2019 04:00,2845,45.96,222,219,2623
02.07.2019 05:00,2880,47.21,185,192,2695
02.07.2019 06:00,3038,48.97,164,179,2874
02.07.2019 07:00,3442,50.34,154,177,3288
02.07.2019 08:00,3845,53.29,183,199,3662
02.07.2019 09:00,3889,53.04,203,245,3686
02.07.2019 10:00,3870,51.98,271,311,3599
02.07.2019 11:00,3896,51.47,356,389,3540
02.07.2019 12:00,3870,51.35,419,464,3451
02.07.2019 13:00,3820,51.09,507,538,3313
02.07.2019 14:00,3791,50.8,583,594,3208
02.07.2019 15:00,3764,50.7,639,635,3125
02.07.2019 16:00,3774,50.69,679,681,3095
02.07.2019 17:00,3829,50.76,704,738,3125
02.07.2019 18:00,3967,51.37,707,797,3260
02.07.2019 19:00,3978,51.4,754,852,3224
02.07.2019 20:00,3872,50.41,849,921,3023
02.07.2019 21:00,3633,49.72,932,1005,2701
02.07.2019 22:00,3462,48.82,1026,1085,2436
02.07.2019 23:00,3292,48.38,1115,1155,2177
02.08.2019 00:00,3035,46.91,1186,1212,1849
02.08.2019 01:00,2982,46.14,1258,1248,1724
02.08.2019 02:00,2891,44.86,1307,1296,1584
02.08.2019 03:00,2844,43.06,1318,1318,1526
02.08.2019 04:00,2845,43.05,1320,1334,1525
02.08.2019 05:00,2875,45.36,1335,1339,1540
02.08.2019 06:00,3021,48.02,1333,1340,1688
02.08.2019 07:00,3403,49.96,1341,1337,2062
02.08.2019 08:00,3801,52.23,1330,1326,2471
02.08.2019 09:00,3888,52.8,1299,1302,2589
02.08.2019 10:00,3881,52.74,1266,1273,2615
02.08.2019 11:00,3857,51.35,1198,1236,2659
02.08.2019 12:00,3813,50.66,1135,1188,2678
02.08.2019 13:00,3745,50.27,1054,1125,2691
02.08.2019 14:00,3681,49.83,959,1040,2722
02.08.2019 15:00,3669,49.91,922,941,2747
02.08.2019 16:00,3624,49.42,851,862,2773
02.08.2019 17:00,3630,49.71,844,859,2786
02.08.2019 18:00,3720,50.42,881,915,2839
02.08.2019 19:00,3616,50.66,957,986,2659
02.08.2019 20:00,3399,49.17,1013,1056,2386
02.08.2019 21:00,3219,48.97,1095,1118,2124
02.08.2019 22:00,3057,47.93,1151,1169,1906
02.08.2019 23:00,2889,47.3,1179,1195,1710
02.09.2019 00:00,2794,44.24,1207,1203,1587
02.09.2019 01:00,2730,46.57,1244,1256,1486
02.09.2019 02:00,2680,45.91,1251,1262,1429
02.09.2019 03:00,2629,45.02,1258,1265,1371
02.09.2019 04:00,2643,44.69,1252,1263,1391
02.09.2019 05:00,2655,45.59,1241,1252,1414
02.09.2019 06:00,2723,46.43,1220,1227,1503
02.09.2019 07:00,2823,45.98,1199,1197,1624
02.09.2019 08:00,2957,46.54,1166,1154,1791
02.09.2019 09:00,3066,46.63,1122,1104,1944
02.09.2019 10:00,3162,48.17,1069,1052,2093
02.09.2019 11:00,3240,48.7,1032,1024,2208
02.09.2019 12:00,3302,48.64,1018,1024,2284
02.09.2019 13:00,3314,48.36,1011,1036,2303
02.09.2019 14:00,3259,47.82,1028,1060,2231
02.09.2019 15:00,3206,47.22,1063,1099,2143
02.09.2019 16:00,3240,47.01,1122,1147,2118
02.09.2019 17:00,3275,48.12,1196,1221,2079
02.09.2019 18:00,3483,49.4,1277,1301,2206
02.09.2019 19:00,3379,49.35,1341,1358,2038
02.09.2019 20:00,3262,47.51,1389,1396,1873
02.09.2019 21:00,3123,45.91,1406,1416,1717
02.09.2019 22:00,3045,46.67,1425,1424,1620
02.09.2019 23:00,2926,46.65,1427,1423,1499
02.10.2019 00:00,2794,46.19,1418,1413,1376
02.10.2019 01:00,2732,44.12,1426,1415,1306
02.10.2019 02:00,2677,42.25,1408,1400,1269
02.10.2019 03:00,2633,40.85,1383,1372,1250
02.10.2019 04:00,2620,40.3,1347,1333,1273
02.10.2019 05:00,2624,41.27,1295,1278,1329
02.10.2019 06:00,2734,43.42,1212,1213,1522
02.10.2019 07:00,2807,43,1157,1145,1650
02.10.2019 08:00,2901,44.06,1082,1090,1819
02.10.2019 09:00,2945,44.72,1034,1043,1911
02.10.2019 10:00,3043,44.97,1013,985,2030
02.10.2019 11:00,3029,45.67,934,910,2095
02.10.2019 12:00,3120,46.07,833,823,2287
02.10.2019 13:00,3220,46.47,731,723,2489
02.10.2019 14:00,3270,46.82,592,574,2678
02.10.2019 15:00,3251,46.9,427,402,2824
02.10.2019 16:00,3202,47.04,302,262,2900
02.10.2019 17:00,3256,48.21,199,181,3057
02.10.2019 18:00,3396,49.41,136,132,3260
02.10.2019 19:00,3357,49.73,94,95,3263
02.10.2019 20:00,3277,49.48,66,72,3211
02.10.2019 21:00,3137,48.14,65,72,3072
02.10.2019 22:00,2964,47.25,86,92,2878
02.10.2019 23:00,2859,46.62,117,134,2742
02.11.2019 00:00,2777,45.57,175,192,2602
02.11.2019 01:00,2699,45.93,190,203,2509
02.11.2019 02:00,2665,44.94,223,249,2442
02.11.2019 03:00,2653,44.44,289,296,2364
02.11.2019 04:00,2728,44.21,313,348,2415
02.11.2019 05:00,2796,44.78,329,384,2467
02.11.2019 06:00,2962,46.51,345,402,2617
02.11.2019 07:00,3331,47.47,405,428,2926
02.11.2019 08:00,3728,49.04,484,490,3244
02.11.2019 09:00,3825,49.41,567,587,3258
02.11.2019 10:00,3865,48.44,667,699,3198
02.11.2019 11:00,3926,48.25,765,804,3161
02.11.2019 12:00,3964,47.98,851,899,3113
02.11.2019 13:00,3936,47.91,923,986,3013
02.11.2019 14:00,3865,47.71,987,1040,2878
02.11.2019 15:00,3777,47.54,1007,1062,2770
02.11.2019 16:00,3785,47.5,1008,1066,2777
02.11.2019 17:00,3814,47.67,1008,1053,2806
02.11.2019 18:00,4014,48.19,995,1026,3019
02.11.2019 19:00,4004,48.51,952,998,3052
02.11.2019 20:00,3940,48.73,923,959,3017
02.11.2019 21:00,3833,47.96,881,913,2952
02.11.2019 22:00,3604,47.06,861,872,2743
02.11.2019 23:00,3356,45.21,844,853,2512
02.12.2019 00:00,3094,41.92,841,845,2253
02.12.2019 01:00,2982,40.69,802,810,2180
02.12.2019 02:00,2969,39.89,767,789,2202
02.12.2019 03:00,2944,39.43,762,766,2182
02.12.2019 04:00,2993,39.86,711,742,2282
02.12.2019 05:00,3054,43.31,686,706,2368
02.12.2019 06:00,3253,46.31,656,658,2597
02.12.2019 07:00,3655,47.9,611,607,3044
02.12.2019 08:00,4078,53.73,538,536,3540
02.12.2019 09:00,4222,53.72,470,460,3752
02.12.2019 10:00,4149,55.95,386,397,3763
02.12.2019 11:00,4098,54.32,346,352,3752
02.12.2019 12:00,3964,50.71,337,330,3627
02.12.2019 13:00,3729,50.02,321,328,3408
02.12.2019 14:00,3612,49.59,323,339,3289
02.12.2019 15:00,3645,49.98,341,350,3304
02.12.2019 16:00,3757,49.98,352,353,3405
02.12.2019 17:00,3824,51.57,369,375,3455
02.12.2019 18:00,4001,55.56,412,410,3589
02.12.2019 19:00,3975,59.02,428,432,3547
02.12.2019 20:00,3858,49.73,466,442,3392
02.12.2019 21:00,3587,47.93,504,448,3083
02.12.2019 22:00,3367,47.37,529,455,2838
02.12.2019 23:00,3102,46.86,575,480,2527
13.02.2019 00:00,2835,46.1,630,519,2205
13.02.2019 01:00,2852,43.78,974,948,1878
13.02.2019 02:00,2751,40.69,1058,1037,1693
13.02.2019 03:00,2698,40.06,1119,1109,1579
13.02.2019 04:00,2703,39.71,1175,1165,1528
13.02.2019 05:00,2740,41.28,1181,1202,1559
13.02.2019 06:00,2871,43.29,1221,1222,1650
13.02.2019 07:00,3326,45.84,1224,1233,2102
13.02.2019 08:00,3665,47.79,1249,1223,2416
13.02.2019 09:00,3671,48.42,1187,1191,2484
13.02.2019 10:00,3569,47.33,1133,1150,2436
13.02.2019 11:00,3481,46.96,1082,1091,2399
13.02.2019 12:00,3387,46.66,1005,1019,2382
13.02.2019 13:00,3311,46.14,931,930,2380
13.02.2019 14:00,3295,46.15,882,867,2413
13.02.2019 15:00,3377,46.3,877,830,2500
13.02.2019 16:00,3461,46.82,808,806,2653
13.02.2019 17:00,3448,47.88,740,771,2708
13.02.2019 18:00,3714,48.58,741,724,2973
13.02.2019 19:00,3694,53.52,670,674,3024
13.02.2019 20:00,3565,48.56,632,643,2933
13.02.2019 21:00,3405,47.55,628,620,2777
13.02.2019 22:00,3144,46.42,604,603,2540
13.02.2019 23:00,3004,45.97,577,597,2427
14.02.2019 00:00,2824,43.62,576,598,2248
14.02.2019 01:00,2689,41.75,610,596,2079
14.02.2019 02:00,2623,40.12,582,573,2041
14.02.2019 03:00,2575,39.85,533,529,2042
14.02.2019 04:00,2602,40.6,482,481,2120
14.02.2019 05:00,2665,43,423,434,2242
14.02.2019 06:00,2882,44.49,394,394,2488
14.02.2019 07:00,3270,51.3,361,367,2909
14.02.2019 08:00,3564,59.27,351,358,3213
14.02.2019 09:00,3578,61.07,355,355,3223
14.02.2019 10:00,3556,55.63,373,352,3183
14.02.2019 11:00,3590,51.74,364,362,3226
14.02.2019 12:00,3534,46.12,346,384,3188
14.02.2019 13:00,3486,44.7,410,413,3076
14.02.2019 14:00,3404,44.65,434,447,2970
14.02.2019 15:00,3399,45.19,485,478,2914
14.02.2019 16:00,3466,45.99,483,506,2983
14.02.2019 17:00,3542,51.13,513,526,3029
14.02.2019 18:00,3702,54.29,536,537,3166
14.02.2019 19:00,3640,53.03,553,545,3087
14.02.2019 20:00,3485,46.99,543,541,2942
14.02.2019 21:00,3358,44.98,544,531,2814
14.02.2019 22:00,3231,44.3,531,525,2700
14.02.2019 23:00,3009,43.84,520,522,2489
15.02.2019 00:00,2834,42.76,510,519,2324
15.02.2019 01:00,2692,42.7,505,485,2187
15.02.2019 02:00,2706,41.18,498,475,2208
15.02.2019 03:00,2704,40.35,483,467,2221
15.02.2019 04:00,2618,39.59,466,457,2152
15.02.2019 05:00,2685,41.1,456,443,2229
15.02.2019 06:00,2882,43.67,438,428,2444
15.02.2019 07:00,3336,46.28,410,414,2926
15.02.2019 08:00,3668,58.02,386,388,3282
15.02.2019 09:00,3787,58.08,370,348,3417
15.02.2019 10:00,3744,54.08,303,309,3441
15.02.2019 11:00,3719,50.78,255,272,3464
15.02.2019 12:00,3655,44.63,229,239,3426
15.02.2019 13:00,3536,43.73,227,216,3309
15.02.2019 14:00,3412,43.36,221,215,3191
15.02.2019 15:00,3290,43.56,227,239,3063
15.02.2019 16:00,3275,44.41,276,290,2999
15.02.2019 17:00,3325,47.03,348,368,2977
15.02.2019 18:00,3505,52.32,421,447,3084
15.02.2019 19:00,3589,53.04,497,523,3092
15.02.2019 20:00,3468,45.01,548,575,2920
15.02.2019 21:00,3247,44.35,587,606,2660
15.02.2019 22:00,3022,43.37,652,626,2370
15.02.2019 23:00,2908,43.37,698,643,2210
16.02.2019 00:00,2783,39.92,721,661,2062
16.02.2019 01:00,2710,39.67,752,708,1958
16.02.2019 02:00,2669,37.16,744,715,1925
16.02.2019 03:00,2680,36,728,711,1952
16.02.2019 04:00,2696,36.29,735,706,1961
16.02.2019 05:00,2748,36.52,728,708,2020
16.02.2019 06:00,2812,35.5,729,715,2083
16.02.2019 07:00,2925,38.39,733,725,2192
16.02.2019 08:00,3037,40.39,727,727,2310
16.02.2019 09:00,3150,40.94,731,716,2419
16.02.2019 10:00,3215,40.92,711,692,2504
16.02.2019 11:00,3161,41.67,674,662,2487
16.02.2019 12:00,3093,41.33,637,644,2456
16.02.2019 13:00,2919,39.07,635,641,2284
16.02.2019 14:00,2851,38.8,655,670,2196
16.02.2019 15:00,2788,38.47,704,721,2084
16.02.2019 16:00,2767,39.61,755,780,2012
16.02.2019 17:00,2853,42.23,792,832,2061
16.02.2019 18:00,3111,43.75,831,870,2280
16.02.2019 19:00,3256,43.81,842,892,2414
16.02.2019 20:00,3189,43.39,870,887,2319
16.02.2019 21:00,2987,42.49,868,854,2119
16.02.2019 22:00,2898,40.67,797,810,2101
16.02.2019 23:00,2792,38.99,750,766,2042
17.02.2019 00:00,2715,40.07,692,724,2023
17.02.2019 01:00,2493,36.76,610,594,1883
17.02.2019 02:00,2441,35.46,569,549,1872
17.02.2019 03:00,2432,37.24,522,499,1910
17.02.2019 04:00,2471,36.27,471,454,2000
17.02.2019 05:00,2528,36.13,418,415,2110
17.02.2019 06:00,2594,36.74,372,384,2222
17.02.2019 07:00,2661,37.42,342,356,2319
17.02.2019 08:00,2768,40.62,304,317,2464
17.02.2019 09:00,2851,41.58,270,276,2581
17.02.2019 10:00,3010,42.47,236,239,2774
17.02.2019 11:00,3045,43.05,185,205,2860
17.02.2019 12:00,3041,43.3,154,175,2887
17.02.2019 13:00,2997,43.21,135,151,2862
17.02.2019 14:00,2930,43.27,117,128,2813
17.02.2019 15:00,2883,43.13,96,107,2787
17.02.2019 16:00,2905,43.01,82,91,2823
17.02.2019 17:00,2942,43.74,73,86,2869
17.02.2019 18:00,3161,45.4,77,91,3084
17.02.2019 19:00,3259,47.21,94,109,3165
17.02.2019 20:00,3209,46.13,112,135,3097
17.02.2019 21:00,3088,45.04,145,167,2943
17.02.2019 22:00,2944,43.32,179,208,2765
17.02.2019 23:00,2843,42.91,218,246,2625
18.02.2019 00:00,2695,42.27,261,292,2434
18.02.2019 01:00,2627,40.38,302,311,2325
18.02.2019 02:00,2595,38.78,366,353,2229
18.02.2019 03:00,2567,38.78,408,391,2159
18.02.2019 04:00,2619,38.2,426,422,2193
18.02.2019 05:00,2683,40.46,431,438,2252
18.02.2019 06:00,2869,43.66,438,441,2431
18.02.2019 07:00,3335,47.87,451,438,2884
18.02.2019 08:00,3623,55.99,420,411,3203
18.02.2019 09:00,3695,54.67,363,373,3332
18.02.2019 10:00,3702,51.35,336,334,3366
18.02.2019 11:00,3681,47.76,302,303,3379
18.02.2019 12:00,3549,45.09,269,279,3280
18.02.2019 13:00,3438,44.15,244,260,3194
18.02.2019 14:00,3402,43.97,237,252,3165
18.02.2019 15:00,3370,44.78,233,250,3137
18.02.2019 16:00,3368,46.21,238,256,3130
18.02.2019 17:00,3449,49.68,251,278,3198
18.02.2019 18:00,3581,51.67,288,324,3293
18.02.2019 19:00,3632,52.74,336,385,3296
18.02.2019 20:00,3603,45.35,383,423,3220
18.02.2019 21:00,3456,44.8,409,440,3047
18.02.2019 22:00,3199,43.98,445,451,2754
18.02.2019 23:00,2985,42.23,456,451,2529
19.02.2019 00:00,2806,39.21,442,442,2364
19.02.2019 01:00,2657,36.09,468,454,2189
19.02.2019 02:00,2637,35.43,448,436,2189
19.02.2019 03:00,2640,35.42,429,413,2211
19.02.2019 04:00,2696,36,407,399,2289
19.02.2019 05:00,2781,36.97,427,416,2354
19.02.2019 06:00,2936,41.69,466,455,2470
19.02.2019 07:00,3287,43.87,510,509,2777
19.02.2019 08:00,3518,47.52,582,583,2936
19.02.2019 09:00,3662,45.64,634,673,3028
19.02.2019 10:00,3637,44.22,757,774,2880
19.02.2019 11:00,3657,43.55,861,878,2796
19.02.2019 12:00,3567,43.17,940,971,2627
19.02.2019 13:00,3546,42.97,1038,1046,2508
19.02.2019 14:00,3551,42.92,1083,1092,2468
19.02.2019 15:00,3549,43.01,1112,1122,2437
19.02.2019 16:00,3604,43.03,1124,1139,2480
19.02.2019 17:00,3575,43.38,1143,1156,2432
19.02.2019 18:00,3675,44.9,1192,1182,2483
19.02.2019 19:00,3682,45.06,1215,1207,2467
19.02.2019 20:00,3569,44.12,1214,1227,2355
19.02.2019 21:00,3415,43.67,1252,1238,2163
19.02.2019 22:00,3198,41.63,1260,1238,1938
19.02.2019 23:00,2986,39.74,1248,1225,1738
20.02.2019 00:00,2803,35.69,1226,1202,1577
20.02.2019 01:00,2693,35.2,1194,1196,1499
20.02.2019 02:00,2710,34.05,1175,1162,1535
20.02.2019 03:00,2668,32.95,1133,1117,1535
20.02.2019 04:00,2690,35.06,1094,1067,1596
20.02.2019 05:00,2699,36.06,1021,1014,1678
20.02.2019 06:00,2826,41.43,961,958,1865
20.02.2019 07:00,3232,43.42,904,894,2328
20.02.2019 08:00,3592,45,807,809,2785
20.02.2019 09:00,3770,45.85,701,711,3069
20.02.2019 10:00,3793,45.62,602,627,3191
20.02.2019 11:00,3731,45.43,501,546,3230
20.02.2019 12:00,3641,44.3,405,464,3236
20.02.2019 13:00,3502,43.74,333,390,3169
20.02.2019 14:00,3423,43.97,277,335,3146
20.02.2019 15:00,3371,44.6,244,293,3127
20.02.2019 16:00,3419,44.91,205,252,3214
20.02.2019 17:00,3461,45.54,183,208,3278
20.02.2019 18:00,3625,46.42,164,174,3461
20.02.2019 19:00,3638,46.56,151,147,3487
20.02.2019 20:00,3506,45.63,135,128,3371
20.02.2019 21:00,3382,45.06,124,113,3258
20.02.2019 22:00,3182,44.06,113,111,3069
20.02.2019 23:00,3012,43.27,114,119,2898
21.02.2019 00:00,2797,42.14,124,134,2673
21.02.2019 01:00,2663,41.54,130,147,2533
21.02.2019 02:00,2565,40.79,154,173,2411
21.02.2019 03:00,2554,40.63,190,210,2364
21.02.2019 04:00,2562,40.93,238,249,2324
21.02.2019 05:00,2573,41.24,277,285,2296
21.02.2019 06:00,2743,42.98,304,324,2439
21.02.2019 07:00,3236,44.26,332,363,2904
21.02.2019 08:00,3568,45.72,381,399,3187
21.02.2019 09:00,3599,46.14,417,423,3182
21.02.2019 10:00,3622,45.58,415,442,3207
21.02.2019 11:00,3686,44.74,429,450,3257
21.02.2019 12:00,3687,44.14,418,445,3269
21.02.2019 13:00,3598,43.88,388,440,3210
21.02.2019 14:00,3601,43.83,379,413,3222
21.02.2019 15:00,3639,43.96,359,380,3280
21.02.2019 16:00,3674,44.2,337,348,3337
21.02.2019 17:00,3651,45.19,332,331,3319
21.02.2019 18:00,3778,49.4,326,334,3452
21.02.2019 19:00,3704,53.1,374,370,3330
21.02.2019 20:00,3601,51.71,442,409,3159
21.02.2019 21:00,3392,45.63,536,459,2856
21.02.2019 22:00,3233,45.02,608,519,2625
21.02.2019 23:00,3177,44,635,565,2542
22.02.2019 00:00,2938,42.69,660,581,2278
22.02.2019 01:00,2950,42.25,672,633,2278
22.02.2019 02:00,2918,41.2,597,563,2321
22.02.2019 03:00,2945,40.82,514,493,2431
22.02.2019 04:00,2992,40.56,464,434,2528
22.02.2019 05:00,3057,41.28,399,395,2658
22.02.2019 06:00,3254,43.03,363,363,2891
22.02.2019 07:00,3639,49.19,339,330,3300
22.02.2019 08:00,3899,55.03,300,287,3599
22.02.2019 09:00,4045,57.95,246,243,3799
22.02.2019 10:00,4028,55.62,218,216,3810
22.02.2019 11:00,3946,54.14,221,199,3725
22.02.2019 12:00,3838,53.06,180,176,3658
22.02.2019 13:00,3705,51.45,149,153,3556
22.02.2019 14:00,3626,48.99,123,132,3503
22.02.2019 15:00,3536,45.88,110,116,3426
22.02.2019 16:00,3511,44.75,98,104,3413
22.02.2019 17:00,3552,46.46,99,101,3453
22.02.2019 18:00,3811,50.42,119,120,3692
22.02.2019 19:00,3896,52.4,148,156,3748
22.02.2019 20:00,3721,45.25,183,199,3538
22.02.2019 21:00,3555,43,227,235,3328
22.02.2019 22:00,3345,42.04,267,273,3078
22.02.2019 23:00,3197,42.17,303,309,2894
23.02.2019 00:00,3055,39.6,331,339,2724
23.02.2019 01:00,2939,38.04,396,380,2543
23.02.2019 02:00,2874,36.54,400,407,2474
23.02.2019 03:00,2871,36.06,421,429,2450
23.02.2019 04:00,2856,36.01,444,454,2412
23.02.2019 05:00,2875,35.61,463,471,2412
23.02.2019 06:00,2870,36.03,457,478,2413
23.02.2019 07:00,2979,37.79,472,483,2507
23.02.2019 08:00,3088,40.62,458,474,2630
23.02.2019 09:00,3218,41.57,440,453,2778
23.02.2019 10:00,3287,41.61,436,437,2851
23.02.2019 11:00,3228,41.04,410,425,2818
23.02.2019 12:00,3160,40.34,379,414,2781
23.02.2019 13:00,3047,40.02,358,400,2689
23.02.2019 14:00,2902,39.31,359,386,2543
23.02.2019 15:00,2840,38.8,348,369,2492
23.02.2019 16:00,2874,39.33,360,353,2514
23.02.2019 17:00,2954,41.44,341,357,2613
23.02.2019 18:00,3214,43.01,378,388,2836
23.02.2019 19:00,3307,43.17,424,429,2883
23.02.2019 20:00,3195,42.48,455,452,2740
23.02.2019 21:00,3100,41.61,466,458,2634
23.02.2019 22:00,2976,40.35,469,459,2507
23.02.2019 23:00,2864,40.48,465,461,2399
24.02.2019 00:00,2790,39,469,467,2321
24.02.2019 01:00,2703,37.82,498,514,2205
24.02.2019 02:00,2642,36.96,515,523,2127
24.02.2019 03:00,2596,36.97,522,526,2074
24.02.2019 04:00,2590,36.21,523,528,2067
24.02.2019 05:00,2674,36.21,538,538,2136
24.02.2019 06:00,2710,37.04,570,554,2140
24.02.2019 07:00,2733,36.98,579,567,2154
24.02.2019 08:00,2705,37.98,572,562,2133
24.02.2019 09:00,2878,39.11,562,542,2316
24.02.2019 10:00,2974,39.79,526,516,2448
24.02.2019 11:00,2942,38.58,471,493,2471
24.02.2019 12:00,2854,37.97,429,473,2425
24.02.2019 13:00,2720,37.67,412,456,2308
24.02.2019 14:00,2649,36.1,421,452,2228
24.02.2019 15:00,2663,35.39,435,458,2228
24.02.2019 16:00,2670,35.86,452,464,2218
24.02.2019 17:00,2804,38,449,467,2355
24.02.2019 18:00,3101,41.31,460,472,2641
24.02.2019 19:00,3318,41.63,465,477,2853
24.02.2019 20:00,3271,41.31,469,472,2802
24.02.2019 21:00,3176,40.62,448,459,2728
24.02.2019 22:00,3050,40.21,413,446,2637
24.02.2019 23:00,2875,39.5,403,432,2472
25.02.2019 00:00,2663,38.97,357,388,2306
25.02.2019 01:00,2562,37.09,336,354,2226
25.02.2019 02:00,2469,36.13,325,346,2144
25.02.2019 03:00,2476,36.11,323,345,2153
25.02.2019 04:00,2537,36.02,330,348,2207
25.02.2019 05:00,2610,36.06,344,367,2266
25.02.2019 06:00,2776,40.07,361,395,2415
25.02.2019 07:00,3315,42.8,387,426,2928
25.02.2019 08:00,3627,43.76,380,415,3247
25.02.2019 09:00,3799,44.38,366,370,3433
25.02.2019 10:00,3773,44.35,306,331,3467
25.02.2019 11:00,3690,44.1,282,321,3408
25.02.2019 12:00,3562,41.85,277,332,3285
25.02.2019 13:00,3416,41.07,297,349,3119
25.02.2019 14:00,3355,40.82,297,359,3058
25.02.2019 15:00,3291,41.04,300,359,2991
25.02.2019 16:00,3291,41.97,325,363,2966
25.02.2019 17:00,3334,43.26,371,384,2963
25.02.2019 18:00,3431,49.92,411,417,3020
25.02.2019 19:00,3475,51.07,451,448,3024
25.02.2019 20:00,3350,43.18,469,452,2881
25.02.2019 21:00,3193,41.85,529,435,2664
25.02.2019 22:00,2946,41.04,538,413,2408
25.02.2019 23:00,2832,40.38,482,405,2350
26.02.2019 00:00,2735,39.43,468,408,2267
26.02.2019 01:00,2713,37.1,573,591,2140
26.02.2019 02:00,2612,37,542,561,2070
26.02.2019 03:00,2575,36.84,517,525,2058
26.02.2019 04:00,2596,35.88,508,488,2088
26.02.2019 05:00,2641,37.35,473,461,2168
26.02.2019 06:00,2770,40.57,445,445,2325
26.02.2019 07:00,3236,42.54,436,433,2800
26.02.2019 08:00,3480,51.77,408,400,3072
26.02.2019 09:00,3569,51.88,356,338,3213
26.02.2019 10:00,3582,49.92,282,264,3300
26.02.2019 11:00,3590,43.95,207,199,3383
26.02.2019 12:00,3465,42.56,150,152,3315
26.02.2019 13:00,3276,42.21,95,117,3181
26.02.2019 14:00,3168,42.15,68,97,3100
26.02.2019 15:00,3114,42.14,57,77,3057
26.02.2019 16:00,3123,42.47,51,65,3072
26.02.2019 17:00,3176,45.86,53,59,3123
26.02.2019 18:00,3346,53.46,66,59,3280
26.02.2019 19:00,3420,58.17,79,61,3341
26.02.2019 20:00,3266,53.62,87,60,3179
26.02.2019 21:00,3036,42.69,89,59,2947
26.02.2019 22:00,2891,42.01,102,73,2789
26.02.2019 23:00,2737,40.9,117,98,2620
27.02.2019 00:00,2583,40.09,147,128,2436
27.02.2019 01:00,2584,39.61,308,307,2276
27.02.2019 02:00,2525,38.47,339,331,2186
27.02.2019 03:00,2528,37.66,380,363,2148
27.02.2019 04:00,2565,37.46,422,401,2143
27.02.2019 05:00,2623,39.16,473,442,2150
27.02.2019 06:00,2832,40.96,513,478,2319
27.02.2019 07:00,3278,42.74,528,510,2750
27.02.2019 08:00,3534,51.84,535,520,2999
27.02.2019 09:00,3604,49.83,528,504,3076
27.02.2019 10:00,3574,48.41,502,479,3072
27.02.2019 11:00,3548,43.5,462,469,3086
27.02.2019 12:00,3473,41.11,437,481,3036
27.02.2019 13:00,3338,40.02,433,504,2905
27.02.2019 14:00,3285,39.9,424,532,2861
27.02.2019 15:00,3193,40.36,468,555,2725
27.02.2019 16:00,3199,40.92,498,580,2701
27.02.2019 17:00,3227,42.59,534,620,2693
27.02.2019 18:00,3408,43.34,611,676,2797
27.02.2019 19:00,3509,43.42,692,729,2817
27.02.2019 20:00,3362,42.56,784,762,2578
27.02.2019 21:00,3190,41.28,785,772,2405
27.02.2019 22:00,2921,40.58,797,767,2124
27.02.2019 23:00,2729,39.81,781,733,1948
28.02.2019 00:00,2583,36.21,762,687,1821
28.02.2019 01:00,2533,34.05,766,750,1767
28.02.2019 02:00,2550,30.41,746,703,1804
28.02.2019 03:00,2586,29.8,692,667,1894
28.02.2019 04:00,2646,28.29,635,644,2011
28.02.2019 05:00,2680,34.17,618,638,2062
28.02.2019 06:00,2830,37.85,614,636,2216
28.02.2019 07:00,3188,41.43,612,632,2576
28.02.2019 08:00,3509,44.89,596,596,2913
28.02.2019 09:00,3668,46.33,530,544,3138
28.02.2019 10:00,3580,42.7,487,510,3093
28.02.2019 11:00,3459,42.47,462,506,2997
28.02.2019 12:00,3315,41.49,466,519,2849
28.02.2019 13:00,3228,41.38,465,531,2763
28.02.2019 14:00,3106,41.45,456,526,2650
28.02.2019 15:00,3025,41.61,442,512,2583
28.02.2019 16:00,3046,41.7,420,489,2626
28.02.2019 17:00,3106,42.73,401,453,2705
28.02.2019 18:00,3396,46.88,380,416,3016
28.02.2019 19:00,3574,49.74,371,391,3203
28.02.2019 20:00,3541,49.75,321,346,3220
28.02.2019 21:00,3366,43.78,280,291,3086
28.02.2019 22:00,3232,43.14,234,250,2998
28.02.2019 23:00,3059,42.6,199,222,2860
03.01.2019 00:00,2909,41.44,174,199,2735
03.01.2019 01:00,2860,41.46,160,165,2700
03.01.2019 02:00,2849,40.85,127,132,2722
03.01.2019 03:00,2842,40.69,102,107,2740
03.01.2019 04:00,2866,41.02,82,93,2784
03.01.2019 05:00,2924,41.92,74,88,2850
03.01.2019 06:00,3169,43.39,81,93,3088
03.01.2019 07:00,3602,45.3,90,100,3512
03.01.2019 08:00,3832,47.98,91,94,3741
03.01.2019 09:00,3825,49.99,78,83,3747
03.01.2019 10:00,3781,50.28,72,77,3709
03.01.2019 11:00,3729,51.15,72,77,3657
03.01.2019 12:00,3582,50.97,67,81,3515
03.01.2019 13:00,3466,48.56,60,85,3406
03.01.2019 14:00,3374,46.26,54,78,3320
03.01.2019 15:00,3297,45.79,45,63,3252
03.01.2019 16:00,3280,45.55,38,50,3242
03.01.2019 17:00,3292,45.8,36,42,3256
03.01.2019 18:00,3459,50.79,44,40,3415
03.01.2019 19:00,3594,52.59,55,52,3539
03.01.2019 20:00,3470,51.23,68,65,3402
03.01.2019 21:00,3314,47.49,86,82,3228
03.01.2019 22:00,3199,45.04,117,106,3082
03.01.2019 23:00,3034,44.19,153,134,2881
03.02.2019 00:00,2843,43.35,202,170,2641
03.02.2019 01:00,2717,43.13,287,289,2430
03.02.2019 02:00,2666,42.24,319,323,2347
03.02.2019 03:00,2638,41.09,339,343,2299
03.02.2019 04:00,2668,39.49,357,353,2311
03.02.2019 05:00,2718,39.59,353,352,2365
03.02.2019 06:00,2835,39.97,355,344,2480
03.02.2019 07:00,2970,40.48,342,335,2628
03.02.2019 08:00,3049,41.16,325,326,2724
03.02.2019 09:00,3238,41.64,311,316,2927
03.02.2019 10:00,3315,41.93,318,322,2997
03.02.2019 11:00,3429,42.36,341,334,3088
03.02.2019 12:00,3382,41.98,361,359,3021
03.02.2019 13:00,3377,41.84,387,387,2990
03.02.2019 14:00,3333,40.21,417,419,2916
03.02.2019 15:00,3233,39.26,422,444,2811
03.02.2019 16:00,3198,39.18,436,470,2762
03.02.2019 17:00,3228,40.97,470,476,2758
03.02.2019 18:00,3299,43.78,468,470,2831
03.02.2019 19:00,3350,44.77,486,468,2864
03.02.2019 20:00,3182,43.22,490,468,2692
03.02.2019 21:00,2954,40.47,492,467,2462
03.02.2019 22:00,2835,40.06,482,464,2353
03.02.2019 23:00,2750,39.77,497,463,2253
03.03.2019 00:00,2576,37.77,515,470,2061
03.03.2019 01:00,2568,38.89,625,629,1943
03.03.2019 02:00,2501,37.48,659,660,1842
03.03.2019 03:00,2485,37.29,691,703,1794
03.03.2019 04:00,2473,37.74,751,742,1722
03.03.2019 05:00,2445,38.57,804,777,1641
03.03.2019 06:00,2421,38.86,839,805,1582
03.03.2019 07:00,2459,37.33,875,838,1584
03.03.2019 08:00,2516,39.12,930,900,1586
03.03.2019 09:00,2635,40.21,1000,982,1635
03.03.2019 10:00,2738,41.03,1053,1046,1685
03.03.2019 11:00,2809,41.42,1096,1073,1713
03.03.2019 12:00,2857,40.99,1058,1087,1799
03.03.2019 13:00,2792,40.65,1024,1093,1768
03.03.2019 14:00,2639,40.23,985,1066,1654
03.03.2019 15:00,2617,39.87,944,1006,1673
03.03.2019 16:00,2691,39.68,875,928,1816
03.03.2019 17:00,2770,40.29,807,851,1963
03.03.2019 18:00,3032,41.79,748,792,2284
03.03.2019 19:00,3316,42.92,723,744,2593
03.03.2019 20:00,3260,43.12,668,696,2592
03.03.2019 21:00,3137,42.68,609,636,2528
03.03.2019 22:00,2929,41.62,551,570,2378
03.03.2019 23:00,2706,40.94,488,493,2218
03.04.2019 00:00,2679,40.32,403,415,2276
03.04.2019 01:00,2582,39.78,302,319,2280
03.04.2019 02:00,2607,39.3,270,316,2337
03.04.2019 03:00,2560,39.32,305,356,2255
03.04.2019 04:00,2500,39.51,403,423,2097
03.04.2019 05:00,2516,40.7,488,521,2028
03.04.2019 06:00,2774,41.48,582,637,2192
03.04.2019 07:00,3225,42.32,720,748,2505
03.04.2019 08:00,3396,42.94,775,790,2621
03.04.2019 09:00,3579,44.03,741,776,2838
03.04.2019 10:00,3658,44.4,747,753,2911
03.04.2019 11:00,3747,44.3,782,754,2965
03.04.2019 12:00,3712,43.79,784,760,2928
03.04.2019 13:00,3601,42.95,833,784,2768
03.04.2019 14:00,3712,42.87,869,843,2843
03.04.2019 15:00,3761,42.83,928,941,2833
03.04.2019 16:00,3695,42.85,1033,1039,2662
03.04.2019 17:00,3622,42.88,1120,1094,2502
03.04.2019 18:00,3661,43.22,1129,1121,2532
03.04.2019 19:00,3805,43.1,1144,1152,2661
03.04.2019 20:00,3749,43.02,1147,1160,2602
03.04.2019 21:00,3611,41.61,1108,1146,2503
03.04.2019 22:00,3450,40.75,1054,1119,2396
03.04.2019 23:00,3267,39.46,1006,1084,2261
03.05.2019 00:00,3092,37.06,982,1046,2110
03.05.2019 01:00,2846,37.81,854,861,1992
03.05.2019 02:00,2762,36.08,826,820,1936
03.05.2019 03:00,2722,36,813,787,1909
03.05.2019 04:00,2632,36.06,782,756,1850
03.05.2019 05:00,2672,38.16,773,752,1899
03.05.2019 06:00,2857,40.55,790,791,2067
03.05.2019 07:00,3312,42.28,791,839,2521
03.05.2019 08:00,3684,44.24,766,829,2918
03.05.2019 09:00,3837,44.68,725,773,3112
03.05.2019 10:00,3832,44.73,646,699,3186
03.05.2019 11:00,3908,44.71,576,609,3332
03.05.2019 12:00,3926,44.39,496,513,3430
03.05.2019 13:00,3871,43.99,425,431,3446
03.05.2019 14:00,3844,43.79,345,358,3499
03.05.2019 15:00,3803,43.77,282,291,3521
03.05.2019 16:00,3766,44.38,248,238,3518
03.05.2019 17:00,3693,46.09,221,197,3472
03.05.2019 18:00,3783,49.27,196,165,3587
03.05.2019 19:00,3817,55.01,208,149,3609
03.05.2019 20:00,3737,52.57,160,131,3577
03.05.2019 21:00,3648,47.74,120,127,3528
03.05.2019 22:00,3454,46.41,112,129,3342
03.05.2019 23:00,3256,44.75,110,136,3146
03.06.2019 00:00,3010,42.79,116,139,2894
03.06.2019 01:00,2943,43.07,137,150,2806
03.06.2019 02:00,2962,42.75,143,162,2819
03.06.2019 03:00,2960,42.51,147,172,2813
03.06.2019 04:00,2945,42.58,152,174,2793
03.06.2019 05:00,2919,43.44,146,169,2773
03.06.2019 06:00,3065,44.81,157,163,2908
03.06.2019 07:00,3430,45.48,166,164,3264
03.06.2019 08:00,3689,47.53,181,182,3508
03.06.2019 09:00,3808,47.79,213,214,3595
03.06.2019 10:00,3790,47.8,268,259,3522
03.06.2019 11:00,3790,47.41,294,312,3496
03.06.2019 12:00,3754,46.84,324,358,3430
03.06.2019 13:00,3682,46.32,360,402,3322
03.06.2019 14:00,3665,46.07,403,436,3262
03.06.2019 15:00,3646,45.63,432,465,3214
03.06.2019 16:00,3660,45.04,459,499,3201
03.06.2019 17:00,3680,45.35,505,552,3175
03.06.2019 18:00,3717,45.73,589,611,3128
03.06.2019 19:00,3696,45.88,673,673,3023
03.06.2019 20:00,3602,44.98,742,725,2860
03.06.2019 21:00,3483,43.99,780,760,2703
03.06.2019 22:00,3300,43.03,794,778,2506
03.06.2019 23:00,3041,40.58,792,772,2249
03.07.2019 00:00,2815,39.39,776,748,2039
03.07.2019 01:00,2725,39.54,979,950,1746
03.07.2019 02:00,2713,37.55,938,910,1775
03.07.2019 03:00,2666,37.41,880,862,1786
03.07.2019 04:00,2700,38.05,818,813,1882
03.07.2019 05:00,2762,40.86,779,773,1983
03.07.2019 06:00,2945,43.11,714,732,2231
03.07.2019 07:00,3341,44.79,652,694,2689
03.07.2019 08:00,3690,47.02,624,656,3066
03.07.2019 09:00,3763,47.88,578,615,3185
03.07.2019 10:00,3801,47.61,522,584,3279
03.07.2019 11:00,3777,47.45,488,565,3289
03.07.2019 12:00,3775,46.69,528,560,3247
03.07.2019 13:00,3713,45.91,532,569,3181
03.07.2019 14:00,3674,45.54,598,631,3076
03.07.2019 15:00,3660,44.91,734,731,2926
03.07.2019 16:00,3515,44.42,899,834,2616
03.07.2019 17:00,3377,43.99,1035,944,2342
03.07.2019 18:00,3471,44.7,1122,1048,2349
03.07.2019 19:00,3636,45.02,1181,1120,2455
03.07.2019 20:00,3663,45.01,1146,1149,2517
03.07.2019 21:00,3577,41.68,1167,1141,2410
03.07.2019 22:00,3317,40.65,1115,1126,2202
03.07.2019 23:00,3112,39.61,1148,1130,1964
03.08.2019 00:00,2881,35.93,1159,1143,1722
03.08.2019 01:00,2767,33.54,1157,1152,1610
03.08.2019 02:00,2688,32.06,1181,1173,1507
03.08.2019 03:00,2580,31.07,1205,1196,1375
03.08.2019 04:00,2600,32.03,1218,1211,1382
03.08.2019 05:00,2625,33.97,1215,1205,1410
03.08.2019 06:00,2748,38.03,1177,1170,1571
03.08.2019 07:00,3102,40.78,1123,1121,1979
03.08.2019 08:00,3412,42.3,1117,1109,2295
03.08.2019 09:00,3538,42.06,1108,1117,2430
03.08.2019 10:00,3546,41.78,1128,1148,2418
03.08.2019 11:00,3576,41.45,1169,1207,2407
03.08.2019 12:00,3611,40.82,1240,1280,2371
03.08.2019 13:00,3485,40.54,1277,1330,2208
03.08.2019 14:00,3363,39.97,1318,1371,2045
03.08.2019 15:00,3232,39.32,1359,1404,1873
03.08.2019 16:00,3239,38.54,1403,1431,1836
03.08.2019 17:00,3294,39.29,1421,1449,1873
03.08.2019 18:00,3471,42.13,1444,1452,2027
03.08.2019 19:00,3646,44.07,1449,1462,2197
03.08.2019 20:00,3553,43.9,1435,1455,2118
03.08.2019 21:00,3467,41.58,1401,1437,2066
03.08.2019 22:00,3348,40.57,1328,1409,2020
03.08.2019 23:00,3176,39.24,1287,1363,1889
03.09.2019 00:00,3054,30.61,1199,1293,1855
03.09.2019 01:00,2871,38.05,993,993,1878
03.09.2019 02:00,2788,36.3,892,919,1896
03.09.2019 03:00,2750,35.84,837,871,1913
03.09.2019 04:00,2736,36.21,825,832,1911
03.09.2019 05:00,2805,37.36,829,847,1976
03.09.2019 06:00,2862,38.31,873,901,1989
03.09.2019 07:00,2948,37.66,917,960,2031
03.09.2019 08:00,3070,38.9,995,1027,2075
03.09.2019 09:00,3314,39.11,1065,1101,2249
03.09.2019 10:00,3573,39.9,1127,1172,2446
03.09.2019 11:00,3616,39.82,1158,1225,2458
03.09.2019 12:00,3482,39.63,1212,1259,2270
03.09.2019 13:00,3311,38.93,1249,1287,2062
03.09.2019 14:00,3341,38.11,1307,1316,2034
03.09.2019 15:00,3241,38,1347,1329,1894
03.09.2019 16:00,3091,37.84,1368,1334,1723
03.09.2019 17:00,3111,38.45,1377,1348,1734
03.09.2019 18:00,3219,39.59,1375,1357,1844
03.09.2019 19:00,3444,40.79,1368,1358,2076
03.09.2019 20:00,3385,39.61,1353,1337,2032
03.09.2019 21:00,3202,38.27,1334,1293,1868
03.09.2019 22:00,2993,37.25,1291,1234,1702
03.09.2019 23:00,2857,36.4,1235,1172,1622
03.10.2019 00:00,2735,35.23,1158,1095,1577
03.10.2019 01:00,2761,35.71,1171,1159,1590
03.10.2019 02:00,2702,33.92,1070,1051,1632
03.10.2019 03:00,2702,33.14,993,966,1709
03.10.2019 04:00,2730,34.08,929,907,1801
03.10.2019 05:00,2669,35.72,921,895,1748
03.10.2019 06:00,2684,37.24,923,896,1761
03.10.2019 07:00,2841,37,937,900,1904
03.10.2019 08:00,2886,38.96,891,878,1995
03.10.2019 09:00,3075,38.35,819,841,2256
03.10.2019 10:00,3089,39.09,759,804,2330
03.10.2019 11:00,3101,39.9,690,754,2411
03.10.2019 12:00,3141,40.17,628,682,2513
03.10.2019 13:00,3098,38.76,562,606,2536
03.10.2019 14:00,3067,39.75,464,532,2603
03.10.2019 15:00,3024,39.91,398,456,2626
03.10.2019 16:00,3064,39.27,349,384,2715
03.10.2019 17:00,3133,41.34,267,321,2866
03.10.2019 18:00,3294,43.51,250,280,3044
03.10.2019 19:00,3482,44.36,257,275,3225
03.10.2019 20:00,3422,44.08,303,290,3119
03.10.2019 21:00,3287,42.89,323,312,2964
03.10.2019 22:00,3125,41.57,360,330,2765
03.10.2019 23:00,2995,41.24,379,342,2616
03.11.2019 00:00,2912,38.11,373,351,2539
03.11.2019 01:00,2864,40.78,351,349,2513
03.11.2019 02:00,2866,39.35,351,345,2515
03.11.2019 03:00,2852,39.52,363,348,2489
03.11.2019 04:00,2909,40.32,359,349,2550
03.11.2019 05:00,3054,42.16,331,326,2723
03.11.2019 06:00,3241,43.96,298,289,2943
03.11.2019 07:00,3647,45.63,257,255,3390
03.11.2019 08:00,3984,47.96,209,214,3775
03.11.2019 09:00,4035,49.11,171,177,3864
03.11.2019 10:00,3853,48.09,151,164,3702
03.11.2019 11:00,3790,47.05,156,192,3634
03.11.2019 12:00,3703,46.3,196,250,3507
03.11.2019 13:00,3560,45.7,247,323,3313
03.11.2019 14:00,3464,45.43,308,398,3156
03.11.2019 15:00,3388,45.05,377,462,3011
03.11.2019 16:00,3348,44.87,438,511,2910
03.11.2019 17:00,3190,45,455,514,2735
03.11.2019 18:00,3454,46.56,505,485,2949
03.11.2019 19:00,3795,49.08,485,472,3310
03.11.2019 20:00,3822,48.94,447,444,3375
03.11.2019 21:00,3752,47.73,401,407,3351
03.11.2019 22:00,3532,46.38,361,372,3171
03.11.2019 23:00,3319,46.08,328,342,2991
03.12.2019 00:00,3112,44.01,298,317,2814
03.12.2019 01:00,2963,42.69,253,276,2710
03.12.2019 02:00,2990,42.23,233,260,2757
03.12.2019 03:00,2988,42.16,223,245,2765
03.12.2019 04:00,2907,41.99,213,239,2694
03.12.2019 05:00,2965,42.81,205,227,2760
03.12.2019 06:00,3142,44.19,222,211,2920
03.12.2019 07:00,3562,46.83,206,195,3356
03.12.2019 08:00,3845,52.05,175,158,3670
03.12.2019 09:00,3939,52.07,143,122,3796
03.12.2019 10:00,3814,49.8,130,107,3684
03.12.2019 11:00,3806,48.66,124,118,3682
03.12.2019 12:00,3752,47.33,155,150,3597
03.12.2019 13:00,3608,46.18,217,204,3391
03.12.2019 14:00,3558,45.28,279,280,3279
03.12.2019 15:00,3517,44.96,389,371,3128
03.12.2019 16:00,3540,44.69,498,481,3042
03.12.2019 17:00,3510,44.55,588,607,2922
03.12.2019 18:00,3683,44.76,737,739,2946
03.12.2019 19:00,3751,45.1,881,871,2870
03.12.2019 20:00,3735,44.93,1000,969,2735
03.12.2019 21:00,3602,43.93,1074,1042,2528
03.12.2019 22:00,3379,43.57,1099,1103,2280
03.12.2019 23:00,3132,41.51,1136,1149,1996
13.03.2019 00:00,2943,37.81,1149,1179,1794
13.03.2019 01:00,2915,37.05,1214,1216,1701
13.03.2019 02:00,2954,35.4,1214,1209,1740
13.03.2019 03:00,2905,35.07,1188,1182,1717
13.03.2019 04:00,2828,35.42,1156,1140,1672
13.03.2019 05:00,2819,38.31,1090,1068,1729
13.03.2019 06:00,3010,40.3,996,978,2014
13.03.2019 07:00,3372,42.13,928,914,2444
13.03.2019 08:00,3641,43.69,889,905,2752
13.03.2019 09:00,3685,44.34,928,923,2757
13.03.2019 10:00,3721,44.18,963,949,2758
13.03.2019 11:00,3740,43.82,994,984,2746
13.03.2019 12:00,3725,43.47,1035,1019,2690
13.03.2019 13:00,3720,43.16,1092,1058,2628
13.03.2019 14:00,3695,42.96,1120,1082,2575
13.03.2019 15:00,3686,42.9,1116,1078,2570
13.03.2019 16:00,3649,42.9,1085,1067,2564
13.03.2019 17:00,3606,43.13,1075,1048,2531
13.03.2019 18:00,3627,43.94,1047,1023,2580
13.03.2019 19:00,3654,44.35,1022,1001,2632
13.03.2019 20:00,3524,43.98,992,948,2532
13.03.2019 21:00,3306,42.38,891,874,2415
13.03.2019 22:00,3194,41.27,845,794,2349
13.03.2019 23:00,2994,39.16,724,693,2270
14.03.2019 00:00,2888,37.7,565,580,2323
14.03.2019 01:00,2787,35.18,395,439,2392
14.03.2019 02:00,2819,34.1,318,379,2501
14.03.2019 03:00,2809,34.42,335,379,2474
14.03.2019 04:00,2782,35.03,375,415,2407
14.03.2019 05:00,2729,37.55,429,461,2300
14.03.2019 06:00,2766,41,471,498,2295
14.03.2019 07:00,3182,41.89,492,503,2690
14.03.2019 08:00,3696,43.93,482,481,3214
14.03.2019 09:00,3817,45.03,471,474,3346
14.03.2019 10:00,3802,44.7,449,481,3353
14.03.2019 11:00,3762,44.25,435,482,3327
14.03.2019 12:00,3682,43.62,433,474,3249
14.03.2019 13:00,3596,43.44,457,470,3139
14.03.2019 14:00,3554,43.06,479,487,3075
14.03.2019 15:00,3555,42.94,515,503,3040
14.03.2019 16:00,3531,42.92,514,516,3017
14.03.2019 17:00,3570,42.94,524,511,3046
14.03.2019 18:00,3683,43.72,481,493,3202
14.03.2019 19:00,3796,44.3,463,465,3333
14.03.2019 20:00,3763,43.65,415,420,3348
14.03.2019 21:00,3592,42.93,342,378,3250
14.03.2019 22:00,3412,42.07,303,344,3109
14.03.2019 23:00,3169,41.32,270,313,2899
15.03.2019 00:00,2955,40.4,248,289,2707
15.03.2019 01:00,2801,41.06,155,169,2646
15.03.2019 02:00,2740,40.31,133,158,2607
15.03.2019 03:00,2714,40.43,120,158,2594
15.03.2019 04:00,2712,40.89,128,171,2584
15.03.2019 05:00,2757,41.23,176,212,2581
15.03.2019 06:00,2934,42.09,221,284,2713
15.03.2019 07:00,3275,43.12,310,367,2965
15.03.2019 08:00,3578,44.99,354,417,3224
15.03.2019 09:00,3652,45.17,399,437,3253
15.03.2019 10:00,3692,44.95,402,446,3290
15.03.2019 11:00,3720,44.65,368,436,3352
15.03.2019 12:00,3720,44.23,308,413,3412
15.03.2019 13:00,3696,43.88,293,402,3403
15.03.2019 14:00,3625,43.5,325,410,3300
15.03.2019 15:00,3563,43.14,381,425,3182
15.03.2019 16:00,3470,43.02,439,435,3031
15.03.2019 17:00,3431,43.12,456,405,2975
15.03.2019 18:00,3542,43.35,453,358,3089
15.03.2019 19:00,3632,43.71,453,329,3179
15.03.2019 20:00,3475,42.94,460,311,3015
15.03.2019 21:00,3264,42.24,414,327,2850
15.03.2019 22:00,3024,41.53,437,362,2587
15.03.2019 23:00,2896,41.37,453,417,2443
16.03.2019 00:00,2857,40.74,472,471,2385
16.03.2019 01:00,2737,40.88,549,548,2188
16.03.2019 02:00,2642,40.3,538,564,2104
16.03.2019 03:00,2637,40.09,575,594,2062
16.03.2019 04:00,2547,39.99,612,632,1935
16.03.2019 05:00,2517,40.66,675,673,1842
16.03.2019 06:00,2589,40.41,710,703,1879
16.03.2019 07:00,2681,40.4,723,728,1958
16.03.2019 08:00,2755,40.81,732,739,2023
16.03.2019 09:00,2910,40.79,751,749,2159
16.03.2019 10:00,3025,41.48,779,770,2246
16.03.2019 11:00,2999,41.8,766,778,2233
16.03.2019 12:00,3015,41.41,735,764,2280
16.03.2019 13:00,2993,40.14,706,733,2287
16.03.2019 14:00,2951,38.57,622,661,2329
16.03.2019 15:00,2937,38.57,513,560,2424
16.03.2019 16:00,2922,40.28,436,453,2486
16.03.2019 17:00,2992,41.15,377,374,2615
16.03.2019 18:00,3094,42.01,360,348,2734
16.03.2019 19:00,3210,42.9,380,366,2830
16.03.2019 20:00,3132,42.32,428,391,2704
16.03.2019 21:00,2974,41.33,453,402,2521
16.03.2019 22:00,2800,41.06,471,419,2329
16.03.2019 23:00,2596,40.65,493,462,2103
17.03.2019 00:00,2465,39.83,571,532,1894
17.03.2019 01:00,2429,36.45,736,368,1693
17.03.2019 02:00,2416,35.68,823,406,1593
17.03.2019 03:00,2373,35.07,915,445,1458
17.03.2019 04:00,2395,34.04,1016,488,1379
17.03.2019 05:00,2476,34.17,1098,524,1378
17.03.2019 06:00,2498,33.56,1120,549,1378
17.03.2019 07:00,2492,31.34,1143,569,1349
17.03.2019 08:00,2583,31.9,1179,587,1404
17.03.2019 09:00,2752,34.75,1213,606,1539
17.03.2019 10:00,2983,37.28,1217,618,1766
17.03.2019 11:00,3033,37.26,1186,617,1847
17.03.2019 12:00,2984,35.97,1173,605,1811
17.03.2019 13:00,2961,35.1,1206,588,1755
17.03.2019 14:00,2909,35.13,1217,593,1692
17.03.2019 15:00,2862,34.83,1239,596,1623
17.03.2019 16:00,2872,34.76,1259,435,1613
17.03.2019 17:00,2907,35.16,1255,408,1652
17.03.2019 18:00,3061,37.34,1271,235,1790
17.03.2019 19:00,3211,39.9,1293,239,1918
17.03.2019 20:00,3272,38.31,1326,247,1946
17.03.2019 21:00,3148,35.15,1355,254,1793
17.03.2019 22:00,3068,34.36,1383,262,1685
17.03.2019 23:00,2935,31.88,1406,270,1529
18.03.2019 00:00,2814,23.19,1418,275,1396
18.03.2019 01:00,2771,30.56,1434,196,1337
18.03.2019 02:00,2747,29.1,1433,198,1314
18.03.2019 03:00,2759,27.57,1433,199,1326
18.03.2019 04:00,2761,29.04,1424,199,1337
18.03.2019 05:00,2816,36.42,1402,199,1414
18.03.2019 06:00,2882,40.97,1367,195,1515
18.03.2019 07:00,3335,42.64,1316,192,2019
18.03.2019 08:00,3739,44.91,1276,185,2463
18.03.2019 09:00,3786,44.22,1222,178,2564
18.03.2019 10:00,3758,43.21,1168,171,2590
18.03.2019 11:00,3684,42.88,1086,163,2598
18.03.2019 12:00,3619,42.44,1031,155,2588
18.03.2019 13:00,3525,42.33,982,147,2543
18.03.2019 14:00,3512,42.32,957,142,2555
18.03.2019 15:00,3485,42.16,931,137,2554
18.03.2019 16:00,3517,42.09,903,131,2614
18.03.2019 17:00,3488,42.19,843,123,2645
18.03.2019 18:00,3521,43.04,769,113,2752
18.03.2019 19:00,3690,44.65,666,97,3024
18.03.2019 20:00,3787,45.03,583,86,3204
18.03.2019 21:00,3668,44.25,559,80,3109
18.03.2019 22:00,3508,42.96,541,75,2967
18.03.2019 23:00,3237,41.7,533,72,2704
19.03.2019 00:00,3083,36.77,504,70,2579
19.03.2019 01:00,2930,39.08,503,521,2427
19.03.2019 02:00,2865,38.49,499,505,2366
19.03.2019 03:00,2889,37.45,481,481,2408
19.03.2019 04:00,2958,36.47,456,456,2502
19.03.2019 05:00,3012,40.39,418,430,2594
19.03.2019 06:00,3177,42.76,394,403,2783
19.03.2019 07:00,3544,45.46,361,375,3183
19.03.2019 08:00,3798,51.27,318,335,3480
19.03.2019 09:00,3755,54.38,294,294,3461
19.03.2019 10:00,3477,49.69,242,275,3235
19.03.2019 11:00,3291,46.31,244,285,3047
19.03.2019 12:00,3317,44.93,281,316,3036
19.03.2019 13:00,3322,44.38,312,352,3010
19.03.2019 14:00,3301,43.95,319,377,2982
19.03.2019 15:00,3230,43.75,327,389,2903
19.03.2019 16:00,3173,43.88,332,385,2841
19.03.2019 17:00,3138,44.61,331,344,2807
19.03.2019 18:00,3368,48.96,298,288,3070
19.03.2019 19:00,3591,55.17,265,254,3326
19.03.2019 20:00,3636,59.27,226,235,3410
19.03.2019 21:00,3550,50.87,213,217,3337
19.03.2019 22:00,3374,45.35,241,213,3133
19.03.2019 23:00,3156,43.71,292,226,2864
20.03.2019 00:00,2879,42.09,343,254,2536
20.03.2019 01:00,2876,40.88,410,403,2466
20.03.2019 02:00,2827,38.96,437,450,2390
20.03.2019 03:00,2757,35.05,483,503,2274
20.03.2019 04:00,2770,34.33,543,564,2227
20.03.2019 05:00,2811,37.96,614,643,2197
20.03.2019 06:00,3059,41.05,700,737,2359
20.03.2019 07:00,3470,42.59,794,833,2676
20.03.2019 08:00,3804,44.1,854,903,2950
20.03.2019 09:00,3855,43.85,890,952,2965
20.03.2019 10:00,3789,42.88,937,996,2852
20.03.2019 11:00,3716,42.13,934,1012,2782
20.03.2019 12:00,3665,41.54,928,1008,2737
20.03.2019 13:00,3564,41.07,922,986,2642
20.03.2019 14:00,3467,40.93,844,936,2623
20.03.2019 15:00,3445,41.03,863,874,2582
20.03.2019 16:00,3443,41.36,786,803,2657
20.03.2019 17:00,3389,42.1,735,731,2654
20.03.2019 18:00,3478,43.66,631,659,2847
20.03.2019 19:00,3552,44.96,586,608,2966
20.03.2019 20:00,3483,43.83,563,572,2920
20.03.2019 21:00,3305,43.14,523,541,2782
20.03.2019 22:00,3116,42.28,518,511,2598
20.03.2019 23:00,2897,41.23,511,491,2386
21.03.2019 00:00,2702,39.51,503,473,2199
21.03.2019 01:00,2639,36.94,503,498,2136
21.03.2019 02:00,2600,34.7,486,490,2114
21.03.2019 03:00,2538,33.51,508,506,2030
21.03.2019 04:00,2470,33.04,544,525,1926
21.03.2019 05:00,2514,34.56,567,555,1947
21.03.2019 06:00,2695,39.24,609,603,2086
21.03.2019 07:00,2995,41.12,677,659,2318
21.03.2019 08:00,3292,42.69,754,711,2538
21.03.2019 09:00,3383,43.33,780,759,2603
21.03.2019 10:00,3363,41.28,846,807,2517
21.03.2019 11:00,3361,40.08,886,860,2475
21.03.2019 12:00,3384,39.41,910,916,2474
21.03.2019 13:00,3293,39.22,958,965,2335
21.03.2019 14:00,3268,38.97,988,991,2280
21.03.2019 15:00,3323,38.91,1000,992,2323
21.03.2019 16:00,3305,38.88,973,980,2332
21.03.2019 17:00,3303,39.85,958,960,2345
21.03.2019 18:00,3413,41.15,925,930,2488
21.03.2019 19:00,3490,41.99,910,893,2580
21.03.2019 20:00,3416,41.72,874,850,2542
21.03.2019 21:00,3215,40.99,823,804,2392
21.03.2019 22:00,3044,39.82,768,747,2276
21.03.2019 23:00,2856,38.03,694,664,2162
22.03.2019 00:00,2663,35.23,601,568,2062
22.03.2019 01:00,2547,35.68,475,440,2072
22.03.2019 02:00,2492,35.09,355,329,2137
22.03.2019 03:00,2525,35.81,263,224,2262
22.03.2019 04:00,2577,36.39,177,166,2400
22.03.2019 05:00,2654,38.17,118,126,2536
22.03.2019 06:00,2831,40.53,95,96,2736
22.03.2019 07:00,3161,42.95,90,80,3071
22.03.2019 08:00,3421,49.76,75,74,3346
22.03.2019 09:00,3478,48.02,81,81,3397
22.03.2019 10:00,3419,44.15,80,95,3339
22.03.2019 11:00,3339,41.73,59,120,3280
22.03.2019 12:00,3258,40.59,108,159,3150
22.03.2019 13:00,3195,40.07,146,208,3049
22.03.2019 14:00,3152,39.33,224,252,2928
22.03.2019 15:00,3067,38.68,269,293,2798
22.03.2019 16:00,2996,38.48,311,335,2685
22.03.2019 17:00,2997,39.17,369,372,2628
22.03.2019 18:00,3152,41.14,407,408,2745
22.03.2019 19:00,3232,41.85,455,455,2777
22.03.2019 20:00,3191,40.76,482,488,2709
22.03.2019 21:00,3005,39.47,511,516,2494
22.03.2019 22:00,2845,38.3,548,540,2297
22.03.2019 23:00,2723,36.3,571,557,2152
23.03.2019 00:00,2600,34.16,580,563,2020
23.03.2019 01:00,2542,34.67,579,629,1963
23.03.2019 02:00,2535,33.1,605,640,1930
23.03.2019 03:00,2523,30.09,629,649,1894
23.03.2019 04:00,2485,30.51,606,643,1879
23.03.2019 05:00,2486,31.78,574,622,1912
23.03.2019 06:00,2507,32.97,570,588,1937
23.03.2019 07:00,2513,33.81,570,561,1943
23.03.2019 08:00,2612,36.54,554,555,2058
23.03.2019 09:00,2731,37.5,563,567,2168
23.03.2019 10:00,2880,37.38,599,603,2281
23.03.2019 11:00,2867,34.53,657,670,2210
23.03.2019 12:00,2804,31.95,716,754,2088
23.03.2019 13:00,2715,29.82,790,845,1925
23.03.2019 14:00,2626,29.06,883,935,1743
23.03.2019 15:00,2617,28.25,955,1008,1662
23.03.2019 16:00,2608,29.52,1002,1054,1606
23.03.2019 17:00,2630,31.38,1022,1048,1608
23.03.2019 18:00,2441,36.51,978,1009,1463
23.03.2019 19:00,2761,38.74,939,981,1822
23.03.2019 20:00,3058,38.22,943,977,2115
23.03.2019 21:00,2959,36.62,955,988,2004
23.03.2019 22:00,2801,33.76,977,997,1824
23.03.2019 23:00,2689,31.13,978,985,1711
24.03.2019 00:00,2611,30.24,956,950,1655
24.03.2019 01:00,2525,31.5,891,891,1634
24.03.2019 02:00,2517,30.1,833,831,1684
24.03.2019 03:00,2525,31.29,763,761,1762
24.03.2019 04:00,2497,32.2,686,688,1811
24.03.2019 05:00,2462,33.03,638,619,1824
24.03.2019 06:00,2576,33.38,552,558,2024
24.03.2019 07:00,2562,33.5,499,500,2063
24.03.2019 08:00,2641,34.98,453,452,2188
24.03.2019 09:00,2794,36.6,447,433,2347
24.03.2019 10:00,2985,35.81,443,451,2542
24.03.2019 11:00,3017,33.78,462,504,2555
24.03.2019 12:00,3034,32.01,514,577,2520
24.03.2019 13:00,2937,31.1,559,647,2378
24.03.2019 14:00,2815,25.54,618,707,2197
24.03.2019 15:00,2751,25.69,677,756,2074
24.03.2019 16:00,2775,30.6,720,792,2055
24.03.2019 17:00,2848,31.57,735,793,2113
24.03.2019 18:00,2906,34.85,707,762,2199
24.03.2019 19:00,3091,39.21,690,736,2401
24.03.2019 20:00,3166,40.45,675,729,2491
24.03.2019 21:00,3146,39.25,695,736,2451
24.03.2019 22:00,3009,36.42,686,746,2323
24.03.2019 23:00,2781,34.94,668,755,2113
25.03.2019 00:00,2634,34.77,643,753,1991
25.03.2019 01:00,2618,26.26,558,582,2060
25.03.2019 02:00,2613,27.23,507,526,2106
25.03.2019 03:00,2590,26.82,442,452,2148
25.03.2019 04:00,2577,29.04,377,378,2200
25.03.2019 05:00,2624,33.28,309,308,2315
25.03.2019 06:00,2805,38.09,243,250,2562
25.03.2019 07:00,3184,39.42,183,203,3001
25.03.2019 08:00,3546,41.55,168,175,3378
25.03.2019 09:00,3660,42.95,150,171,3510
25.03.2019 10:00,3648,41.9,136,185,3512
25.03.2019 11:00,3629,41.2,164,218,3465
25.03.2019 12:00,3572,40.74,216,263,3356
25.03.2019 13:00,3457,39.98,260,316,3197
25.03.2019 14:00,3365,39.73,277,356,3088
25.03.2019 15:00,3278,39.4,296,387,2982
25.03.2019 16:00,3228,39.32,319,398,2909
25.03.2019 17:00,3038,39.5,340,360,2698
25.03.2019 18:00,3097,40.35,309,302,2788
25.03.2019 19:00,3309,41.71,300,268,3009
25.03.2019 20:00,3433,45.34,265,237,3168
25.03.2019 21:00,3308,41.84,218,212,3090
25.03.2019 22:00,3097,40.33,219,203,2878
25.03.2019 23:00,2914,39.99,246,220,2668
26.03.2019 00:00,2711,37.56,317,260,2394
26.03.2019 01:00,2560,33.25,441,450,2119
26.03.2019 02:00,2505,30.79,559,540,1946
26.03.2019 03:00,2441,30.07,655,632,1786
26.03.2019 04:00,2456,30.01,732,712,1724
26.03.2019 05:00,2537,30.03,767,740,1770
26.03.2019 06:00,2692,36.45,767,752,1925
26.03.2019 07:00,3108,39,747,764,2361
26.03.2019 08:00,3542,42.8,742,763,2800
26.03.2019 09:00,3504,42.75,732,759,2772
26.03.2019 10:00,3258,40.69,729,767,2529
26.03.2019 11:00,3222,41.44,704,749,2518
26.03.2019 12:00,3140,40.91,677,707,2463
26.03.2019 13:00,3045,40.91,655,656,2390
26.03.2019 14:00,3034,41.08,586,581,2448
26.03.2019 15:00,3035,40.65,500,487,2535
26.03.2019 16:00,3106,40.91,420,393,2686
26.03.2019 17:00,3133,41.43,346,312,2787
26.03.2019 18:00,3293,43.71,254,244,3039
26.03.2019 19:00,3442,48.05,214,202,3228
26.03.2019 20:00,3523,48.21,176,179,3347
26.03.2019 21:00,3392,43.04,149,161,3243
26.03.2019 22:00,3221,42.33,145,157,3076
26.03.2019 23:00,3029,40.87,162,178,2867
27.03.2019 00:00,2787,38.42,195,215,2592
27.03.2019 01:00,2628,36.62,244,253,2384
27.03.2019 02:00,2532,34.81,286,283,2246
27.03.2019 03:00,2449,34.27,328,320,2121
27.03.2019 04:00,2491,33.37,376,357,2115
27.03.2019 05:00,2509,34.14,404,366,2105
27.03.2019 06:00,2661,37.83,375,348,2286
27.03.2019 07:00,3002,41,356,326,2646
27.03.2019 08:00,3317,46,329,304,2988
27.03.2019 09:00,3373,45.91,310,286,3063
27.03.2019 10:00,3330,43.94,330,286,3000
27.03.2019 11:00,3327,41.48,315,275,3012
27.03.2019 12:00,3286,40.61,294,257,2992
27.03.2019 13:00,3235,40,292,241,2943
27.03.2019 14:00,3284,39.58,259,226,3025
27.03.2019 15:00,3158,38.75,241,210,2917
27.03.2019 16:00,3068,39.47,207,198,2861
27.03.2019 17:00,3019,39.18,200,182,2819
27.03.2019 18:00,3116,41.49,188,161,2928
27.03.2019 19:00,3210,43.22,176,147,3034
27.03.2019 20:00,3262,46.76,158,135,3104
27.03.2019 21:00,3167,41.09,131,124,3036
27.03.2019 22:00,2996,40.23,125,112,2871
27.03.2019 23:00,2819,38.96,114,100,2705
28.03.2019 00:00,2617,36.92,108,88,2509
28.03.2019 01:00,2548,32.73,118,121,2430
28.03.2019 02:00,2530,32.86,111,110,2419
28.03.2019 03:00,2537,32.58,108,100,2429
28.03.2019 04:00,2593,31.71,90,93,2503
28.03.2019 05:00,2632,33.12,87,90,2545
28.03.2019 06:00,2787,35.87,97,97,2690
28.03.2019 07:00,3102,43.41,110,110,2992
28.03.2019 08:00,3379,48.61,119,117,3260
28.03.2019 09:00,3410,48.54,97,111,3313
28.03.2019 10:00,3370,45.65,92,105,3278
28.03.2019 11:00,3303,43.06,105,123,3198
28.03.2019 12:00,3317,42.32,135,160,3182
28.03.2019 13:00,3275,41.52,179,207,3096
28.03.2019 14:00,3255,41.37,219,257,3036
28.03.2019 15:00,3217,42.02,270,299,2947
28.03.2019 16:00,3226,43.03,308,347,2918
28.03.2019 17:00,3178,36.94,380,395,2798
28.03.2019 18:00,3180,36.9,426,444,2754
28.03.2019 19:00,3243,43.04,485,519,2758
28.03.2019 20:00,3240,36.33,546,573,2694
28.03.2019 21:00,3094,34.7,602,604,2492
28.03.2019 22:00,2888,32.77,653,633,2235
28.03.2019 23:00,2611,29.07,688,657,1923
29.03.2019 00:00,2441,27.35,713,675,1728
29.03.2019 01:00,2445,4.79,803,773,1642
29.03.2019 02:00,2436,2.9,818,806,1618
29.03.2019 03:00,2420,4.07,828,833,1592
29.03.2019 04:00,2447,4.32,853,857,1594
29.03.2019 05:00,2534,17.44,868,872,1666
29.03.2019 06:00,2704,33.07,879,880,1825
29.03.2019 07:00,2974,35.05,894,889,2080
29.03.2019 08:00,3213,41.97,917,914,2296
29.03.2019 09:00,3195,39.91,955,951,2240
29.03.2019 10:00,3110,36.5,1000,999,2110
29.03.2019 11:00,3080,35.62,1052,1046,2028
29.03.2019 12:00,2956,33.76,1076,1079,1880
29.03.2019 13:00,2881,32.82,1071,1096,1810
29.03.2019 14:00,2808,32.09,1033,1080,1775
29.03.2019 15:00,2810,31.62,996,1045,1814
29.03.2019 16:00,2790,32.33,961,1000,1829
29.03.2019 17:00,2772,33,934,967,1838
29.03.2019 18:00,2891,34.09,928,946,1963
29.03.2019 19:00,2969,37.22,943,943,2026
29.03.2019 20:00,2946,36.33,934,948,2012
29.03.2019 21:00,2807,33.82,924,950,1883
29.03.2019 22:00,2744,33.02,924,943,1820
29.03.2019 23:00,2605,30.37,910,914,1695
30.03.2019 00:00,2465,26.15,867,871,1598
30.03.2019 01:00,2401,32.76,805,803,1596
30.03.2019 02:00,2364,31.09,745,745,1619
30.03.2019 03:00,2357,29.41,680,680,1677
30.03.2019 04:00,2333,31.59,617,609,1716
30.03.2019 05:00,2376,34.93,548,544,1828
30.03.2019 06:00,2379,33.07,498,490,1881
30.03.2019 07:00,2483,32.19,464,444,2019
30.03.2019 08:00,2580,33.23,432,408,2148
30.03.2019 09:00,2689,34.93,413,394,2276
30.03.2019 10:00,2712,33.17,404,403,2308
30.03.2019 11:00,2667,31.63,427,451,2240
30.03.2019 12:00,2606,29.24,475,526,2131
30.03.2019 13:00,2580,28.77,560,609,2020
30.03.2019 14:00,2503,26.56,602,681,1901
30.03.2019 15:00,2410,26.07,672,737,1738
30.03.2019 16:00,2398,29.25,730,776,1668
30.03.2019 17:00,2373,32.02,788,808,1585
30.03.2019 18:00,2561,36.48,845,835,1716
30.03.2019 19:00,2760,37.43,897,870,1863
30.03.2019 20:00,2878,37.24,911,901,1967
30.03.2019 21:00,2710,35.09,942,948,1768
30.03.2019 22:00,2581,33.68,971,988,1610
30.03.2019 23:00,2429,30.97,1021,1001,1408
31.03.2019 00:00,2347,26.8,1002,1006,1345
31.03.2019 01:00,2324,30.7,1062,1081,1262
31.03.2019 02:00,2288,28.88,1097,1105,1191
31.03.2019 03:00,2761.949947,36.96376226,446.1037531,443.144979,2315.846194
31.03.2019 04:00,2330,25.07,1102,1124,1228
31.03.2019 05:00,2378,22.47,1119,1134,1259
31.03.2019 06:00,2376,24.9,1141,1129,1235
31.03.2019 07:00,2417,26.96,1132,1114,1285
31.03.2019 08:00,2455,31.24,1115,1095,1340
31.03.2019 09:00,2474,33.07,1099,1090,1375
31.03.2019 10:00,2584,32.78,1116,1101,1468
31.03.2019 11:00,2557,31.49,1068,1106,1489
31.03.2019 12:00,2591,31.43,1053,1075,1538
31.03.2019 13:00,2535,29.84,960,1019,1575
31.03.2019 14:00,2411,27.33,860,962,1551
31.03.2019 15:00,2328,18.92,803,897,1525
31.03.2019 16:00,2366,7.05,776,829,1590
31.03.2019 17:00,2327,11.51,736,766,1591
31.03.2019 18:00,2429,26.73,678,688,1751
31.03.2019 19:00,2592,34.68,594,588,1998
31.03.2019 20:00,2899,37.98,485,493,2414
31.03.2019 21:00,3135,38.59,412,424,2723
31.03.2019 22:00,3005,37.98,360,378,2645
31.03.2019 23:00,2853,37.33,328,348,2525
04.01.2019 00:00,2665,36.61,311,320,2354
04.01.2019 01:00,2607,31.06,315,306,2292
04.01.2019 02:00,2598,29.96,291,282,2307
04.01.2019 03:00,2621,31.07,258,248,2363
04.01.2019 04:00,2673,31.84,214,210,2459
04.01.2019 05:00,2777,32.4,174,171,2603
04.01.2019 06:00,3040,37.61,135,133,2905
04.01.2019 07:00,3508,43.43,96,96,3412
04.01.2019 08:00,3772,55.58,65,68,3707
04.01.2019 09:00,3754,53.56,41,50,3713
04.01.2019 10:00,3603,45.95,28,48,3575
04.01.2019 11:00,3460,42.2,27,54,3433
04.01.2019 12:00,3281,40.07,35,68,3246
04.01.2019 13:00,3132,39.2,53,90,3079
04.01.2019 14:00,3092,38.98,79,115,3013
04.01.2019 15:00,3030,37.2,99,137,2931
04.01.2019 16:00,2949,36.93,127,159,2822
04.01.2019 17:00,2923,37.79,162,183,2761
04.01.2019 18:00,2964,38.43,196,206,2768
04.01.2019 19:00,3072,40.62,232,235,2840
04.01.2019 20:00,3153,44.02,288,284,2865
04.01.2019 21:00,3206,41,353,350,2853
04.01.2019 22:00,2971,39.41,414,417,2557
04.01.2019 23:00,2718,35.8,497,491,2221
04.02.2019 00:00,2644,31.8,555,543,2089
04.02.2019 01:00,2578,29.11,580,567,1998
04.02.2019 02:00,2489,26.93,593,596,1896
04.02.2019 03:00,2441,25.43,653,639,1788
04.02.2019 04:00,2509,25.46,699,689,1810
04.02.2019 05:00,2604,27.88,747,732,1857
04.02.2019 06:00,2781,34.73,767,760,2014
04.02.2019 07:00,3192,39.63,783,777,2409
04.02.2019 08:00,3488,42.73,795,791,2693
04.02.2019 09:00,3537,42.16,821,821,2716
04.02.2019 10:00,3370,40.5,870,899,2500
04.02.2019 11:00,3198,39.4,938,992,2260
04.02.2019 12:00,3134,38.69,1002,1057,2132
04.02.2019 13:00,3101,38.28,1049,1091,2052
04.02.2019 14:00,3046,37.39,1075,1114,1971
04.02.2019 15:00,3003,35.05,1081,1125,1922
04.02.2019 16:00,2987,34.68,1098,1126,1889
04.02.2019 17:00,2921,34.82,1095,1112,1826
04.02.2019 18:00,2948,36.78,1075,1072,1873
04.02.2019 19:00,3099,39.03,1037,1017,2062
04.02.2019 20:00,3249,39.57,1011,980,2238
04.02.2019 21:00,3273,38.58,985,977,2288
04.02.2019 22:00,3118,36.4,969,990,2149
04.02.2019 23:00,2860,31.38,1000,1002,1860
04.03.2019 00:00,2651,27.69,1007,998,1644
04.03.2019 01:00,2525,31.9,991,993,1534
04.03.2019 02:00,2494,31.5,972,977,1522
04.03.2019 03:00,2467,31.08,961,969,1506
04.03.2019 04:00,2470,31.19,954,960,1516
04.03.2019 05:00,2565,32.57,914,949,1651
04.03.2019 06:00,2742,36,877,927,1865
04.03.2019 07:00,3121,41.17,873,892,2248
04.03.2019 08:00,3486,44.8,808,843,2678
04.03.2019 09:00,3611,48.44,740,772,2871
04.03.2019 10:00,3518,46.47,649,710,2869
04.03.2019 11:00,3489,46.16,571,659,2918
04.03.2019 12:00,3409,44.58,548,633,2861
04.03.2019 13:00,3307,42.4,480,622,2827
04.03.2019 14:00,3269,41.73,472,625,2797
04.03.2019 15:00,3196,40.77,500,638,2696
04.03.2019 16:00,3131,40.48,529,657,2602
04.03.2019 17:00,3044,40.73,577,671,2467
04.03.2019 18:00,3105,41.08,616,690,2489
04.03.2019 19:00,3181,41.26,669,722,2512
04.03.2019 20:00,3265,41.39,707,762,2558
04.03.2019 21:00,3259,40.89,789,806,2470
04.03.2019 22:00,3016,39.91,835,839,2181
04.03.2019 23:00,2789,35.89,850,865,1939
04.04.2019 00:00,2599,34.95,853,868,1746
04.04.2019 01:00,2426,32.63,857,874,1569
04.04.2019 02:00,2361,32.31,857,866,1504
04.04.2019 03:00,2357,32.21,859,855,1498
04.04.2019 04:00,2419,31.81,858,854,1561
04.04.2019 05:00,2477,34.13,860,856,1617
04.04.2019 06:00,2656,36.86,864,867,1792
04.04.2019 07:00,2985,40.54,872,878,2113
04.04.2019 08:00,3304,44.96,877,876,2427
04.04.2019 09:00,3460,49.07,848,848,2612
04.04.2019 10:00,3396,45.8,790,827,2606
04.04.2019 11:00,3400,43.78,750,819,2650
04.04.2019 12:00,3325,41.93,753,825,2572
04.04.2019 13:00,3206,40.75,765,837,2441
04.04.2019 14:00,3120,40.33,740,851,2380
04.04.2019 15:00,3042,38.73,752,855,2290
04.04.2019 16:00,2999,38.37,780,849,2219
04.04.2019 17:00,2970,39.03,759,831,2211
04.04.2019 18:00,3011,39.86,738,814,2273
04.04.2019 19:00,3028,40.63,730,809,2298
04.04.2019 20:00,3040,40.71,790,829,2250
04.04.2019 21:00,3026,40.29,831,853,2195
04.04.2019 22:00,2883,39.66,852,861,2031
04.04.2019 23:00,2682,37.57,843,858,1839
04.05.2019 00:00,2447,35.92,817,833,1630
04.05.2019 01:00,2285,35.36,755,757,1530
04.05.2019 02:00,2272,35.47,710,720,1562
04.05.2019 03:00,2298,34.49,695,705,1603
04.05.2019 04:00,2344,34.59,693,710,1651
04.05.2019 05:00,2412,37.06,687,722,1725
04.05.2019 06:00,2598,39.18,706,742,1892
04.05.2019 07:00,2963,40.89,726,762,2237
04.05.2019 08:00,3295,42.44,723,766,2572
04.05.2019 09:00,3388,43.93,690,742,2698
04.05.2019 10:00,3258,43.17,653,722,2605
04.05.2019 11:00,3115,42.34,685,737,2430
04.05.2019 12:00,2956,41.29,704,780,2252
04.05.2019 13:00,2792,40.73,759,823,2033
04.05.2019 14:00,2726,40.08,784,854,1942
04.05.2019 15:00,2682,39.09,816,880,1866
04.05.2019 16:00,2700,38.84,826,901,1874
04.05.2019 17:00,2712,39.12,826,918,1886
04.05.2019 18:00,2810,39.98,824,940,1986
04.05.2019 19:00,2816,40.63,874,971,1942
04.05.2019 20:00,2871,40.6,923,1012,1948
04.05.2019 21:00,2816,40.21,946,1039,1870
04.05.2019 22:00,2659,40.46,974,1045,1685
04.05.2019 23:00,2554,39.48,967,1032,1587
04.06.2019 00:00,2419,38.65,972,1000,1447
04.06.2019 01:00,2206,37.96,814,845,1392
04.06.2019 02:00,2205,37.93,754,793,1451
04.06.2019 03:00,2172,37.39,724,745,1448
04.06.2019 04:00,2189,36.1,691,705,1498
04.06.2019 05:00,2217,36.13,664,675,1553
04.06.2019 06:00,2296,37.27,637,655,1659
04.06.2019 07:00,2343,38.06,632,639,1711
04.06.2019 08:00,2480,38.82,582,606,1898
04.06.2019 09:00,2719,40.35,520,546,2199
04.06.2019 10:00,2810,41.3,438,492,2372
04.06.2019 11:00,2755,41.17,383,465,2372
04.06.2019 12:00,2739,40.25,375,459,2364
04.06.2019 13:00,2626,38.75,371,457,2255
04.06.2019 14:00,2505,36.97,361,449,2144
04.06.2019 15:00,2408,35.94,372,433,2036
04.06.2019 16:00,2368,35.97,360,411,2008
04.06.2019 17:00,2388,37.43,334,387,2054
04.06.2019 18:00,2479,38.36,323,372,2156
04.06.2019 19:00,2556,40.29,317,372,2239
04.06.2019 20:00,2578,40.9,334,391,2244
04.06.2019 21:00,2668,41.07,352,409,2316
04.06.2019 22:00,2569,39.99,342,408,2227
04.06.2019 23:00,2430,39.21,342,396,2088
04.07.2019 00:00,2297,36.32,315,361,1982
04.07.2019 01:00,2180,38.61,245,256,1935
04.07.2019 02:00,2142,38.51,206,226,1936
04.07.2019 03:00,2141,38.05,183,196,1958
04.07.2019 04:00,2176,38.03,158,170,2018
04.07.2019 05:00,2225,38.64,133,150,2092
04.07.2019 06:00,2271,38.66,115,128,2156
04.07.2019 07:00,2285,38.32,95,107,2190
04.07.2019 08:00,2362,39.43,77,87,2285
04.07.2019 09:00,2515,40.51,55,70,2460
04.07.2019 10:00,2560,40.66,29,57,2531
04.07.2019 11:00,2541,39.66,19,53,2522
04.07.2019 12:00,2505,39.54,14,53,2491
04.07.2019 13:00,2477,39.19,15,60,2462
04.07.2019 14:00,2432,38.88,21,64,2411
04.07.2019 15:00,2352,38.56,25,68,2327
04.07.2019 16:00,2253,38.35,36,70,2217
04.07.2019 17:00,2235,38.29,54,69,2181
04.07.2019 18:00,2306,38.16,61,68,2245
04.07.2019 19:00,2461,40.88,73,73,2388
04.07.2019 20:00,2567,42.22,109,104,2458
04.07.2019 21:00,2639,42.35,154,139,2485
04.07.2019 22:00,2542,41.02,185,162,2357
04.07.2019 23:00,2353,40.06,218,184,2135
04.08.2019 00:00,2189,39.46,221,193,1968
04.08.2019 01:00,2182,37.57,313,311,1869
04.08.2019 02:00,2207,36.79,326,317,1881
04.08.2019 03:00,2224,35.85,345,328,1879
04.08.2019 04:00,2213,35.59,359,347,1854
04.08.2019 05:00,2209,37.2,382,378,1827
04.08.2019 06:00,2468,40.6,405,403,2063
04.08.2019 07:00,2888,42.59,416,413,2472
04.08.2019 08:00,3262,44.43,404,411,2858
04.08.2019 09:00,3327,44.84,391,414,2936
04.08.2019 10:00,3267,44.49,399,421,2868
04.08.2019 11:00,3254,44.17,368,417,2886
04.08.2019 12:00,3237,42.98,321,384,2916
04.08.2019 13:00,3172,42.35,266,334,2906
04.08.2019 14:00,3158,41.85,225,287,2933
04.08.2019 15:00,3069,40.42,206,246,2863
04.08.2019 16:00,3048,40.17,167,217,2881
04.08.2019 17:00,2985,40.76,160,197,2825
04.08.2019 18:00,3059,41.81,157,180,2902
04.08.2019 19:00,3041,43.1,147,162,2894
04.08.2019 20:00,3058,43.95,137,149,2921
04.08.2019 21:00,3125,43.25,133,135,2992
04.08.2019 22:00,3022,42.38,123,129,2899
04.08.2019 23:00,2784,41.01,127,123,2657
04.09.2019 00:00,2550,38.36,123,120,2427
04.09.2019 01:00,2455,33.24,132,132,2323
04.09.2019 02:00,2497,34.1,170,149,2327
04.09.2019 03:00,2537,34.74,184,173,2353
04.09.2019 04:00,2594,34.86,236,198,2358
04.09.2019 05:00,2725,34.91,271,238,2454
04.09.2019 06:00,3039,40.79,279,272,2760
04.09.2019 07:00,3460,44.15,280,294,3180
04.09.2019 08:00,3652,50.51,322,304,3330
04.09.2019 09:00,3560,51.9,329,301,3231
04.09.2019 10:00,3474,47.03,297,285,3177
04.09.2019 11:00,3495,45.61,277,258,3218
04.09.2019 12:00,3386,44.4,204,230,3182
04.09.2019 13:00,3279,43.15,184,208,3095
04.09.2019 14:00,3161,42.29,163,195,2998
04.09.2019 15:00,3059,40.9,124,195,2935
04.09.2019 16:00,2952,40.68,122,200,2830
04.09.2019 17:00,2968,41.48,132,207,2836
04.09.2019 18:00,3007,42.06,162,217,2845
04.09.2019 19:00,3043,43.53,207,229,2836
04.09.2019 20:00,3168,45.89,248,248,2920
04.09.2019 21:00,3114,44.47,255,248,2859
04.09.2019 22:00,2988,42.7,247,242,2741
04.09.2019 23:00,2800,42.07,213,241,2587
04.10.2019 00:00,2198,40.06,227,245,1971
04.10.2019 01:00,2660,37.51,259,235,2401
04.10.2019 02:00,2612,37.18,272,240,2340
04.10.2019 03:00,2639,36.54,300,249,2339
04.10.2019 04:00,2701,35.78,317,258,2384
04.10.2019 05:00,2786,39.88,333,269,2453
04.10.2019 06:00,2965,42.26,320,276,2645
04.10.2019 07:00,3314,44.37,335,286,2979
04.10.2019 08:00,3625,53.13,352,298,3273
04.10.2019 09:00,3687,56.08,340,297,3347
04.10.2019 10:00,3581,49.38,309,286,3272
04.10.2019 11:00,3601,46.15,271,274,3330
04.10.2019 12:00,3595,44.5,253,259,3342
04.10.2019 13:00,3498,43.88,236,242,3262
04.10.2019 14:00,3498,43.53,215,228,3283
04.10.2019 15:00,3442,42.41,194,218,3248
04.10.2019 16:00,3444,42.43,187,213,3257
04.10.2019 17:00,3425,43.46,177,206,3248
04.10.2019 18:00,3469,44.01,180,197,3289
04.10.2019 19:00,3462,45.09,180,184,3282
04.10.2019 20:00,3440,47.2,184,172,3256
04.10.2019 21:00,3485,45.84,184,170,3301
04.10.2019 22:00,3345,44.26,198,179,3147
04.10.2019 23:00,3160,43.65,192,190,2968
04.11.2019 00:00,2948,42.01,185,193,2763
04.11.2019 01:00,2854,42.47,180,182,2674
04.11.2019 02:00,2775,41.94,176,183,2599
04.11.2019 03:00,2770,41.9,175,185,2595
04.11.2019 04:00,2748,41.96,181,187,2567
04.11.2019 05:00,2759,42.3,178,190,2581
04.11.2019 06:00,2937,43.92,179,191,2758
04.11.2019 07:00,3362,47.91,184,191,3178
04.11.2019 08:00,3750,56.4,194,190,3556
04.11.2019 09:00,3833,60.7,202,189,3631
04.11.2019 10:00,3713,52.97,198,190,3515
04.11.2019 11:00,3693,49.75,172,192,3521
04.11.2019 12:00,3582,47.5,164,188,3418
04.11.2019 13:00,3462,49.93,156,181,3306
04.11.2019 14:00,3411,48.67,153,172,3258
04.11.2019 15:00,3335,45.96,147,163,3188
04.11.2019 16:00,3274,45.28,132,156,3142
04.11.2019 17:00,3222,46.05,133,154,3089
04.11.2019 18:00,3187,46.27,132,150,3055
04.11.2019 19:00,3209,47.69,134,145,3075
04.11.2019 20:00,3239,54.02,144,136,3095
04.11.2019 21:00,3322,52.99,154,131,3168
04.11.2019 22:00,3241,47.96,157,135,3084
04.11.2019 23:00,3079,47.2,157,141,2922
04.12.2019 00:00,2928,45.11,166,139,2762
04.12.2019 01:00,2814,44,163,105,2651
04.12.2019 02:00,2796,43.68,151,98,2645
04.12.2019 03:00,2786,43.59,136,94,2650
04.12.2019 04:00,2803,43.7,132,93,2671
04.12.2019 05:00,2860,44.19,141,95,2719
04.12.2019 06:00,3081,45.92,135,99,2946
04.12.2019 07:00,3444,47.52,117,101,3327
04.12.2019 08:00,3743,58.98,135,105,3608
04.12.2019 09:00,3761,60.08,140,116,3621
04.12.2019 10:00,3674,51.55,138,136,3536
04.12.2019 11:00,3618,48.97,138,157,3480
04.12.2019 12:00,3516,46.99,139,161,3377
04.12.2019 13:00,3419,45.95,157,154,3262
04.12.2019 14:00,3312,45.2,159,145,3153
04.12.2019 15:00,3204,44.15,149,133,3055
04.12.2019 16:00,3094,43.57,138,121,2956
04.12.2019 17:00,3016,43.61,135,113,2881
04.12.2019 18:00,3063,44,129,105,2934
04.12.2019 19:00,3113,45.72,123,98,2990
04.12.2019 20:00,3090,47.27,140,93,2950
04.12.2019 21:00,3153,47.02,140,92,3013
04.12.2019 22:00,3037,45.36,128,99,2909
04.12.2019 23:00,2994,44.72,139,111,2855
13.04.2019 00:00,2863,43.83,160,119,2703
13.04.2019 01:00,2722,44.78,163,167,2559
13.04.2019 02:00,2648,43.89,188,194,2460
13.04.2019 03:00,2622,43.41,216,219,2406
13.04.2019 04:00,2600,43.09,254,250,2346
13.04.2019 05:00,2641,43.32,294,290,2347
13.04.2019 06:00,2732,43.3,311,310,2421
13.04.2019 07:00,2771,43.88,306,312,2465
13.04.2019 08:00,2911,44.99,283,301,2628
13.04.2019 09:00,3048,46.14,299,311,2749
13.04.2019 10:00,3021,45.9,345,358,2676
13.04.2019 11:00,3033,44.65,397,413,2636
13.04.2019 12:00,3032,44.04,438,447,2594
13.04.2019 13:00,2950,43.82,446,462,2504
13.04.2019 14:00,2854,43.45,461,471,2393
13.04.2019 15:00,2734,43.18,482,474,2252
13.04.2019 16:00,2652,42.96,481,474,2171
13.04.2019 17:00,2598,43.02,509,475,2089
13.04.2019 18:00,2650,43.46,509,472,2141
13.04.2019 19:00,2681,44.13,495,456,2186
13.04.2019 20:00,2780,44.99,457,440,2323
13.04.2019 21:00,2912,45.27,434,437,2478
13.04.2019 22:00,2812,44.11,443,449,2369
13.04.2019 23:00,2700,42.96,465,461,2235
14.04.2019 00:00,2587,41.47,470,467,2117
14.04.2019 01:00,2591,40.25,589,243,2002
14.04.2019 02:00,2572,38.07,608,242,1964
14.04.2019 03:00,2576,38.04,595,247,1981
14.04.2019 04:00,2642,38.06,595,253,2047
14.04.2019 05:00,2697,39.18,625,259,2072
14.04.2019 06:00,2719,39.49,631,260,2088
14.04.2019 07:00,2670,38.28,607,260,2063
14.04.2019 08:00,2782,41.42,607,265,2175
14.04.2019 09:00,2850,43.21,626,277,2224
14.04.2019 10:00,2837,43.66,661,297,2176
14.04.2019 11:00,2746,43.45,661,321,2085
14.04.2019 12:00,2697,43.13,638,332,2059
14.04.2019 13:00,2640,42.87,621,326,2019
14.04.2019 14:00,2550,42.65,619,314,1931
14.04.2019 15:00,2455,42.47,603,302,1852
14.04.2019 16:00,2422,42.31,585,192,1837
14.04.2019 17:00,2493,41.97,553,169,1940
14.04.2019 18:00,2562,42.32,556,99,2006
14.04.2019 19:00,2675,43.26,525,88,2150
14.04.2019 20:00,2814,44.7,495,78,2319
14.04.2019 21:00,2902,45.62,458,72,2444
14.04.2019 22:00,2793,44.41,437,72,2356
14.04.2019 23:00,2759,43.92,452,75,2307
15.04.2019 00:00,2692,42.23,463,75,2229
15.04.2019 01:00,2639,41.96,461,443.144979,2178
15.04.2019 02:00,2536,41.92,436,443.144979,2100
15.04.2019 03:00,2585,41.96,433,443.144979,2152
15.04.2019 04:00,2650,42.24,422,443.144979,2228
15.04.2019 05:00,2754,43.36,422,443.144979,2332
15.04.2019 06:00,2950,45.1,404,443.144979,2546
15.04.2019 07:00,3340,47.73,384,443.144979,2956
15.04.2019 08:00,3632,58.76,346,443.144979,3286
15.04.2019 09:00,3708,60.33,320,443.144979,3388
15.04.2019 10:00,3604,47.29,321,443.144979,3283
15.04.2019 11:00,3403,45.88,312,443.144979,3091
15.04.2019 12:00,3206,44.81,291,443.144979,2915
15.04.2019 13:00,3110,44.47,345,443.144979,2765
15.04.2019 14:00,3135,44.31,420,443.144979,2715
15.04.2019 15:00,3066,43.85,434,443.144979,2632
15.04.2019 16:00,2991,43.62,416,443.144979,2575
15.04.2019 17:00,2864,43.88,370,443.144979,2494
15.04.2019 18:00,2874,44.45,340,443.144979,2534
15.04.2019 19:00,2912,45.88,330,443.144979,2582
15.04.2019 20:00,3007,48.09,340,443.144979,2667
15.04.2019 21:00,3113,47.01,337,443.144979,2776
15.04.2019 22:00,3025,45.7,324,443.144979,2701
15.04.2019 23:00,2897,43.98,323,443.144979,2574
16.04.2019 00:00,2740,42.92,357,443.144979,2383
16.04.2019 01:00,2675,43.17,399,424,2276
16.04.2019 02:00,2684,43.05,430,439,2254
16.04.2019 03:00,2617,43.04,444,456,2173
16.04.2019 04:00,2616,43.18,461,470,2155
16.04.2019 05:00,2705,43.5,482,485,2223
16.04.2019 06:00,2965,44.17,526,490,2439
16.04.2019 07:00,3273,46.22,496,478,2777
16.04.2019 08:00,3614,50.81,475,459,3139
16.04.2019 09:00,3671,51.44,475,449,3196
16.04.2019 10:00,3492,46.62,505,459,2987
16.04.2019 11:00,3281,44.72,503,493,2778
16.04.2019 12:00,3118,44.42,521,529,2597
16.04.2019 13:00,3049,44.16,553,558,2496
16.04.2019 14:00,3144,44.17,598,581,2546
16.04.2019 15:00,3055,43.83,625,582,2430
16.04.2019 16:00,2977,43.58,585,562,2392
16.04.2019 17:00,2837,43.58,528,533,2309
16.04.2019 18:00,2863,44.5,565,500,2298
16.04.2019 19:00,2790,48.54,571,460,2219
16.04.2019 20:00,2872,47.46,544,423,2328
16.04.2019 21:00,3054,47.22,516,406,2538
16.04.2019 22:00,2960,46.39,485,402,2475
16.04.2019 23:00,2703,44.16,448,403,2255
17.04.2019 00:00,2440,41.94,456,401,1984
17.04.2019 01:00,2395,42.1,484,445,1911
17.04.2019 02:00,2344,41.73,489,433,1855
17.04.2019 03:00,2362,41.33,481,426,1881
17.04.2019 04:00,2467,41.92,475,415,1992
17.04.2019 05:00,2544,42.27,467,397,2077
17.04.2019 06:00,2748,43.38,444,361,2304
17.04.2019 07:00,3093,45.68,399,313,2694
17.04.2019 08:00,3420,46.7,337,259,3083
17.04.2019 09:00,3517,47.43,283,213,3234
17.04.2019 10:00,3387,46.53,232,187,3155
17.04.2019 11:00,3258,45.92,179,185,3079
17.04.2019 12:00,3109,44.57,153,202,2956
17.04.2019 13:00,2950,43.91,140,223,2810
17.04.2019 14:00,2905,43.28,164,240,2741
17.04.2019 15:00,2870,42.98,181,246,2689
17.04.2019 16:00,2832,42.91,181,248,2651
17.04.2019 17:00,2751,42.93,181,246,2570
17.04.2019 18:00,2751,43.19,177,247,2574
17.04.2019 19:00,2740,44.41,168,252,2572
17.04.2019 20:00,2762,45.12,181,268,2581
17.04.2019 21:00,2802,45.73,204,288,2598
17.04.2019 22:00,2731,44.26,228,302,2503
17.04.2019 23:00,2510,42.97,241,313,2269
18.04.2019 00:00,2350,41.8,278,307,2072
18.04.2019 01:00,2288,42.73,289,265,1999
18.04.2019 02:00,2275,42.59,306,259,1969
18.04.2019 03:00,2270,42.57,287,255,1983
18.04.2019 04:00,2292,42.71,258,251,2034
18.04.2019 05:00,2395,42.97,233,251,2162
18.04.2019 06:00,2543,44.04,221,248,2322
18.04.2019 07:00,2825,44.77,259,242,2566
18.04.2019 08:00,3078,45.8,243,224,2835
18.04.2019 09:00,3163,46.34,202,190,2961
18.04.2019 10:00,3087,45.65,186,159,2901
18.04.2019 11:00,2926,44.57,153,149,2773
18.04.2019 12:00,2793,43.63,116,150,2677
18.04.2019 13:00,2692,43.03,115,155,2577
18.04.2019 14:00,2651,42.42,137,158,2514
18.04.2019 15:00,2573,42.2,154,156,2419
18.04.2019 16:00,2512,42.09,157,150,2355
18.04.2019 17:00,2451,42.07,158,141,2293
18.04.2019 18:00,2461,42.68,125,129,2336
18.04.2019 19:00,2502,44.01,134,119,2368
18.04.2019 20:00,2521,44.77,131,121,2390
18.04.2019 21:00,2555,44.92,126,123,2429
18.04.2019 22:00,2528,44.23,116,122,2412
18.04.2019 23:00,2380,43.19,103,123,2277
19.04.2019 00:00,2232,41.39,107,120,2125
19.04.2019 01:00,2124,38.83,118,130,2006
19.04.2019 02:00,2104,38.1,113,125,1991
19.04.2019 03:00,2108,37.97,116,118,1992
19.04.2019 04:00,2163,38.03,110,110,2053
19.04.2019 05:00,2236,37.07,96,105,2140
19.04.2019 06:00,2321,40.75,87,97,2234
19.04.2019 07:00,2403,41.67,78,86,2325
19.04.2019 08:00,2463,42.68,59,73,2404
19.04.2019 09:00,2509,43.83,48,58,2461
19.04.2019 10:00,2510,43.73,30,50,2480
19.04.2019 11:00,2434,42.97,17,49,2417
19.04.2019 12:00,2357,42.76,14,53,2343
19.04.2019 13:00,2323,42.28,11,56,2312
19.04.2019 14:00,2266,41.93,13,59,2253
19.04.2019 15:00,2169,41.4,16,61,2153
19.04.2019 16:00,2174,40.99,21,64,2153
19.04.2019 17:00,2200,41.79,36,65,2164
19.04.2019 18:00,2248,42.22,38,64,2210
19.04.2019 19:00,2247,42.97,44,64,2203
19.04.2019 20:00,2242,43.68,52,72,2190
19.04.2019 21:00,2276,43.2,62,81,2214
19.04.2019 22:00,2311,44.09,69,91,2242
19.04.2019 23:00,2195,43.88,78,99,2117
20.04.2019 00:00,2095,41.62,83,102,2012
20.04.2019 01:00,2007,42.45,88,92,1919
20.04.2019 02:00,1989,40.96,88,95,1901
20.04.2019 03:00,1999,40.46,84,94,1915
20.04.2019 04:00,2064,40.75,79,87,1985
20.04.2019 05:00,2120,41.26,73,80,2047
20.04.2019 06:00,2148,40.13,70,73,2078
20.04.2019 07:00,2151,40.46,63,68,2088
20.04.2019 08:00,2181,41.42,55,64,2126
20.04.2019 09:00,2257,42.67,45,55,2212
20.04.2019 10:00,2291,42.99,31,48,2260
20.04.2019 11:00,2304,42.88,19,48,2285
20.04.2019 12:00,2222,42.01,17,51,2205
20.04.2019 13:00,2179,41.5,20,57,2159
20.04.2019 14:00,2122,40.99,27,69,2095
20.04.2019 15:00,2003,40.71,40,84,1963
20.04.2019 16:00,1955,40.18,58,102,1897
20.04.2019 17:00,1964,40.46,86,121,1878
20.04.2019 18:00,1995,41.16,110,132,1885
20.04.2019 19:00,2035,43.33,132,143,1903
20.04.2019 20:00,2102,43.66,155,162,1947
20.04.2019 21:00,2161,43.54,171,176,1990
20.04.2019 22:00,2108,43.24,165,181,1943
20.04.2019 23:00,2047,42.02,172,180,1875
21.04.2019 00:00,2011,41.05,175,166,1836
21.04.2019 01:00,2030,37.86,261,189,1769
21.04.2019 02:00,1984,34.86,257,195,1727
21.04.2019 03:00,1938,32.1,227,207,1711
21.04.2019 04:00,1913,32.09,234,219,1679
21.04.2019 05:00,1954,34.04,260,223,1694
21.04.2019 06:00,1986,33.92,254,209,1732
21.04.2019 07:00,1997,34.96,231,186,1766
21.04.2019 08:00,2049,35.01,198,164,1851
21.04.2019 09:00,2151,40.36,162,135,1989
21.04.2019 10:00,2217,41.84,123,112,2094
21.04.2019 11:00,2162,41.44,108,112,2054
21.04.2019 12:00,2082,41.19,91,126,1991
21.04.2019 13:00,2017,40.78,109,141,1908
21.04.2019 14:00,1994,39.67,141,154,1853
21.04.2019 15:00,1989,37.4,160,159,1829
21.04.2019 16:00,1995,33.16,156,158,1839
21.04.2019 17:00,2022,35.01,156,152,1866
21.04.2019 18:00,2075,39.58,142,139,1933
21.04.2019 19:00,2119,41.85,133,126,1986
21.04.2019 20:00,2185,43.31,132,124,2053
21.04.2019 21:00,2192,43.49,148,129,2044
21.04.2019 22:00,2229,43.1,143,132,2086
21.04.2019 23:00,2141,41.38,144,131,1997
22.04.2019 00:00,2017,39.27,141,127,1876
22.04.2019 01:00,1827,35.02,128,115,1699
22.04.2019 02:00,1713,30.08,133,124,1580
22.04.2019 03:00,1719,30.05,166,148,1553
22.04.2019 04:00,1740,30.06,228,179,1512
22.04.2019 05:00,1842,30.02,300,209,1542
22.04.2019 06:00,1894,31.41,320,225,1574
22.04.2019 07:00,1929,36.81,321,223,1608
22.04.2019 08:00,2080,39.29,266,212,1814
22.04.2019 09:00,2207,40.79,242,201,1965
22.04.2019 10:00,2195,41.12,243,210,1952
22.04.2019 11:00,2179,41.44,244,231,1935
22.04.2019 12:00,2192,41.08,282,258,1910
22.04.2019 13:00,2189,40.47,295,281,1894
22.04.2019 14:00,2175,39.99,304,299,1871
22.04.2019 15:00,2115,38.9,312,318,1803
22.04.2019 16:00,2039,39.16,324,340,1715
22.04.2019 17:00,2039,39.71,361,362,1678
22.04.2019 18:00,2063,40.7,411,379,1652
22.04.2019 19:00,2120,41.44,430,392,1690
22.04.2019 20:00,2189,41.43,440,416,1749
22.04.2019 21:00,2242,39.57,473,468,1769
22.04.2019 22:00,2235,35.05,557,532,1678
22.04.2019 23:00,2005,20,593,591,1412
23.04.2019 00:00,1906,11.23,572,616,1334
23.04.2019 01:00,1892,4.08,613,666,1279
23.04.2019 02:00,1899,26.53,598,660,1301
23.04.2019 03:00,1893,24.13,603,662,1290
23.04.2019 04:00,1939,25.75,620,677,1319
23.04.2019 05:00,1995,30.08,643,698,1352
23.04.2019 06:00,2131,37.85,709,707,1422
23.04.2019 07:00,2380,41.36,705,700,1675
23.04.2019 08:00,2685,43.66,688,697,1997
23.04.2019 09:00,2888,43.99,714,735,2174
23.04.2019 10:00,2842,43.37,774,837,2068
23.04.2019 11:00,2626,42.77,894,979,1732
23.04.2019 12:00,2584,42.51,1055,1100,1529
23.04.2019 13:00,2549,41.22,1099,1172,1450
23.04.2019 14:00,2617,40.45,1197,1215,1420
23.04.2019 15:00,2553,38.11,1222,1240,1331
23.04.2019 16:00,2516,38.79,1230,1250,1286
23.04.2019 17:00,2545,38.47,1256,1259,1289
23.04.2019 18:00,2569,38.37,1251,1251,1318
23.04.2019 19:00,2583,39.83,1244,1235,1339
23.04.2019 20:00,2645,41.11,1239,1219,1406
23.04.2019 21:00,2646,40.68,1208,1211,1438
23.04.2019 22:00,2586,36.37,1192,1211,1394
23.04.2019 23:00,2407,29.37,1179,1209,1228
24.04.2019 00:00,2244,23.71,1179,1195,1065
24.04.2019 01:00,2127,2.18,1208,935,919
24.04.2019 02:00,2092,4.09,1182,917,910
24.04.2019 03:00,2015,3.93,1177,909,838
24.04.2019 04:00,1979,3.55,1169,911,810
24.04.2019 05:00,2053,5.35,1200,917,853
24.04.2019 06:00,2191,21.69,1201,918,990
24.04.2019 07:00,2473,40.1,1166,913,1307
24.04.2019 08:00,2827,43.18,1146,908,1681
24.04.2019 09:00,2901,43.85,1109,913,1792
24.04.2019 10:00,2838,41.97,1142,929,1696
24.04.2019 11:00,2821,40.96,1141,943,1680
24.04.2019 12:00,2795,39.84,1157,943,1638
24.04.2019 13:00,2709,38.63,1151,934,1558
24.04.2019 14:00,2683,36.96,1117,917,1566
24.04.2019 15:00,2741,33.03,1089,890,1652
24.04.2019 16:00,2749,35.19,1024,852,1725
24.04.2019 17:00,2668,36.69,937,801,1731
24.04.2019 18:00,2681,40.86,863,747,1818
24.04.2019 19:00,2759,42.36,808,699,1951
24.04.2019 20:00,2793,42.56,774,660,2019
24.04.2019 21:00,2740,42.28,744,639,1996
24.04.2019 22:00,2655,41.4,696,627,1959
24.04.2019 23:00,2524,38.1,701,614,1823
25.04.2019 00:00,2359,31,682,600,1677
25.04.2019 01:00,2208,27.44,656,680,1552
25.04.2019 02:00,2154,26.1,629,654,1525
25.04.2019 03:00,2046,27.22,618,642,1428
25.04.2019 04:00,1995,28.65,628,639,1367
25.04.2019 05:00,2085,31.3,620,635,1465
25.04.2019 06:00,2172,38.82,598,611,1574
25.04.2019 07:00,2545,43,553,563,1992
25.04.2019 08:00,2855,49.6,516,508,2339
25.04.2019 09:00,2934,47.15,465,449,2469
25.04.2019 10:00,2930,44.41,385,409,2545
25.04.2019 11:00,2858,42.32,347,378,2511
25.04.2019 12:00,2842,41.15,305,354,2537
25.04.2019 13:00,2815,40.8,251,329,2564
25.04.2019 14:00,2829,40.68,245,301,2584
25.04.2019 15:00,2781,40.23,199,271,2582
25.04.2019 16:00,2737,40.13,158,243,2579
25.04.2019 17:00,2630,40.27,134,215,2496
25.04.2019 18:00,2666,41.21,120,186,2546
25.04.2019 19:00,2625,45.11,111,161,2514
25.04.2019 20:00,2598,56.11,103,145,2495
25.04.2019 21:00,2567,58.46,101,149,2466
25.04.2019 22:00,2528,46.63,106,165,2422
25.04.2019 23:00,2338,41.2,123,181,2215
26.04.2019 00:00,2141,39.04,140,198,2001
26.04.2019 01:00,2068,36.11,125,120,1943
26.04.2019 02:00,1974,35,145,144,1829
26.04.2019 03:00,1962,33.53,178,179,1784
26.04.2019 04:00,2019,34.88,219,228,1800
26.04.2019 05:00,2067,36.31,275,280,1792
26.04.2019 06:00,2174,40.06,315,309,1859
26.04.2019 07:00,2476,44.39,310,310,2166
26.04.2019 08:00,2768,52.31,297,300,2471
26.04.2019 09:00,2936,55.03,304,284,2632
26.04.2019 10:00,2962,51.67,307,284,2655
26.04.2019 11:00,2880,48.74,242,297,2638
26.04.2019 12:00,2822,45.81,236,316,2586
26.04.2019 13:00,2734,43.56,226,340,2508
26.04.2019 14:00,2648,42.56,232,364,2416
26.04.2019 15:00,2571,41.3,222,376,2349
26.04.2019 16:00,2560,41.51,252,378,2308
26.04.2019 17:00,2516,42.1,262,374,2254
26.04.2019 18:00,2523,43.12,238,341,2285
26.04.2019 19:00,2487,43.25,246,300,2241
26.04.2019 20:00,2413,47.88,223,274,2190
26.04.2019 21:00,2423,48.47,254,258,2169
26.04.2019 22:00,2360,42.95,214,240,2146
26.04.2019 23:00,2154,41.04,190,220,1964
27.04.2019 00:00,1984,37.05,183,203,1801
27.04.2019 01:00,1892,31.25,182,171,1710
27.04.2019 02:00,1806,29.38,216,179,1590
27.04.2019 03:00,1749,28.35,222,183,1527
27.04.2019 04:00,1764,27.37,207,187,1557
27.04.2019 05:00,1725,26.78,229,202,1496
27.04.2019 06:00,1675,26.12,260,215,1415
27.04.2019 07:00,1789,27.02,251,227,1538
27.04.2019 08:00,2074,31.99,217,242,1857
27.04.2019 09:00,2213,37.22,245,259,1968
27.04.2019 10:00,2309,38.04,291,285,2018
27.04.2019 11:00,2413,38.02,295,310,2118
27.04.2019 12:00,2449,37.57,300,324,2149
27.04.2019 13:00,2455,33.92,318,332,2137
27.04.2019 14:00,2433,31.55,352,339,2081
27.04.2019 15:00,2337,30.89,314,317,2023
27.04.2019 16:00,2265,30.98,277,279,1988
27.04.2019 17:00,2286,32.04,257,240,2029
27.04.2019 18:00,2371,33.92,217,194,2154
27.04.2019 19:00,2407,38.02,172,151,2235
27.04.2019 20:00,2369,38.96,144,122,2225
27.04.2019 21:00,2350,38.6,133,109,2217
27.04.2019 22:00,2301,36.72,137,104,2164
27.04.2019 23:00,2191,32.83,163,105,2028
28.04.2019 00:00,2107,30.82,192,109,1915
28.04.2019 01:00,2079,4.49,269,196,1810
28.04.2019 02:00,2003,4.3,292,214,1711
28.04.2019 03:00,1926,3.2,301,219,1625
28.04.2019 04:00,1930,3.07,314,224,1616
28.04.2019 05:00,1938,2.95,320,237,1618
28.04.2019 06:00,1924,3.17,330,242,1594
28.04.2019 07:00,1954,6.9,337,238,1617
28.04.2019 08:00,2134,23.39,318,227,1816
28.04.2019 09:00,2283,32.05,282,225,2001
28.04.2019 10:00,2423,34.41,276,230,2147
28.04.2019 11:00,2464,34.48,286,241,2178
28.04.2019 12:00,2467,35.53,286,248,2181
28.04.2019 13:00,2461,32.6,297,252,2164
28.04.2019 14:00,2485,31.44,317,257,2168
28.04.2019 15:00,2453,30.4,322,258,2131
28.04.2019 16:00,2391,29.77,317,255,2074
28.04.2019 17:00,2381,31.74,282,252,2099
28.04.2019 18:00,2475,35.51,327,250,2148
28.04.2019 19:00,2526,40.12,342,256,2184
28.04.2019 20:00,2522,40.57,352,269,2170
28.04.2019 21:00,2570,41.11,366,293,2204
28.04.2019 22:00,2588,40.98,401,337,2187
28.04.2019 23:00,2417,33.96,458,389,1959
29.04.2019 00:00,2224,29.96,507,418,1717
29.04.2019 01:00,2052,35.03,544,578,1508
29.04.2019 02:00,2064,19.03,599,612,1465
29.04.2019 03:00,2051,18.75,654,641,1397
29.04.2019 04:00,2059,18.06,690,662,1369
29.04.2019 05:00,2164,33.36,707,679,1457
29.04.2019 06:00,2246,36.57,696,664,1550
29.04.2019 07:00,2608,41.43,637,607,1971
29.04.2019 08:00,3006,43.11,589,545,2417
29.04.2019 09:00,3090,55.35,555,498,2535
29.04.2019 10:00,2970,50.07,479,481,2491
29.04.2019 11:00,2749,45.87,413,481,2336
29.04.2019 12:00,2738,44.52,379,471,2359
29.04.2019 13:00,2713,43,367,445,2346
29.04.2019 14:00,2754,42.49,355,412,2399
29.04.2019 15:00,2752,40.67,318,372,2434
29.04.2019 16:00,2630,39.41,279,327,2351
29.04.2019 17:00,2546,39.9,227,283,2319
29.04.2019 18:00,2602,41.38,207,241,2395
29.04.2019 19:00,2540,43.89,180,207,2360
29.04.2019 20:00,2534,45.95,157,187,2377
29.04.2019 21:00,2521,47.81,140,177,2381
29.04.2019 22:00,2548,46.81,141,176,2407
29.04.2019 23:00,2412,39.97,124,174,2288
30.04.2019 00:00,2282,36.48,111,159,2171
30.04.2019 01:00,2180,29.91,110,105,2070
30.04.2019 02:00,2140,25.8,103,96,2037
30.04.2019 03:00,2104,24.67,93,86,2011
30.04.2019 04:00,2130,29.14,84,78,2046
30.04.2019 05:00,2204,34.44,82,72,2122
30.04.2019 06:00,2308,37.04,75,59,2233
30.04.2019 07:00,2602,39.94,62,43,2540
30.04.2019 08:00,2843,42.26,47,36,2796
30.04.2019 09:00,2883,42.76,39,34,2844
30.04.2019 10:00,2865,42.81,36,38,2829
30.04.2019 11:00,2856,42.97,31,42,2825
30.04.2019 12:00,2811,42.66,24,53,2787
30.04.2019 13:00,2757,41.84,28,64,2729
30.04.2019 14:00,2727,41.25,42,75,2685
30.04.2019 15:00,2676,40.12,58,85,2618
30.04.2019 16:00,2622,40.02,72,92,2550
30.04.2019 17:00,2516,40.11,77,94,2439
30.04.2019 18:00,2525,41.3,72,84,2453
30.04.2019 19:00,2465,42.26,62,71,2403
30.04.2019 20:00,2379,42.2,65,67,2314
30.04.2019 21:00,2342,41.17,79,66,2263
30.04.2019 22:00,2389,40.66,87,65,2302
30.04.2019 23:00,2239,38.96,98,64,2141
05.01.2019 00:00,2077,5.03,97,56,1980
05.01.2019 01:00,1958,3.1,107,113,1851
05.01.2019 02:00,1880,4.84,106,109,1774
05.01.2019 03:00,1861,4.09,100,105,1761
05.01.2019 04:00,1865,4.26,98,104,1767
05.01.2019 05:00,1862,3.92,106,106,1756
05.01.2019 06:00,1825,2.74,121,113,1704
05.01.2019 07:00,1829,4,158,125,1671
05.01.2019 08:00,1961,11.29,156,144,1805
05.01.2019 09:00,2156,30.15,185,164,1971
05.01.2019 10:00,2271,29.4,226,186,2045
05.01.2019 11:00,2348,29.59,276,219,2072
05.01.2019 12:00,2459,28.65,359,268,2100
05.01.2019 13:00,2485,22.84,437,329,2048
05.01.2019 14:00,2425,19.47,497,401,1928
05.01.2019 15:00,2367,12.9,553,480,1814
05.01.2019 16:00,2348,10.4,663,563,1685
05.01.2019 17:00,2287,10.51,740,646,1547
05.01.2019 18:00,2281,19.61,798,714,1483
05.01.2019 19:00,2245,29.65,842,770,1403
05.01.2019 20:00,2414,33.12,935,816,1479
05.01.2019 21:00,2494,32.8,968,864,1526
05.01.2019 22:00,2413,33.2,975,915,1438
05.01.2019 23:00,2232,26.99,948,958,1284
05.02.2019 00:00,2103,12.78,967,988,1136
05.02.2019 01:00,2026,1.92,1016,1032,1010
05.02.2019 02:00,1995,1.03,1058,1062,937
05.02.2019 03:00,1939,0.55,1099,1087,840
05.02.2019 04:00,1955,0.47,1124,1109,831
05.02.2019 05:00,2037,0.12,1155,1130,882
05.02.2019 06:00,2158,2.1,1194,1144,964
05.02.2019 07:00,2549,12.02,1217,1153,1332
05.02.2019 08:00,2873,39.16,1235,1155,1638
05.02.2019 09:00,2963,39.9,1219,1131,1744
05.02.2019 10:00,2909,39.48,1191,1086,1718
05.02.2019 11:00,3040,39.36,1229,1034,1811
05.02.2019 12:00,2964,37.32,1156,982,1808
05.02.2019 13:00,3047,31.42,1118,935,1929
05.02.2019 14:00,2946,31.9,1041,902,1905
05.02.2019 15:00,2789,29.3,1011,897,1778
05.02.2019 16:00,2653,26.8,968,908,1685
05.02.2019 17:00,2577,26.55,949,908,1628
05.02.2019 18:00,2716,27.66,935,859,1781
05.02.2019 19:00,2764,37.01,863,766,1901
05.02.2019 20:00,2787,38.26,780,646,2007
05.02.2019 21:00,2742,39.71,663,543,2079
05.02.2019 22:00,2716,39.91,559,482,2157
05.02.2019 23:00,2534,36.76,488,440,2046
05.03.2019 00:00,2394,14.41,351,380,2043
05.03.2019 01:00,2182,28.1,359,385,1823
05.03.2019 02:00,2090,28.93,336,328,1754
05.03.2019 03:00,2154,28.91,287,280,1867
05.03.2019 04:00,2228,28.97,283,229,1945
05.03.2019 05:00,2376,28.97,192,182,2184
05.03.2019 06:00,2469,35.96,152,134,2317
05.03.2019 07:00,2681,39.94,119,95,2562
05.03.2019 08:00,2952,42.39,87,74,2865
05.03.2019 09:00,2988,43.05,85,83,2903
05.03.2019 10:00,2890,42.73,108,120,2782
05.03.2019 11:00,2827,42.43,205,180,2622
05.03.2019 12:00,2810,41.93,303,259,2507
05.03.2019 13:00,2773,41.7,359,346,2414
05.03.2019 14:00,2672,39.84,538,429,2134
05.03.2019 15:00,2607,38.69,606,483,2001
05.03.2019 16:00,2665,37.12,633,525,2032
05.03.2019 17:00,2686,36.37,677,560,2009
05.03.2019 18:00,2660,38.89,618,528,2042
05.03.2019 19:00,2596,39.89,565,451,2031
05.03.2019 20:00,2706,39.86,397,378,2309
05.03.2019 21:00,2703,40.12,410,319,2293
05.03.2019 22:00,2550,40.82,358,284,2192
05.03.2019 23:00,2354,39.7,309,268,2045
05.04.2019 00:00,2298,39.02,315,254,1983
05.04.2019 01:00,2168,39.06,339,325,1829
05.04.2019 02:00,2139,35.32,349,329,1790
05.04.2019 03:00,2071,33.92,305,289,1766
05.04.2019 04:00,2088,34.06,292,285,1796
05.04.2019 05:00,2106,34.47,267,269,1839
05.04.2019 06:00,2093,34.51,236,228,1857
05.04.2019 07:00,2161,38.89,193,194,1968
05.04.2019 08:00,2290,40.87,146,166,2144
05.04.2019 09:00,2404,42.99,128,148,2276
05.04.2019 10:00,2433,43.62,143,154,2290
05.04.2019 11:00,2468,43.24,157,168,2311
05.04.2019 12:00,2446,42.65,187,191,2259
05.04.2019 13:00,2413,41.18,204,216,2209
05.04.2019 14:00,2389,40.34,243,256,2146
05.04.2019 15:00,2357,39.97,243,264,2114
05.04.2019 16:00,2292,39.57,253,283,2039
05.04.2019 17:00,2265,39.37,258,271,2007
05.04.2019 18:00,2303,40.49,234,242,2069
05.04.2019 19:00,2352,41.65,205,207,2147
05.04.2019 20:00,2335,42.52,162,166,2173
05.04.2019 21:00,2389,42.73,136,146,2253
05.04.2019 22:00,2403,42.5,126,132,2277
05.04.2019 23:00,2319,42.68,123,129,2196
05.05.2019 00:00,2200,40.99,123,132,2077
05.05.2019 01:00,2133,35.19,160,166,1973
05.05.2019 02:00,2138,32.02,177,181,1961
05.05.2019 03:00,2149,29.04,182,183,1967
05.05.2019 04:00,2191,28.9,184,183,2007
05.05.2019 05:00,2292,29.04,190,191,2102
05.05.2019 06:00,2218,28.63,170,168,2048
05.05.2019 07:00,2150,30.09,129,126,2021
05.05.2019 08:00,2149,40.12,102,102,2047
05.05.2019 09:00,2223,41.02,99,113,2124
05.05.2019 10:00,2257,41.52,117,138,2140
05.05.2019 11:00,2262,41.63,149,174,2113
05.05.2019 12:00,2267,41.51,199,236,2068
05.05.2019 13:00,2198,41.63,233,271,1965
05.05.2019 14:00,2165,41.45,292,321,1873
05.05.2019 15:00,2123,41.09,360,380,1763
05.05.2019 16:00,2096,40.86,423,424,1673
05.05.2019 17:00,2120,40.89,390,439,1730
05.05.2019 18:00,2196,41.35,423,459,1773
05.05.2019 19:00,2151,41.4,444,423,1707
05.05.2019 20:00,2299,41.92,417,418,1882
05.05.2019 21:00,2339,42.56,416,426,1923
05.05.2019 22:00,2381,42.54,420,430,1961
05.05.2019 23:00,2302,42.34,460,452,1842
05.06.2019 00:00,2088,40.88,519,482,1569
05.06.2019 01:00,2092,38.72,642,608,1450
05.06.2019 02:00,2083,34.99,659,650,1424
05.06.2019 03:00,2103,34.92,671,657,1432
05.06.2019 04:00,2138,33.34,686,671,1452
05.06.2019 05:00,2227,33.07,688,680,1539
05.06.2019 06:00,2317,41.71,673,665,1644
05.06.2019 07:00,2682,44.75,639,652,2043
05.06.2019 08:00,3125,50.26,634,649,2491
05.06.2019 09:00,3111,48.84,654,654,2457
05.06.2019 10:00,2997,46.03,649,659,2348
05.06.2019 11:00,2993,45.81,620,672,2373
05.06.2019 12:00,2955,45.41,652,697,2303
05.06.2019 13:00,2943,44.7,699,743,2244
05.06.2019 14:00,2941,44.25,745,782,2196
05.06.2019 15:00,2935,43.17,755,818,2180
05.06.2019 16:00,2956,42.19,817,855,2139
05.06.2019 17:00,2840,42.16,820,848,2020
05.06.2019 18:00,2905,43.46,852,847,2053
05.06.2019 19:00,2755,44.09,803,776,1952
05.06.2019 20:00,2784,44.12,728,722,2056
05.06.2019 21:00,2853,43.91,709,704,2144
05.06.2019 22:00,2751,44.06,676,663,2075
05.06.2019 23:00,2643,43.43,671,663,1972
05.07.2019 00:00,2439,41.34,685,681,1754
05.07.2019 01:00,2393,41.2,685,674,1708
05.07.2019 02:00,2393,39.17,710,673,1683
05.07.2019 03:00,2375,36.08,696,677,1679
05.07.2019 04:00,2412,36.98,712,685,1700
05.07.2019 05:00,2412,36.1,723,692,1689
05.07.2019 06:00,2511,42.71,705,690,1806
05.07.2019 07:00,2845,45.45,704,695,2141
05.07.2019 08:00,3103,47.97,713,721,2390
05.07.2019 09:00,3097,48.66,735,752,2362
05.07.2019 10:00,3069,46.75,762,785,2307
05.07.2019 11:00,3120,46.28,782,817,2338
05.07.2019 12:00,3124,45.41,844,864,2280
05.07.2019 13:00,3029,44.82,882,927,2147
05.07.2019 14:00,2999,44.43,944,986,2055
05.07.2019 15:00,3029,43.78,958,1014,2071
05.07.2019 16:00,2988,43.31,977,1017,2011
05.07.2019 17:00,2973,43.28,972,1002,2001
05.07.2019 18:00,3017,43.94,904,933,2113
05.07.2019 19:00,2967,44.67,770,819,2197
05.07.2019 20:00,2960,45.07,658,689,2302
05.07.2019 21:00,2932,45.05,524,588,2408
05.07.2019 22:00,2804,45.06,445,536,2359
05.07.2019 23:00,2754,44,431,510,2323
05.08.2019 00:00,2591,42.81,399,493,2192
05.08.2019 01:00,2433,41.13,360,293,2073
05.08.2019 02:00,2389,39.03,343,278,2046
05.08.2019 03:00,2406,36.84,337,251,2069
05.08.2019 04:00,2417,40.48,322,223,2095
05.08.2019 05:00,2460,40.18,295,196,2165
05.08.2019 06:00,2482,41.81,245,162,2237
05.08.2019 07:00,2819,44.03,201,127,2618
05.08.2019 08:00,3223,47.92,181,110,3042
05.08.2019 09:00,3291,47.96,200,121,3091
05.08.2019 10:00,3123,46.04,249,152,2874
05.08.2019 11:00,3103,44.66,277,189,2826
05.08.2019 12:00,3000,43.6,319,226,2681
05.08.2019 13:00,2912,43.03,328,260,2584
05.08.2019 14:00,2884,42.62,363,298,2521
05.08.2019 15:00,2787,42.07,408,337,2379
05.08.2019 16:00,2739,41.38,479,372,2260
05.08.2019 17:00,2722,40.66,519,402,2203
05.08.2019 18:00,2768,41.67,537,440,2231
05.08.2019 19:00,2706,41.97,579,486,2127
05.08.2019 20:00,2815,42.18,634,544,2181
05.08.2019 21:00,2791,41.74,726,610,2065
05.08.2019 22:00,2809,40.68,818,675,1991
05.08.2019 23:00,2680,26.82,888,729,1792
05.09.2019 00:00,2440,16.96,944,772,1496
05.09.2019 01:00,2281,33.04,1004,1032,1277
05.09.2019 02:00,2191,32.01,997,1079,1194
05.09.2019 03:00,2217,30.26,1010,1096,1207
05.09.2019 04:00,2293,30.69,1016,1093,1277
05.09.2019 05:00,2369,32.31,1042,1091,1327
05.09.2019 06:00,2424,37.07,1103,1089,1321
05.09.2019 07:00,2751,43.28,1090,1084,1661
05.09.2019 08:00,3068,44.98,1065,1072,2003
05.09.2019 09:00,3120,45.67,1043,1047,2077
05.09.2019 10:00,3208,44.75,991,1033,2217
05.09.2019 11:00,3282,44.03,935,1015,2347
05.09.2019 12:00,3302,43.56,861,969,2441
05.09.2019 13:00,3284,43.53,795,903,2489
05.09.2019 14:00,3269,43.21,719,838,2550
05.09.2019 15:00,3174,43.11,632,762,2542
05.09.2019 16:00,3082,42.64,532,673,2550
05.09.2019 17:00,3028,42.27,471,583,2557
05.09.2019 18:00,3031,41.84,398,509,2633
05.09.2019 19:00,2996,41.05,348,448,2648
05.09.2019 20:00,2960,40.97,307,398,2653
05.09.2019 21:00,2829,41.67,251,395,2578
05.09.2019 22:00,2786,42.4,221,345,2565
05.09.2019 23:00,2623,41.34,203,300,2420
05.10.2019 00:00,2460,34.5,157,263,2303
05.10.2019 01:00,2352,12.35,125,171,2227
05.10.2019 02:00,2296,11.29,117,121,2179
05.10.2019 03:00,2265,7.5,103,102,2162
05.10.2019 04:00,2246,16.03,84,88,2162
05.10.2019 05:00,2255,16.1,79,78,2176
05.10.2019 06:00,2364,38.08,74,67,2290
05.10.2019 07:00,2680,42.55,66,57,2614
05.10.2019 08:00,3003,45.39,61,52,2942
05.10.2019 09:00,3063,45.9,46,51,3017
05.10.2019 10:00,3023,45.66,54,57,2969
05.10.2019 11:00,2966,45.45,60,65,2906
05.10.2019 12:00,2910,44.81,84,79,2826
05.10.2019 13:00,2808,43.66,96,104,2712
05.10.2019 14:00,2752,43.03,132,143,2620
05.10.2019 15:00,2650,42.3,152,185,2498
05.10.2019 16:00,2610,41.9,181,213,2429
05.10.2019 17:00,2586,42.04,196,239,2390
05.10.2019 18:00,2591,42.99,242,254,2349
05.10.2019 19:00,2580,48.9,247,269,2333
05.10.2019 20:00,2528,50.24,235,283,2293
05.10.2019 21:00,2512,50.73,247,297,2265
05.10.2019 22:00,2489,50.21,273,316,2216
05.10.2019 23:00,2440,43.25,271,337,2169
05.11.2019 00:00,2306,42.02,270,351,2036
05.11.2019 01:00,2148,40.68,227,259,1921
05.11.2019 02:00,2021,39.04,227,266,1794
05.11.2019 03:00,2023,37.02,242,263,1781
05.11.2019 04:00,1993,35.64,215,252,1778
05.11.2019 05:00,2037,36.27,213,234,1824
05.11.2019 06:00,2040,35.95,207,205,1833
05.11.2019 07:00,2128,36.58,174,174,1954
05.11.2019 08:00,2268,38.17,141,158,2127
05.11.2019 09:00,2368,41.16,114,164,2254
05.11.2019 10:00,2441,41.97,108,170,2333
05.11.2019 11:00,2417,41,107,180,2310
05.11.2019 12:00,2375,40.77,130,194,2245
05.11.2019 13:00,2306,40.25,168,226,2138
05.11.2019 14:00,2220,39.37,203,263,2017
05.11.2019 15:00,2169,37.98,229,299,1940
05.11.2019 16:00,2141,36.71,273,335,1868
05.11.2019 17:00,2119,36.92,319,363,1800
05.11.2019 18:00,2164,38.2,349,375,1815
05.11.2019 19:00,2200,38.21,370,375,1830
05.11.2019 20:00,2212,39.87,418,383,1794
05.11.2019 21:00,2236,37.88,463,417,1773
05.11.2019 22:00,2282,36.7,495,468,1787
05.11.2019 23:00,2226,31.01,492,511,1734
05.12.2019 00:00,2100,32.46,457,519,1643
05.12.2019 01:00,2033,30,489,483,1544
05.12.2019 02:00,1977,19.97,509,460,1468
05.12.2019 03:00,2003,4.72,479,438,1524
05.12.2019 04:00,1991,2.95,464,422,1527
05.12.2019 05:00,2036,2.02,464,404,1572
05.12.2019 06:00,1997,2.97,399,359,1598
05.12.2019 07:00,2029,3.03,334,295,1695
05.12.2019 08:00,2085,2.98,259,254,1826
05.12.2019 09:00,2166,11.05,246,268,1920
05.12.2019 10:00,2255,19.86,301,326,1954
05.12.2019 11:00,2188,9.69,350,403,1838
05.12.2019 12:00,2235,7.86,427,481,1808
05.12.2019 13:00,2280,9.25,524,556,1756
05.12.2019 14:00,2259,1.97,619,621,1640
05.12.2019 15:00,2223,1.7,653,649,1570
05.12.2019 16:00,2219,1.46,663,648,1556
05.12.2019 17:00,2246,1.8,645,628,1601
05.12.2019 18:00,2335,9.67,613,587,1722
05.12.2019 19:00,2399,20.98,593,530,1806
05.12.2019 20:00,2400,25.81,510,477,1890
05.12.2019 21:00,2513,21.92,450,426,2063
05.12.2019 22:00,2556,31.04,366,396,2190
05.12.2019 23:00,2525,20.09,381,380,2144
13.05.2019 00:00,2353,24.91,355,362,1998
13.05.2019 01:00,2150,16.33,299,302,1851
13.05.2019 02:00,2145,19.21,301,291,1844
13.05.2019 03:00,2147,19.95,298,289,1849
13.05.2019 04:00,2144,19.14,307,291,1837
13.05.2019 05:00,2119,28.15,302,292,1817
13.05.2019 06:00,2218,35.73,290,278,1928
13.05.2019 07:00,2590,45.05,295,256,2295
13.05.2019 08:00,3003,53.01,270,249,2733
13.05.2019 09:00,3022,53.01,269,264,2753
13.05.2019 10:00,2877,47.26,288,309,2589
13.05.2019 11:00,2851,42.27,298,368,2553
13.05.2019 12:00,2901,42.01,379,405,2522
13.05.2019 13:00,2841,41.57,414,428,2427
13.05.2019 14:00,2718,41.46,399,441,2319
13.05.2019 15:00,2637,41.44,398,434,2239
13.05.2019 16:00,2623,41.4,374,415,2249
13.05.2019 17:00,2628,41.38,380,392,2248
13.05.2019 18:00,2631,41.96,345,354,2286
13.05.2019 19:00,2611,43.6,283,300,2328
13.05.2019 20:00,2620,48.95,226,246,2394
13.05.2019 21:00,2601,48.24,199,189,2402
13.05.2019 22:00,2568,47.61,205,157,2363
13.05.2019 23:00,2536,45.76,155,138,2381
14.05.2019 00:00,2420,40.27,147,126,2273
14.05.2019 01:00,2284,38.34,120,95,2164
14.05.2019 02:00,2232,35.83,108,86,2124
14.05.2019 03:00,2285,36.18,101,79,2184
14.05.2019 04:00,2352,35.82,94,76,2258
14.05.2019 05:00,2376,37.38,88,75,2288
14.05.2019 06:00,2458,40.95,80,66,2378
14.05.2019 07:00,2698,49.62,63,56,2635
14.05.2019 08:00,2957,58.75,48,50,2909
14.05.2019 09:00,2981,61.38,38,51,2943
14.05.2019 10:00,2906,59.6,49,63,2857
14.05.2019 11:00,2891,57.51,62,82,2829
14.05.2019 12:00,2850,50.35,67,92,2783
14.05.2019 13:00,2784,47.7,80,92,2704
14.05.2019 14:00,2753,50.3,93,96,2660
14.05.2019 15:00,2708,42.82,136,102,2572
14.05.2019 16:00,2657,42.18,136,108,2521
14.05.2019 17:00,2636,41.95,165,115,2471
14.05.2019 18:00,2677,42.33,185,113,2492
14.05.2019 19:00,2655,49.29,190,102,2465
14.05.2019 20:00,2671,49.28,177,91,2494
14.05.2019 21:00,2639,47.29,134,78,2505
14.05.2019 22:00,2594,48.36,111,72,2483
14.05.2019 23:00,2494,44.11,94,71,2400
15.05.2019 00:00,2313,40.36,82,69,2231
15.05.2019 01:00,2227,37.1,70,59,2157
15.05.2019 02:00,2215,38.92,75,57,2140
15.05.2019 03:00,2225,39.04,79,60,2146
15.05.2019 04:00,2236,39.11,92,64,2144
15.05.2019 05:00,2213,34.99,111,73,2102
15.05.2019 06:00,2237,40.69,112,72,2125
15.05.2019 07:00,2565,46.65,104,69,2461
15.05.2019 08:00,2873,57.13,101,70,2772
15.05.2019 09:00,2956,61.75,122,76,2834
15.05.2019 10:00,2886,59.6,131,91,2755
15.05.2019 11:00,2827,56.66,127,114,2700
15.05.2019 12:00,2848,56.1,155,137,2693
15.05.2019 13:00,2753,46.2,155,159,2598
15.05.2019 14:00,2706,49.84,176,177,2530
15.05.2019 15:00,2625,43.68,186,187,2439
15.05.2019 16:00,2623,42.49,202,188,2421
15.05.2019 17:00,2593,42.15,235,187,2358
15.05.2019 18:00,2618,42.46,259,177,2359
15.05.2019 19:00,2542,48.82,234,164,2308
15.05.2019 20:00,2564,48.21,232,154,2332
15.05.2019 21:00,2556,43.3,224,158,2332
15.05.2019 22:00,2558,42.45,253,177,2305
15.05.2019 23:00,2498,42.13,279,207,2219
16.05.2019 00:00,2301,38.06,316,237,1985
16.05.2019 01:00,2193,33.67,368,392,1825
16.05.2019 02:00,2138,33.67,433,462,1705
16.05.2019 03:00,2074,33.19,499,533,1575
16.05.2019 04:00,2044,31.3,580,600,1464
16.05.2019 05:00,2090,25.68,655,663,1435
16.05.2019 06:00,2191,36.01,709,692,1482
16.05.2019 07:00,2616,41.68,750,691,1866
16.05.2019 08:00,3041,47.21,760,701,2281
16.05.2019 09:00,3083,49.3,797,750,2286
16.05.2019 10:00,2931,45.06,824,842,2107
16.05.2019 11:00,2738,43.17,869,939,1869
16.05.2019 12:00,2675,42.88,968,1013,1707
16.05.2019 13:00,2665,41.7,1054,1054,1611
16.05.2019 14:00,2689,41.46,1071,1077,1618
16.05.2019 15:00,2659,40.93,1075,1084,1584
16.05.2019 16:00,2598,40.25,1083,1087,1515
16.05.2019 17:00,2569,39.33,1076,1084,1493
16.05.2019 18:00,2621,40.34,1096,1082,1525
16.05.2019 19:00,2550,40.97,1077,1072,1473
16.05.2019 20:00,2570,41.77,1059,1061,1511
16.05.2019 21:00,2623,40.58,1037,1060,1586
16.05.2019 22:00,2566,40.39,1037,1070,1529
16.05.2019 23:00,2403,38.89,1049,1085,1354
17.05.2019 00:00,2267,34.97,1049,1087,1218
17.05.2019 01:00,2136,34.84,1063,828,1073
17.05.2019 02:00,2052,34.03,1064,823,988
17.05.2019 03:00,2041,25.95,1069,813,972
17.05.2019 04:00,2078,25.96,1055,804,1023
17.05.2019 05:00,2115,22.85,1050,792,1065
17.05.2019 06:00,2238,36.09,1003,776,1235
17.05.2019 07:00,2686,40.15,955,760,1731
17.05.2019 08:00,3028,45.93,941,752,2087
17.05.2019 09:00,3062,49.9,939,757,2123
17.05.2019 10:00,3072,47.99,913,782,2159
17.05.2019 11:00,3103,45.16,955,821,2148
17.05.2019 12:00,3020,44.92,1045,855,1975
17.05.2019 13:00,2889,43.79,1058,877,1831
17.05.2019 14:00,2854,40.72,1095,889,1759
17.05.2019 15:00,2918,39.15,1115,891,1803
17.05.2019 16:00,2863,38.49,1117,883,1746
17.05.2019 17:00,2739,38.44,1096,862,1643
17.05.2019 18:00,2733,40.11,1034,827,1699
17.05.2019 19:00,2744,47.36,979,781,1765
17.05.2019 20:00,2680,51.65,917,726,1763
17.05.2019 21:00,2647,39.46,836,667,1811
17.05.2019 22:00,2599,39.05,743,606,1856
17.05.2019 23:00,2520,38.14,670,544,1850
18.05.2019 00:00,2379,36.08,594,485,1785
18.05.2019 01:00,2139,30.68,471,471,1668
18.05.2019 02:00,2080,26.01,398,408,1682
18.05.2019 03:00,2045,23.97,340,350,1705
18.05.2019 04:00,2041,22.86,290,300,1751
18.05.2019 05:00,2015,21.87,233,253,1782
18.05.2019 06:00,1979,26.04,203,210,1776
18.05.2019 07:00,2018,33.11,158,174,1860
18.05.2019 08:00,2137,35.58,129,150,2008
18.05.2019 09:00,2249,38.06,107,135,2142
18.05.2019 10:00,2343,38.76,95,130,2248
18.05.2019 11:00,2393,38.28,98,131,2295
18.05.2019 12:00,2366,37.23,97,139,2269
18.05.2019 13:00,2293,36.26,114,150,2179
18.05.2019 14:00,2257,35.51,127,164,2130
18.05.2019 15:00,2210,34.58,126,172,2084
18.05.2019 16:00,2167,34.33,128,179,2039
18.05.2019 17:00,2107,35.19,118,182,1989
18.05.2019 18:00,2163,35.38,121,178,2042
18.05.2019 19:00,2236,38.32,154,177,2082
18.05.2019 20:00,2217,37.91,164,181,2053
18.05.2019 21:00,2230,37.09,154,183,2076
18.05.2019 22:00,2219,37.7,168,192,2051
18.05.2019 23:00,2132,36.21,165,202,1967
19.05.2019 00:00,1961,33.94,173,190,1788
19.05.2019 01:00,1895,38.63,147,155,1748
19.05.2019 02:00,1812,36.02,134,137,1678
19.05.2019 03:00,1728,35,132,124,1596
19.05.2019 04:00,1664,34.03,152,117,1512
19.05.2019 05:00,1635,34.3,134,114,1501
19.05.2019 06:00,1620,34.03,120,115,1500
19.05.2019 07:00,1675,33.37,124,115,1551
19.05.2019 08:00,1757,34.04,124,119,1633
19.05.2019 09:00,1923,36.23,124,121,1799
19.05.2019 10:00,2020,36.8,116,122,1904
19.05.2019 11:00,2105,37.18,113,124,1992
19.05.2019 12:00,2130,37.88,97,130,2033
19.05.2019 13:00,2133,37.4,96,136,2037
19.05.2019 14:00,2126,36.83,118,141,2008
19.05.2019 15:00,2059,36.25,117,146,1942
19.05.2019 16:00,2061,35.85,140,147,1921
19.05.2019 17:00,2125,36.22,176,144,1949
19.05.2019 18:00,2152,37.13,172,147,1980
19.05.2019 19:00,2134,38.91,179,150,1955
19.05.2019 20:00,2177,41.27,172,155,2005
19.05.2019 21:00,2198,40.98,177,158,2021
19.05.2019 22:00,2221,40.71,207,166,2014
19.05.2019 23:00,2123,40.81,227,177,1896
20.05.2019 00:00,1917,38.94,228,179,1689
20.05.2019 01:00,1820,37.3,201,146,1619
20.05.2019 02:00,1804,35,190,130,1614
20.05.2019 03:00,1777,34.55,150,117,1627
20.05.2019 04:00,1800,34.13,131,107,1669
20.05.2019 05:00,1836,33.77,105,97,1731
20.05.2019 06:00,1918,38.13,98,83,1820
20.05.2019 07:00,2317,46.91,76,66,2241
20.05.2019 08:00,2674,60.87,65,54,2609
20.05.2019 09:00,2799,63.22,50,46,2749
20.05.2019 10:00,2784,57.73,42,46,2742
20.05.2019 11:00,2824,56.63,50,49,2774
20.05.2019 12:00,2789,55.5,52,55,2737
20.05.2019 13:00,2763,51.99,62,63,2701
20.05.2019 14:00,2759,50.29,70,71,2689
20.05.2019 15:00,2691,47.59,72,77,2619
20.05.2019 16:00,2665,46.01,81,82,2584
20.05.2019 17:00,2573,45.1,96,87,2477
20.05.2019 18:00,2596,46.09,106,93,2490
20.05.2019 19:00,2506,47.91,132,100,2374
20.05.2019 20:00,2491,49.39,157,109,2334
20.05.2019 21:00,2422,46.02,176,124,2246
20.05.2019 22:00,2317,45.8,209,151,2108
20.05.2019 23:00,2201,43.11,248,180,1953
21.05.2019 00:00,1970,38.59,252,201,1718
21.05.2019 01:00,1876,35.2,287,294,1589
21.05.2019 02:00,1792,34.44,326,294,1466
21.05.2019 03:00,1797,33.12,299,281,1498
21.05.2019 04:00,1795,31.49,314,270,1481
21.05.2019 05:00,1859,32.37,289,256,1570
21.05.2019 06:00,1932,35.38,264,230,1668
21.05.2019 07:00,2269,40.81,225,195,2044
21.05.2019 08:00,2597,50.08,208,168,2389
21.05.2019 09:00,2737,57.61,169,151,2568
21.05.2019 10:00,2776,55,145,148,2631
21.05.2019 11:00,2803,52.52,156,151,2647
21.05.2019 12:00,2785,51.15,146,149,2639
21.05.2019 13:00,2650,49.85,136,147,2514
21.05.2019 14:00,2702,46.27,164,149,2538
21.05.2019 15:00,2691,44.25,171,149,2520
21.05.2019 16:00,2694,42.65,167,150,2527
21.05.2019 17:00,2681,41.86,195,149,2486
21.05.2019 18:00,2721,44.38,198,144,2523
21.05.2019 19:00,2710,45.95,173,139,2537
21.05.2019 20:00,2636,46.96,140,141,2496
21.05.2019 21:00,2547,44.87,120,151,2427
21.05.2019 22:00,2475,44.11,123,172,2352
21.05.2019 23:00,2340,42.57,133,191,2207
22.05.2019 00:00,2107,36.35,135,189,1972
22.05.2019 01:00,1911,32.66,111,123,1800
22.05.2019 02:00,1898,32.5,111,115,1787
22.05.2019 03:00,1880,29.66,107,101,1773
22.05.2019 04:00,1871,29,91,87,1780
22.05.2019 05:00,1824,29.61,69,76,1755
22.05.2019 06:00,1849,35.1,58,62,1791
22.05.2019 07:00,2192,39.78,44,49,2148
22.05.2019 08:00,2556,46.6,34,41,2522
22.05.2019 09:00,2694,50.35,29,40,2665
22.05.2019 10:00,2687,48.37,28,46,2659
22.05.2019 11:00,2686,45.77,27,57,2659
22.05.2019 12:00,2682,42.41,30,71,2652
22.05.2019 13:00,2629,41.12,72,92,2557
22.05.2019 14:00,2555,40.44,98,125,2457
22.05.2019 15:00,2489,39.86,140,166,2349
22.05.2019 16:00,2424,38.65,218,219,2206
22.05.2019 17:00,2402,38.69,329,282,2073
22.05.2019 18:00,2400,40.03,433,335,1967
22.05.2019 19:00,2457,41.82,473,379,1984
22.05.2019 20:00,2473,46.79,519,413,1954
22.05.2019 21:00,2361,47.81,526,416,1835
22.05.2019 22:00,2319,46.99,469,411,1850
22.05.2019 23:00,2279,47.29,467,414,1812
23.05.2019 00:00,2075,38.62,463,424,1612
23.05.2019 01:00,2043,34.94,495,375,1548
23.05.2019 02:00,1943,32.52,510,375,1433
23.05.2019 03:00,1866,31.59,498,369,1368
23.05.2019 04:00,1818,31.08,484,358,1334
23.05.2019 05:00,1866,31.74,461,339,1405
23.05.2019 06:00,1926,35.72,419,312,1507
23.05.2019 07:00,2276,40.56,360,291,1916
23.05.2019 08:00,2581,46.77,351,265,2230
23.05.2019 09:00,2581,47.06,314,247,2267
23.05.2019 10:00,2565,40.86,260,232,2305
23.05.2019 11:00,2632,39.06,263,219,2369
23.05.2019 12:00,2689,38.63,254,205,2435
23.05.2019 13:00,2676,38.22,228,197,2448
23.05.2019 14:00,2679,38.17,228,194,2451
23.05.2019 15:00,2624,38.76,208,196,2416
23.05.2019 16:00,2606,39.01,224,204,2382
23.05.2019 17:00,2576,39.23,224,215,2352
23.05.2019 18:00,2595,42,277,216,2318
23.05.2019 19:00,2551,48.55,273,209,2278
23.05.2019 20:00,2531,52.38,278,202,2253
23.05.2019 21:00,2519,54.04,282,211,2237
23.05.2019 22:00,2402,50.82,321,231,2081
23.05.2019 23:00,2269,48.23,352,249,1917
24.05.2019 00:00,2076,44.19,380,249,1696
24.05.2019 01:00,1923,37.54,388,381,1535
24.05.2019 02:00,1849,35.14,408,375,1441
24.05.2019 03:00,1825,34.28,433,368,1392
24.05.2019 04:00,1825,34.1,442,360,1383
24.05.2019 05:00,1829,33.95,434,352,1395
24.05.2019 06:00,1868,35.99,392,322,1476
24.05.2019 07:00,2217,43.71,349,291,1868
24.05.2019 08:00,2627,49.9,332,290,2295
24.05.2019 09:00,2680,50.95,396,347,2284
24.05.2019 10:00,2625,45.94,456,441,2169
24.05.2019 11:00,2650,43.78,518,550,2132
24.05.2019 12:00,2661,39.54,640,642,2021
24.05.2019 13:00,2629,38.24,774,718,1855
24.05.2019 14:00,2553,37.04,858,775,1695
24.05.2019 15:00,2594,36.52,882,776,1712
24.05.2019 16:00,2425,36.29,877,733,1548
24.05.2019 17:00,2384,36.72,743,671,1641
24.05.2019 18:00,2463,37.82,665,610,1798
24.05.2019 19:00,2470,40.47,627,550,1843
24.05.2019 20:00,2443,42.86,543,499,1900
24.05.2019 21:00,2349,39.82,498,470,1851
24.05.2019 22:00,2246,39.47,465,452,1781
24.05.2019 23:00,2122,38.86,472,447,1650
25.05.2019 00:00,1992,37.95,461,446,1531
25.05.2019 01:00,1954,38.1,505,474,1449
25.05.2019 02:00,1893,36.26,502,471,1391
25.05.2019 03:00,1880,35.07,488,454,1392
25.05.2019 04:00,1879,34.03,445,428,1434
25.05.2019 05:00,1856,33.84,395,400,1461
25.05.2019 06:00,1823,33.09,357,373,1466
25.05.2019 07:00,1924,34.05,344,357,1580
25.05.2019 08:00,2034,35.11,336,349,1698
25.05.2019 09:00,2190,37.28,323,332,1867
25.05.2019 10:00,2248,37.5,295,312,1953
25.05.2019 11:00,2286,36.37,299,300,1987
25.05.2019 12:00,2289,35.9,288,307,2001
25.05.2019 13:00,2282,35.37,318,323,1964
25.05.2019 14:00,2240,34.18,326,345,1914
25.05.2019 15:00,2168,33.09,349,383,1819
25.05.2019 16:00,2182,32.39,380,433,1802
25.05.2019 17:00,2112,33.14,402,486,1710
25.05.2019 18:00,2119,35.11,450,527,1669
25.05.2019 19:00,2114,36.56,499,559,1615
25.05.2019 20:00,2145,37.8,557,587,1588
25.05.2019 21:00,2165,36.99,657,632,1508
25.05.2019 22:00,2193,36.82,712,694,1481
25.05.2019 23:00,2155,36.53,743,745,1412
26.05.2019 00:00,2017,35.61,748,780,1269
26.05.2019 01:00,1849,35.53,773,589,1076
26.05.2019 02:00,1787,32.75,839,622,948
26.05.2019 03:00,1785,29.44,896,656,889
26.05.2019 04:00,1783,28.59,937,693,846
26.05.2019 05:00,1854,23.06,960,728,894
26.05.2019 06:00,1805,18.4,978,760,827
26.05.2019 07:00,1834,14.63,1016,790,818
26.05.2019 08:00,1901,18.65,1046,818,855
26.05.2019 09:00,2054,24.58,1094,843,960
26.05.2019 10:00,2136,23.73,1117,865,1019
26.05.2019 11:00,2322,30.5,1166,886,1156
26.05.2019 12:00,2353,32.2,1153,898,1200
26.05.2019 13:00,2378,30.06,1148,897,1230
26.05.2019 14:00,2349,25.02,1126,884,1223
26.05.2019 15:00,2276,24.95,1073,845,1203
26.05.2019 16:00,2201,26.92,998,781,1203
26.05.2019 17:00,2187,33,939,689,1248
26.05.2019 18:00,2258,35.03,819,579,1439
26.05.2019 19:00,2352,35.42,653,461,1699
26.05.2019 20:00,2402,36.63,498,344,1904
26.05.2019 21:00,2364,37.16,345,247,2019
26.05.2019 22:00,2356,36.59,267,188,2089
26.05.2019 23:00,2232,36.37,192,153,2040
27.05.2019 00:00,2076,33.53,174,130,1902
27.05.2019 01:00,1937,18.67,122,93,1815
27.05.2019 02:00,1874,12.86,119,99,1755
27.05.2019 03:00,1824,12.2,160,122,1664
27.05.2019 04:00,1758,14.09,220,163,1538
27.05.2019 05:00,1747,19.18,280,215,1467
27.05.2019 06:00,1751,29.46,331,257,1420
27.05.2019 07:00,2127,37.97,376,299,1751
27.05.2019 08:00,2564,45.34,450,349,2114
27.05.2019 09:00,2722,42.31,515,399,2207
27.05.2019 10:00,2791,41.35,521,450,2270
27.05.2019 11:00,2813,39.74,465,497,2348
27.05.2019 12:00,2840,39.27,551,532,2289
27.05.2019 13:00,2752,38.55,618,550,2134
27.05.2019 14:00,2660,38.03,608,576,2052
27.05.2019 15:00,2620,37.4,708,595,1912
27.05.2019 16:00,2517,37.08,709,597,1808
27.05.2019 17:00,2519,36.63,796,582,1723
27.05.2019 18:00,2622,38.51,778,543,1844
27.05.2019 19:00,2581,41.57,718,496,1863
27.05.2019 20:00,2576,39.85,619,447,1957
27.05.2019 21:00,2556,39.98,611,404,1945
27.05.2019 22:00,2503,41.47,562,377,1941
27.05.2019 23:00,2432,39.76,520,363,1912
28.05.2019 00:00,2192,37.44,518,359,1674
28.05.2019 01:00,2112,33.26,433,438,1679
28.05.2019 02:00,2089,28.65,427,438,1662
28.05.2019 03:00,2024,25.03,421,426,1603
28.05.2019 04:00,2069,20.88,396,408,1673
28.05.2019 05:00,2041,16.91,403,383,1638
28.05.2019 06:00,2180,35.32,325,346,1855
28.05.2019 07:00,2572,45.71,293,309,2279
28.05.2019 08:00,2888,55.78,271,291,2617
28.05.2019 09:00,2943,63.04,258,290,2685
28.05.2019 10:00,2894,58.51,246,295,2648
28.05.2019 11:00,2943,50.48,274,301,2669
28.05.2019 12:00,2892,47.24,281,323,2611
28.05.2019 13:00,2821,43.87,291,352,2530
28.05.2019 14:00,2752,44.59,292,379,2460
28.05.2019 15:00,2732,41.92,318,402,2414
28.05.2019 16:00,2653,38.39,312,419,2341
28.05.2019 17:00,2598,38.4,344,433,2254
28.05.2019 18:00,2563,38.99,382,438,2181
28.05.2019 19:00,2523,38.94,385,440,2138
28.05.2019 20:00,2577,38.93,407,440,2170
28.05.2019 21:00,2689,38.36,420,447,2269
28.05.2019 22:00,2710,38.4,426,470,2284
28.05.2019 23:00,2578,37.53,438,508,2140
29.05.2019 00:00,2334,33.25,490,541,1844
29.05.2019 01:00,2109,16.95,714,727,1395
29.05.2019 02:00,2092,11.73,758,751,1334
29.05.2019 03:00,2092,15.63,759,757,1333
29.05.2019 04:00,2149,14.91,753,746,1396
29.05.2019 05:00,2109,13.36,758,729,1351
29.05.2019 06:00,2244,32.47,700,707,1544
29.05.2019 07:00,2681,38.52,691,697,1990
29.05.2019 08:00,2822,47.82,726,719,2096
29.05.2019 09:00,2815,49.65,748,724,2067
29.05.2019 10:00,2859,46.77,676,712,2183
29.05.2019 11:00,2935,45.3,657,693,2278
29.05.2019 12:00,2856,43.92,638,678,2218
29.05.2019 13:00,2818,39.91,633,668,2185
29.05.2019 14:00,2760,38.94,601,650,2159
29.05.2019 15:00,2739,38.96,570,624,2169
29.05.2019 16:00,2670,37.37,538,592,2132
29.05.2019 17:00,2629,39.56,489,548,2140
29.05.2019 18:00,2657,44.43,418,471,2239
29.05.2019 19:00,2642,49.06,338,381,2304
29.05.2019 20:00,2610,52.14,260,297,2350
29.05.2019 21:00,2528,52.62,219,248,2309
29.05.2019 22:00,2493,46.62,216,230,2277
29.05.2019 23:00,2380,31.82,210,220,2170
30.05.2019 00:00,2267,31.41,185,215,2082
30.05.2019 01:00,2180,16.98,202,237,1978
30.05.2019 02:00,2078,24.15,261,264,1817
30.05.2019 03:00,2044,22.04,300,295,1744
30.05.2019 04:00,2057,11.44,347,327,1710
30.05.2019 05:00,2035,4.52,423,368,1612
30.05.2019 06:00,2013,5.06,466,403,1547
30.05.2019 07:00,2015,3.83,472,432,1543
30.05.2019 08:00,2130,8.89,502,489,1628
30.05.2019 09:00,2195,10.44,606,606,1589
30.05.2019 10:00,2249,4.5,727,745,1522
30.05.2019 11:00,2332,2.46,856,866,1476
30.05.2019 12:00,2354,2.15,921,954,1433
30.05.2019 13:00,2361,2.23,1029,1020,1332
30.05.2019 14:00,2360,0.79,1075,1071,1285
30.05.2019 15:00,2330,0.58,1124,1093,1206
30.05.2019 16:00,2264,2.24,1098,1097,1166
30.05.2019 17:00,2328,7.18,1106,1095,1222
30.05.2019 18:00,2466,24.5,1125,1075,1341
30.05.2019 19:00,2485,29.42,1155,1040,1330
30.05.2019 20:00,2420,19.97,1095,988,1325
30.05.2019 21:00,2360,4.76,1055,928,1305
30.05.2019 22:00,2306,6.75,985,866,1321
30.05.2019 23:00,2173,7.41,932,804,1241
31.05.2019 00:00,2080,4.12,887,744,1193
31.05.2019 01:00,2031,2.39,896,847,1135
31.05.2019 02:00,1976,2.26,781,769,1195
31.05.2019 03:00,1977,2.38,672,680,1305
31.05.2019 04:00,1956,2.02,557,587,1399
31.05.2019 05:00,1971,1.61,446,491,1525
31.05.2019 06:00,2078,10.1,363,407,1715
31.05.2019 07:00,2318,34.16,303,340,2015
31.05.2019 08:00,2544,40.06,269,292,2275
31.05.2019 09:00,2716,40.49,217,266,2499
31.05.2019 10:00,2748,38.83,209,260,2539
31.05.2019 11:00,2697,37,204,262,2493
31.05.2019 12:00,2654,35.63,177,271,2477
31.05.2019 13:00,2596,34.82,221,286,2375
31.05.2019 14:00,2434,32.77,258,303,2176
31.05.2019 15:00,2371,30,314,315,2057
31.05.2019 16:00,2360,29.14,345,319,2015
31.05.2019 17:00,2387,29.79,346,314,2041
31.05.2019 18:00,2460,36.77,343,292,2117
31.05.2019 19:00,2424,40.05,294,257,2130
31.05.2019 20:00,2405,45.27,250,221,2155
31.05.2019 21:00,2333,46.39,225,203,2108
31.05.2019 22:00,2270,44.57,221,209,2049
31.05.2019 23:00,2230,42.93,229,213,2001
06.01.2019 00:00,2105,33.21,204,199,1901
06.01.2019 01:00,1947,15.63,207,210,1740
06.01.2019 02:00,1858,13.1,220,213,1638
06.01.2019 03:00,1849,6.86,262,217,1587
06.01.2019 04:00,1883,4.93,272,223,1611
06.01.2019 05:00,1832,3.92,286,240,1546
06.01.2019 06:00,1842,4.98,321,265,1521
06.01.2019 07:00,1874,17.02,335,306,1539
06.01.2019 08:00,1994,22.39,387,367,1607
06.01.2019 09:00,2116,29.61,450,444,1666
06.01.2019 10:00,2189,28.68,542,533,1647
06.01.2019 11:00,2275,26.42,610,617,1665
06.01.2019 12:00,2364,25.28,708,702,1656
06.01.2019 13:00,2310,26.69,787,802,1523
06.01.2019 14:00,2239,22.4,863,902,1376
06.01.2019 15:00,2185,18.33,953,967,1232
06.01.2019 16:00,2058,24.71,998,998,1060
06.01.2019 17:00,2082,26.91,1011,1004,1071
06.01.2019 18:00,2146,29.09,1015,977,1131
06.01.2019 19:00,2216,33.04,993,930,1223
06.01.2019 20:00,2197,32.7,869,858,1328
06.01.2019 21:00,2228,30.08,778,771,1450
06.01.2019 22:00,2175,32.29,703,697,1472
06.01.2019 23:00,2193,32.02,647,643,1546
06.02.2019 00:00,2078,20.77,607,602,1471
06.02.2019 01:00,1956,4.99,600,616,1356
06.02.2019 02:00,1877,4.76,566,577,1311
06.02.2019 03:00,1811,3.55,544,532,1267
06.02.2019 04:00,1806,2.85,520,482,1286
06.02.2019 05:00,1770,2.3,473,427,1297
06.02.2019 06:00,1752,2.96,402,368,1350
06.02.2019 07:00,1766,4.77,321,313,1445
06.02.2019 08:00,1832,22.64,272,267,1560
06.02.2019 09:00,1889,25.22,204,229,1685
06.02.2019 10:00,2065,29.91,175,200,1890
06.02.2019 11:00,2161,30.94,169,183,1992
06.02.2019 12:00,2161,30.07,111,168,2050
06.02.2019 13:00,2151,24.97,94,151,2057
06.02.2019 14:00,2117,20,80,136,2037
06.02.2019 15:00,2075,16.34,85,132,1990
06.02.2019 16:00,2022,20.03,76,137,1946
06.02.2019 17:00,2046,24.17,97,142,1949
06.02.2019 18:00,2114,31.28,115,152,1999
06.02.2019 19:00,2200,32.49,136,174,2064
06.02.2019 20:00,2318,36.21,165,215,2153
06.02.2019 21:00,2297,37.22,217,278,2080
06.02.2019 22:00,2188,36.09,313,376,1875
06.02.2019 23:00,2106,35.36,444,494,1662
06.03.2019 00:00,1895,29.85,549,591,1346
06.03.2019 01:00,1835,25.93,701,688,1134
06.03.2019 02:00,1731,22.78,776,747,955
06.03.2019 03:00,1593,20.78,784,759,809
06.03.2019 04:00,1699,19.97,736,729,963
06.03.2019 05:00,1807,19.17,698,686,1109
06.03.2019 06:00,1942,24.04,679,629,1263
06.03.2019 07:00,2301,40.62,615,551,1686
06.03.2019 08:00,2749,44.92,507,469,2242
06.03.2019 09:00,2857,45.02,389,399,2468
06.03.2019 10:00,2811,41.81,319,356,2492
06.03.2019 11:00,2848,39.36,279,329,2569
06.03.2019 12:00,2849,37.71,275,313,2574
06.03.2019 13:00,2743,36.25,280,305,2463
06.03.2019 14:00,2722,35.46,273,298,2449
06.03.2019 15:00,2781,35.23,282,299,2499
06.03.2019 16:00,2544,35.68,274,299,2270
06.03.2019 17:00,2614,35.69,248,290,2366
06.03.2019 18:00,2765,42.97,227,256,2538
06.03.2019 19:00,2614,45.42,187,211,2427
06.03.2019 20:00,2521,49.29,200,186,2321
06.03.2019 21:00,2303,47.81,196,171,2107
06.03.2019 22:00,1882,47.19,193,148,1689
06.03.2019 23:00,455,44.86,153,127,302
06.04.2019 00:00,428,40.41,122,111,306
06.04.2019 01:00,1915,2.91,132,130,1783
06.04.2019 02:00,1817,3,121,133,1696
06.04.2019 03:00,1808,3.21,110,124,1698
06.04.2019 04:00,1914,3.22,166,106,1748
06.04.2019 05:00,1896,2.92,146,85,1750
06.04.2019 06:00,1928,19.99,91,62,1837
06.04.2019 07:00,2185,42.95,38,48,2147
06.04.2019 08:00,2543,50.29,30,39,2513
06.04.2019 09:00,2696,55.43,36,38,2660
06.04.2019 10:00,2693,46.93,31,43,2662
06.04.2019 11:00,2735,42.24,30,49,2705
06.04.2019 12:00,2704,41,23,62,2681
06.04.2019 13:00,2712,37.56,33,82,2679
06.04.2019 14:00,2665,36.5,43,98,2622
06.04.2019 15:00,2666,35.19,52,104,2614
06.04.2019 16:00,2668,34.47,61,104,2607
06.04.2019 17:00,2581,36.65,66,99,2515
06.04.2019 18:00,2591,42.92,63,90,2528
06.04.2019 19:00,2512,45.13,54,77,2458
06.04.2019 20:00,2448,46.17,49,66,2399
06.04.2019 21:00,2374,44.72,54,60,2320
06.04.2019 22:00,2254,38.28,51,58,2203
06.04.2019 23:00,2235,33.83,58,62,2177
06.05.2019 00:00,2085,27.34,71,79,2014
06.05.2019 01:00,1959,26.82,129,127,1830
06.05.2019 02:00,1816,25.23,174,199,1642
06.05.2019 03:00,1786,19.96,241,272,1545
06.05.2019 04:00,1753,16.13,329,342,1424
06.05.2019 05:00,1637,6.08,419,410,1218
06.05.2019 06:00,1729,20.41,478,449,1251
06.05.2019 07:00,2078,32.52,518,453,1560
06.05.2019 08:00,2513,43.44,511,444,2002
06.05.2019 09:00,2681,44.99,528,431,2153
06.05.2019 10:00,2747,43.97,475,420,2272
06.05.2019 11:00,2828,41.38,386,419,2442
06.05.2019 12:00,2810,40.46,370,423,2440
06.05.2019 13:00,2738,38.85,329,426,2409
06.05.2019 14:00,2717,36.32,288,427,2429
06.05.2019 15:00,2668,36.19,246,421,2422
06.05.2019 16:00,2597,38.01,214,403,2383
06.05.2019 17:00,2511,38.93,191,380,2320
06.05.2019 18:00,2525,43.45,214,368,2311
06.05.2019 19:00,2444,48.28,230,365,2214
06.05.2019 20:00,2410,56.52,258,377,2152
06.05.2019 21:00,2344,48.22,306,416,2038
06.05.2019 22:00,2295,31.45,413,479,1882
06.05.2019 23:00,2248,26.92,487,546,1761
06.06.2019 00:00,2047,6.53,508,588,1539
06.06.2019 01:00,1853,2.19,569,592,1284
06.06.2019 02:00,1759,2.7,604,626,1155
06.06.2019 03:00,1714,2.42,627,637,1087
06.06.2019 04:00,1708,2.38,613,632,1095
06.06.2019 05:00,1632,1.83,578,615,1054
06.06.2019 06:00,1648,2.39,558,572,1090
06.06.2019 07:00,1857,8.62,509,517,1348
06.06.2019 08:00,2065,6.84,454,478,1611
06.06.2019 09:00,2231,12.36,477,489,1754
06.06.2019 10:00,2364,19.98,491,549,1873
06.06.2019 11:00,2334,23.12,524,629,1810
06.06.2019 12:00,2253,20.31,631,706,1622
06.06.2019 13:00,2205,11.1,723,771,1482
06.06.2019 14:00,2141,7.43,821,821,1320
06.06.2019 15:00,2137,4.87,841,828,1296
06.06.2019 16:00,2167,4.21,771,802,1396
06.06.2019 17:00,2214,4.23,699,754,1515
06.06.2019 18:00,2247,8.89,597,676,1650
06.06.2019 19:00,2249,13.04,560,582,1689
06.06.2019 20:00,2260,14.52,493,483,1767
06.06.2019 21:00,2259,12.11,368,403,1891
06.06.2019 22:00,2201,13.49,274,351,1927
06.06.2019 23:00,2108,10.46,247,325,1861
06.07.2019 00:00,1989,7.52,230,285,1759
06.07.2019 01:00,1891,7.87,229,237,1662
06.07.2019 02:00,1814,10.92,227,232,1587
06.07.2019 03:00,1785,10.75,191,231,1594
06.07.2019 04:00,1686,10.36,174,234,1512
06.07.2019 05:00,1665,4.83,188,243,1477
06.07.2019 06:00,1770,13.72,197,228,1573
06.07.2019 07:00,1973,55.95,188,209,1785
06.07.2019 08:00,2261,71.98,166,196,2095
06.07.2019 09:00,2457,65.38,152,175,2305
06.07.2019 10:00,2453,44.83,109,155,2344
06.07.2019 11:00,2511,37.21,90,143,2421
06.07.2019 12:00,2511,32.59,50,139,2461
06.07.2019 13:00,2465,30.09,59,142,2406
06.07.2019 14:00,2407,28.39,74,143,2333
06.07.2019 15:00,2347,27.73,74,139,2273
06.07.2019 16:00,2289,27.45,82,126,2207
06.07.2019 17:00,2302,28.66,102,115,2200
06.07.2019 18:00,2336,30.54,115,102,2221
06.07.2019 19:00,2272,38.96,89,82,2183
06.07.2019 20:00,2171,41.03,88,72,2083
06.07.2019 21:00,2095,39.11,105,68,1990
06.07.2019 22:00,2043,32.21,118,70,1925
06.07.2019 23:00,2006,29.32,118,79,1888
06.08.2019 00:00,1915,25.62,112,87,1803
06.08.2019 01:00,1766,10.42,115,123,1651
06.08.2019 02:00,1680,12.68,157,150,1523
06.08.2019 03:00,1551,11.74,206,200,1345
06.08.2019 04:00,1538,5.99,273,258,1265
06.08.2019 05:00,1498,3.85,325,318,1173
06.08.2019 06:00,1563,3.66,315,332,1248
06.08.2019 07:00,1723,3.99,303,313,1420
06.08.2019 08:00,1875,10.4,279,299,1596
06.08.2019 09:00,2044,11.85,243,293,1801
06.08.2019 10:00,2184,16.62,247,291,1937
06.08.2019 11:00,2174,13.76,275,307,1899
06.08.2019 12:00,2101,15.85,338,356,1763
06.08.2019 13:00,2093,13.98,414,422,1679
06.08.2019 14:00,2015,11.54,477,497,1538
06.08.2019 15:00,1936,10.5,524,561,1412
06.08.2019 16:00,1934,9.57,619,604,1315
06.08.2019 17:00,2025,9.65,680,620,1345
06.08.2019 18:00,1912,10.71,690,602,1222
06.08.2019 19:00,1923,10.45,655,566,1268
06.08.2019 20:00,1940,10.23,597,525,1343
06.08.2019 21:00,2029,5.53,606,483,1423
06.08.2019 22:00,2032,3.53,683,461,1349
06.08.2019 23:00,1901,2.29,642,464,1259
06.09.2019 00:00,1880,1.63,589,492,1291
06.09.2019 01:00,1862,4.54,719,687,1143
06.09.2019 02:00,1733,2.42,753,724,980
06.09.2019 03:00,1617,1.85,770,768,847
06.09.2019 04:00,1545,0.83,726,814,819
06.09.2019 05:00,1521,0.51,774,858,747
06.09.2019 06:00,1526,0.86,796,889,730
06.09.2019 07:00,1610,1.92,857,924,753
06.09.2019 08:00,1763,2.9,945,981,818
06.09.2019 09:00,1849,11,980,1027,869
06.09.2019 10:00,1922,10.47,985,1042,937
06.09.2019 11:00,1964,5.28,1021,1034,943
06.09.2019 12:00,2007,12.26,1007,998,1000
06.09.2019 13:00,2016,14.6,964,938,1052
06.09.2019 14:00,2036,13.26,913,869,1123
06.09.2019 15:00,1982,14.57,836,789,1146
06.09.2019 16:00,2011,12.5,731,691,1280
06.09.2019 17:00,2061,11.73,634,587,1427
06.09.2019 18:00,2132,13.34,532,482,1600
06.09.2019 19:00,2160,43.32,412,381,1748
06.09.2019 20:00,2200,47.6,319,296,1881
06.09.2019 21:00,2229,49.32,269,241,1960
06.09.2019 22:00,2151,46.02,225,214,1926
06.09.2019 23:00,2100,24.05,199,200,1901
06.10.2019 00:00,1973,10.04,178,181,1795
06.10.2019 01:00,1855,1.76,131,105,1724
06.10.2019 02:00,1803,1.16,135,86,1668
06.10.2019 03:00,1790,1.49,109,77,1681
06.10.2019 04:00,1787,1.65,108,76,1679
06.10.2019 05:00,1748,1.61,105,79,1643
06.10.2019 06:00,1866,3.08,85,73,1781
06.10.2019 07:00,2187,26.84,74,64,2113
06.10.2019 08:00,2515,30.03,74,66,2441
06.10.2019 09:00,2654,33.54,77,79,2577
06.10.2019 10:00,2696,30.92,100,107,2596
06.10.2019 11:00,2734,30.06,140,143,2594
06.10.2019 12:00,2684,29.55,181,175,2503
06.10.2019 13:00,2660,28.69,241,205,2419
06.10.2019 14:00,2623,27.13,307,232,2316
06.10.2019 15:00,2606,27.3,319,247,2287
06.10.2019 16:00,2652,27.45,334,254,2318
06.10.2019 17:00,2552,28.08,354,259,2198
06.10.2019 18:00,2525,30.92,351,268,2174
06.10.2019 19:00,2491,36.48,358,281,2133
06.10.2019 20:00,2434,39.04,358,301,2076
06.10.2019 21:00,2427,39.85,425,323,2002
06.10.2019 22:00,2371,34.5,416,347,1955
06.10.2019 23:00,2279,33.57,402,378,1877
06.11.2019 00:00,2053,23.03,456,402,1597
06.11.2019 01:00,1956,14.86,578,642,1378
06.11.2019 02:00,1905,9.69,629,678,1276
06.11.2019 03:00,1824,10.04,649,701,1175
06.11.2019 04:00,1768,4.4,662,717,1106
06.11.2019 05:00,1759,3.21,688,747,1071
06.11.2019 06:00,1818,11.61,728,776,1090
06.11.2019 07:00,2274,42.06,744,793,1530
06.11.2019 08:00,2716,46.25,791,805,1925
06.11.2019 09:00,2900,51.58,769,782,2131
06.11.2019 10:00,3027,48.83,737,753,2290
06.11.2019 11:00,3019,51.46,739,736,2280
06.11.2019 12:00,2941,52.73,710,710,2231
06.11.2019 13:00,2931,46.24,733,691,2198
06.11.2019 14:00,2947,44.62,725,664,2222
06.11.2019 15:00,2890,44,693,648,2197
06.11.2019 16:00,2761,45.36,719,642,2042
06.11.2019 17:00,2615,48.6,779,650,1836
06.11.2019 18:00,2612,54.64,811,663,1801
06.11.2019 19:00,2633,57.95,795,688,1838
06.11.2019 20:00,2710,31.81,871,725,1839
06.11.2019 21:00,2637,28.11,880,748,1757
06.11.2019 22:00,2523,20.73,898,772,1625
06.11.2019 23:00,2432,7.77,876,796,1556
06.12.2019 00:00,2332,3.36,914,807,1418
06.12.2019 01:00,2125,2.05,909,903,1216
06.12.2019 02:00,2040,2.46,906,896,1134
06.12.2019 03:00,2031,2.23,897,893,1134
06.12.2019 04:00,2049,2.41,881,901,1168
06.12.2019 05:00,2061,2.08,889,912,1172
06.12.2019 06:00,2259,12.8,876,915,1383
06.12.2019 07:00,2481,28.7,927,915,1554
06.12.2019 08:00,2564,55.15,888,915,1676
06.12.2019 09:00,2767,61.11,880,909,1887
06.12.2019 10:00,2820,56.11,895,931,1925
06.12.2019 11:00,2938,50.66,1002,950,1936
06.12.2019 12:00,2935,49.33,1017,962,1918
06.12.2019 13:00,2870,33.86,979,977,1891
06.12.2019 14:00,3037,33.74,971,991,2066
06.12.2019 15:00,3017,33.7,909,992,2108
06.12.2019 16:00,2859,33,871,985,1988
06.12.2019 17:00,2776,32.39,863,967,1913
06.12.2019 18:00,2755,32.11,888,929,1867
06.12.2019 19:00,2594,31.61,842,866,1752
06.12.2019 20:00,2544,31.51,781,787,1763
06.12.2019 21:00,2537,30.11,738,736,1799
06.12.2019 22:00,2504,29.6,703,704,1801
06.12.2019 23:00,2372,27.06,707,671,1665
13.06.2019 00:00,2278,18.89,577,573,1701
13.06.2019 01:00,2162,3.06,463,485,1699
13.06.2019 02:00,2129,10.01,382,386,1747
13.06.2019 03:00,2003,15.65,279,305,1724
13.06.2019 04:00,1974,14.46,268,279,1706
13.06.2019 05:00,1970,10.48,257,281,1713
13.06.2019 06:00,2116,24.09,262,272,1854
13.06.2019 07:00,2457,36.55,250,266,2207
13.06.2019 08:00,2655,48.01,247,262,2408
13.06.2019 09:00,2695,44.49,198,227,2497
13.06.2019 10:00,2770,36.42,198,224,2572
13.06.2019 11:00,2827,32.9,205,224,2622
13.06.2019 12:00,2850,30.58,190,216,2660
13.06.2019 13:00,2793,29.36,124,203,2669
13.06.2019 14:00,2746,28.73,102,155,2644
13.06.2019 15:00,2716,29.56,103,144,2613
13.06.2019 16:00,2728,30.03,100,133,2628
13.06.2019 17:00,2612,31.11,117,124,2495
13.06.2019 18:00,2641,33.68,131,145,2510
13.06.2019 19:00,2531,50.09,121,134,2410
13.06.2019 20:00,2495,62.7,128,127,2367
13.06.2019 21:00,2477,72.94,136,132,2341
13.06.2019 22:00,2383,61.1,173,149,2210
13.06.2019 23:00,2294,46.27,168,174,2126
14.06.2019 00:00,2153,30.61,190,185,1963
14.06.2019 01:00,2022,28.33,225,274,1797
14.06.2019 02:00,1879,25.99,195,264,1684
14.06.2019 03:00,1764,25.01,220,247,1544
14.06.2019 04:00,1728,22.66,234,239,1494
14.06.2019 05:00,1863,23.11,225,231,1638
14.06.2019 06:00,2021,28.61,178,205,1843
14.06.2019 07:00,2298,39.28,145,174,2153
14.06.2019 08:00,2587,52.94,122,149,2465
14.06.2019 09:00,2655,59.61,90,137,2565
14.06.2019 10:00,2624,49.04,75,144,2549
14.06.2019 11:00,2612,42.91,69,158,2543
14.06.2019 12:00,2772,40.02,115,181,2657
14.06.2019 13:00,2646,34.06,83,209,2563
14.06.2019 14:00,2525,32.41,91,205,2434
14.06.2019 15:00,2466,32.48,99,220,2367
14.06.2019 16:00,2504,33.24,157,234,2347
14.06.2019 17:00,2427,35.47,164,245,2263
14.06.2019 18:00,2403,44.86,176,243,2227
14.06.2019 19:00,2337,32.95,184,235,2153
14.06.2019 20:00,2256,32.82,170,231,2086
14.06.2019 21:00,2154,31.44,185,244,1969
14.06.2019 22:00,2118,30.94,252,278,1866
14.06.2019 23:00,2154,30.26,257,313,1897
15.06.2019 00:00,2131,27.82,286,337,1845
15.06.2019 01:00,1892,28.13,284,354,1608
15.06.2019 02:00,1766,27.37,289,369,1477
15.06.2019 03:00,1665,22.97,306,391,1359
15.06.2019 04:00,1659,20.01,337,410,1322
15.06.2019 05:00,1609,18.08,370,429,1239
15.06.2019 06:00,1616,19.91,387,440,1229
15.06.2019 07:00,1754,21.45,386,442,1368
15.06.2019 08:00,1939,24.59,403,443,1536
15.06.2019 09:00,2101,28.51,423,457,1678
15.06.2019 10:00,2220,29.56,452,484,1768
15.06.2019 11:00,2225,29.41,435,521,1790
15.06.2019 12:00,2193,27.47,467,576,1726
15.06.2019 13:00,2213,25.38,520,643,1693
15.06.2019 14:00,2387,24.93,540,709,1847
15.06.2019 15:00,2392,23.54,616,773,1776
15.06.2019 16:00,2253,23.64,709,829,1544
15.06.2019 17:00,2043,24.32,706,871,1337
15.06.2019 18:00,2085,28.27,718,886,1367
15.06.2019 19:00,2212,28.54,789,879,1423
15.06.2019 20:00,2158,27.31,828,849,1330
15.06.2019 21:00,2081,23.93,790,815,1291
15.06.2019 22:00,2057,22.61,727,791,1330
15.06.2019 23:00,2216,19.22,690,758,1526
16.06.2019 00:00,2187,15.44,643,696,1544
16.06.2019 01:00,2080,21.86,521,530,1559
16.06.2019 02:00,1933,20.75,387,436,1546
16.06.2019 03:00,1849,19.79,314,375,1535
16.06.2019 04:00,1820,17.5,262,343,1558
16.06.2019 05:00,1796,14.09,222,326,1574
16.06.2019 06:00,1771,17.97,236,310,1535
16.06.2019 07:00,1837,19.94,222,311,1615
16.06.2019 08:00,1973,25.31,251,341,1722
16.06.2019 09:00,2065,27.67,290,374,1775
16.06.2019 10:00,2194,28.04,293,408,1901
16.06.2019 11:00,2255,27.44,316,437,1939
16.06.2019 12:00,2261,27.98,333,453,1928
16.06.2019 13:00,2269,27.17,335,462,1934
16.06.2019 14:00,2247,23.92,346,371,1901
16.06.2019 15:00,2258,23.1,333,366,1925
16.06.2019 16:00,2206,24.65,326,356,1880
16.06.2019 17:00,2129,25.16,329,344,1800
16.06.2019 18:00,2201,25.91,310,323,1891
16.06.2019 19:00,2280,28.02,294,294,1986
16.06.2019 20:00,2293,28.7,273,260,2020
16.06.2019 21:00,2263,27.92,270,246,1993
16.06.2019 22:00,2208,27.38,292,254,1916
16.06.2019 23:00,2196,25.66,285,270,1911
17.06.2019 00:00,2068,19.97,295,276,1773
17.06.2019 01:00,1877,18.27,274,340,1603
17.06.2019 02:00,1798,17.03,279,345,1519
17.06.2019 03:00,1812,17.24,278,330,1534
17.06.2019 04:00,1809,15.73,278,301,1531
17.06.2019 05:00,1715,11.74,243,267,1472
17.06.2019 06:00,1847,25.68,194,220,1653
17.06.2019 07:00,2226,31.27,142,173,2084
17.06.2019 08:00,2575,33.32,106,155,2469
17.06.2019 09:00,2651,34.86,119,174,2532
17.06.2019 10:00,2626,34.68,148,213,2478
17.06.2019 11:00,2654,33.53,181,256,2473
17.06.2019 12:00,2705,32.62,230,297,2475
17.06.2019 13:00,2721,32.9,279,337,2442
17.06.2019 14:00,2714,32.42,285,377,2429
17.06.2019 15:00,2723,32.64,325,396,2398
17.06.2019 16:00,2770,31.66,382,395,2388
17.06.2019 17:00,2662,30.74,359,385,2303
17.06.2019 18:00,2627,31.27,332,355,2295
17.06.2019 19:00,2548,31.46,283,311,2265
17.06.2019 20:00,2474,31.42,243,263,2231
17.06.2019 21:00,2406,29.76,223,231,2183
17.06.2019 22:00,2365,28.18,204,222,2161
17.06.2019 23:00,2319,23.24,199,223,2120
18.06.2019 00:00,2089,19.74,169,221,1920
18.06.2019 01:00,1920,17.77,159,227,1761
18.06.2019 02:00,1901,17.75,163,226,1738
18.06.2019 03:00,1967,16.21,210,228,1757
18.06.2019 04:00,1951,14.09,203,238,1748
18.06.2019 05:00,1915,10.1,231,255,1684
18.06.2019 06:00,1964,22.06,221,263,1743
18.06.2019 07:00,2211,31.4,205,260,2006
18.06.2019 08:00,2566,50.5,218,260,2348
18.06.2019 09:00,2690,48.56,258,289,2432
18.06.2019 10:00,2685,42.69,337,341,2348
18.06.2019 11:00,2710,38.96,343,393,2367
18.06.2019 12:00,2751,37.97,415,442,2336
18.06.2019 13:00,2733,36.23,445,486,2288
18.06.2019 14:00,2783,33.52,467,517,2316
18.06.2019 15:00,2767,32.85,474,528,2293
18.06.2019 16:00,2731,31.16,488,521,2243
18.06.2019 17:00,2635,29.44,479,504,2156
18.06.2019 18:00,2612,30.4,434,480,2178
18.06.2019 19:00,2588,31.5,403,454,2185
18.06.2019 20:00,2607,31.42,399,434,2208
18.06.2019 21:00,2498,29.38,403,435,2095
18.06.2019 22:00,2376,27.88,401,467,1975
18.06.2019 23:00,2296,24.82,457,508,1839
19.06.2019 00:00,2149,20.52,447,524,1702
19.06.2019 01:00,2000,4.1,395,405,1605
19.06.2019 02:00,1950,14.08,385,389,1565
19.06.2019 03:00,1921,17.59,386,363,1535
19.06.2019 04:00,1923,16.76,352,333,1571
19.06.2019 05:00,1966,14.01,328,303,1638
19.06.2019 06:00,2089,24.92,297,262,1792
19.06.2019 07:00,2393,43.07,243,213,2150
19.06.2019 08:00,2690,54.43,178,177,2512
19.06.2019 09:00,2800,58.64,163,168,2637
19.06.2019 10:00,2814,49.28,152,177,2662
19.06.2019 11:00,2885,42.98,140,201,2745
19.06.2019 12:00,2855,40.81,160,231,2695
19.06.2019 13:00,2815,37.01,175,265,2640
19.06.2019 14:00,2812,36.93,206,301,2606
19.06.2019 15:00,2747,36.29,273,328,2474
19.06.2019 16:00,2726,36.09,311,343,2415
19.06.2019 17:00,2654,34.91,343,349,2311
19.06.2019 18:00,2706,42.91,357,347,2349
19.06.2019 19:00,2708,49.94,334,335,2374
19.06.2019 20:00,2673,53.17,337,331,2336
19.06.2019 21:00,2641,49.85,344,350,2297
19.06.2019 22:00,2475,44.55,385,387,2090
19.06.2019 23:00,2349,39.12,412,417,1937
20.06.2019 00:00,2244,28.86,374,411,1870
20.06.2019 01:00,2187,28.95,376,430,1811
20.06.2019 02:00,2054,28.43,360,397,1694
20.06.2019 03:00,2000,27.34,318,358,1682
20.06.2019 04:00,1935,25.07,271,322,1664
20.06.2019 05:00,1873,18.7,222,287,1651
20.06.2019 06:00,2001,23.05,196,242,1805
20.06.2019 07:00,2301,30.71,146,189,2155
20.06.2019 08:00,2687,35.23,126,150,2561
20.06.2019 09:00,2804,39.68,129,158,2675
20.06.2019 10:00,2883,36.91,144,208,2739
20.06.2019 11:00,2922,35.69,142,281,2780
20.06.2019 12:00,2856,36.98,182,347,2674
20.06.2019 13:00,2817,35.21,233,398,2584
20.06.2019 14:00,2734,33.27,296,350,2438
20.06.2019 15:00,2715,32.37,348,360,2367
20.06.2019 16:00,2618,33.11,357,355,2261
20.06.2019 17:00,2474,32.73,416,344,2058
20.06.2019 18:00,2420,35.83,415,311,2005
20.06.2019 19:00,2443,30.55,367,263,2076
20.06.2019 20:00,2383,43.75,296,213,2087
20.06.2019 21:00,2238,44.72,276,173,1962
20.06.2019 22:00,2117,28.46,247,147,1870
20.06.2019 23:00,2111,25.38,219,137,1892
21.06.2019 00:00,1961,16.95,216,135,1745
21.06.2019 01:00,1803,24.89,202,210,1601
21.06.2019 02:00,1704,23.22,196,189,1508
21.06.2019 03:00,1682,20.41,188,168,1494
21.06.2019 04:00,1641,18.76,160,145,1481
21.06.2019 05:00,1581,14.06,134,120,1447
21.06.2019 06:00,1570,24.13,101,89,1469
21.06.2019 07:00,1712,27.45,88,70,1624
21.06.2019 08:00,1852,28.24,69,72,1783
21.06.2019 09:00,2003,45.96,73,88,1930
21.06.2019 10:00,2111,43.34,87,118,2024
21.06.2019 11:00,2161,42.88,117,156,2044
21.06.2019 12:00,2203,40.06,147,202,2056
21.06.2019 13:00,2220,35.34,191,257,2029
21.06.2019 14:00,2163,32.73,241,317,1922
21.06.2019 15:00,2112,28.53,297,368,1815
21.06.2019 16:00,2012,27.77,343,401,1669
21.06.2019 17:00,1955,28.39,361,430,1594
21.06.2019 18:00,1966,28.41,367,435,1599
21.06.2019 19:00,1919,28.54,373,424,1546
21.06.2019 20:00,1840,28.08,396,411,1444
21.06.2019 21:00,1801,25.01,385,402,1416
21.06.2019 22:00,1749,25.65,406,402,1343
21.06.2019 23:00,1798,24.7,447,415,1351
22.06.2019 00:00,1804,21.02,415,433,1389
22.06.2019 01:00,1738,25.02,437,460,1301
22.06.2019 02:00,1633,21.14,455,471,1178
22.06.2019 03:00,1592,15.02,462,474,1130
22.06.2019 04:00,1512,2.91,459,462,1053
22.06.2019 05:00,1466,1.5,478,444,988
22.06.2019 06:00,1512,2.4,437,414,1075
22.06.2019 07:00,1630,15.02,421,389,1209
22.06.2019 08:00,1662,23.92,443,388,1219
22.06.2019 09:00,1667,23.11,393,384,1274
22.06.2019 10:00,1761,23.96,356,368,1405
22.06.2019 11:00,1893,24.7,386,351,1507
22.06.2019 12:00,2013,25.37,380,343,1633
22.06.2019 13:00,2034,24.9,347,342,1687
22.06.2019 14:00,1990,24.31,325,342,1665
22.06.2019 15:00,1972,24.31,296,342,1676
22.06.2019 16:00,1960,23.47,277,334,1683
22.06.2019 17:00,1968,23.2,260,318,1708
22.06.2019 18:00,2012,32.35,243,284,1769
22.06.2019 19:00,2051,33.89,218,245,1833
22.06.2019 20:00,2013,37,199,208,1814
22.06.2019 21:00,1990,34.53,185,190,1805
22.06.2019 22:00,1968,31.84,197,194,1771
22.06.2019 23:00,1929,24.96,204,206,1725
23.06.2019 00:00,1827,22.87,197,207,1630
23.06.2019 01:00,1681,21.39,195,206,1486
23.06.2019 02:00,1568,16.92,185,193,1383
23.06.2019 03:00,1566,14.05,186,171,1380
23.06.2019 04:00,1638,8.22,176,141,1462
23.06.2019 05:00,1621,4.91,156,115,1465
23.06.2019 06:00,1555,14.07,117,81,1438
23.06.2019 07:00,1614,20.68,68,51,1546
23.06.2019 08:00,1694,21.89,46,41,1648
23.06.2019 09:00,1802,25.78,39,42,1763
23.06.2019 10:00,1902,25.72,34,53,1868
23.06.2019 11:00,1959,25.37,25,66,1934
23.06.2019 12:00,1976,24.17,25,80,1951
23.06.2019 13:00,1983,22.04,31,94,1952
23.06.2019 14:00,1963,21.8,41,108,1922
23.06.2019 15:00,1922,22.14,61,117,1861
23.06.2019 16:00,1915,23.3,77,120,1838
23.06.2019 17:00,1935,26.48,95,121,1840
23.06.2019 18:00,1970,27.03,102,115,1868
23.06.2019 19:00,2045,28.75,109,105,1936
23.06.2019 20:00,2097,34.75,107,99,1990
23.06.2019 21:00,2111,35.47,109,98,2002
23.06.2019 22:00,2040,31.13,121,109,1919
23.06.2019 23:00,2037,29.77,131,130,1906
24.06.2019 00:00,1918,27.04,128,143,1790
24.06.2019 01:00,1776,26.32,138,142,1638
24.06.2019 02:00,1678,25.07,167,154,1511
24.06.2019 03:00,1632,23.43,177,166,1455
24.06.2019 04:00,1642,24.01,180,171,1462
24.06.2019 05:00,1612,21.68,189,170,1423
24.06.2019 06:00,1752,25.97,202,142,1550
24.06.2019 07:00,2116,32.29,170,100,1946
24.06.2019 08:00,2500,35.13,138,71,2362
24.06.2019 09:00,2666,42.78,113,62,2553
24.06.2019 10:00,2720,36.24,82,65,2638
24.06.2019 11:00,2731,33.75,50,66,2681
24.06.2019 12:00,2736,33.47,46,73,2690
24.06.2019 13:00,2687,33.46,50,81,2637
24.06.2019 14:00,2661,33.03,66,84,2595
24.06.2019 15:00,2621,32.82,95,96,2526
24.06.2019 16:00,2663,32.22,98,108,2565
24.06.2019 17:00,2602,32.78,119,114,2483
24.06.2019 18:00,2523,35.34,139,113,2384
24.06.2019 19:00,2405,45.06,151,118,2254
24.06.2019 20:00,2406,55.42,174,131,2232
24.06.2019 21:00,2354,52.71,206,145,2148
24.06.2019 22:00,2261,39.94,239,163,2022
24.06.2019 23:00,2220,32.06,279,187,1941
25.06.2019 00:00,1973,28.82,310,201,1663
25.06.2019 01:00,1784,25.24,336,311,1448
25.06.2019 02:00,1773,24.78,366,329,1407
25.06.2019 03:00,1784,23.7,384,343,1400
25.06.2019 04:00,1775,23.09,394,350,1381
25.06.2019 05:00,1711,20.04,409,355,1302
25.06.2019 06:00,1807,27.29,371,327,1436
25.06.2019 07:00,2246,32.69,322,278,1924
25.06.2019 08:00,2643,42.86,271,236,2372
25.06.2019 09:00,2786,49.18,235,220,2551
25.06.2019 10:00,2794,39.98,230,224,2564
25.06.2019 11:00,2833,37.77,192,236,2641
25.06.2019 12:00,2853,36.45,181,249,2672
25.06.2019 13:00,2807,34.92,175,262,2632
25.06.2019 14:00,2805,33.8,182,274,2623
25.06.2019 15:00,2765,33.9,196,287,2569
25.06.2019 16:00,2696,34.91,225,294,2471
25.06.2019 17:00,2578,36.05,239,293,2339
25.06.2019 18:00,2588,48.04,267,278,2321
25.06.2019 19:00,2565,60.05,264,257,2301
25.06.2019 20:00,2532,72.12,247,243,2285
25.06.2019 21:00,2444,60.44,242,250,2202
25.06.2019 22:00,2344,60.43,273,280,2071
25.06.2019 23:00,2276,31.64,314,316,1962
26.06.2019 00:00,2026,30.32,338,332,1688
26.06.2019 01:00,1861,25.06,344,356,1517
26.06.2019 02:00,1759,25.09,327,352,1432
26.06.2019 03:00,1721,24.98,304,328,1417
26.06.2019 04:00,1776,24.83,277,295,1499
26.06.2019 05:00,1737,23.86,251,260,1486
26.06.2019 06:00,1817,28.26,190,216,1627
26.06.2019 07:00,2116,43.38,141,170,1975
26.06.2019 08:00,2462,59.82,109,137,2353
26.06.2019 09:00,2715,60.08,117,122,2598
26.06.2019 10:00,2779,48.44,100,129,2679
26.06.2019 11:00,2811,38.09,76,152,2735
26.06.2019 12:00,2830,36.7,83,200,2747
26.06.2019 13:00,2805,35.08,140,282,2665
26.06.2019 14:00,2811,33.09,209,398,2602
26.06.2019 15:00,2698,31.88,282,510,2416
26.06.2019 16:00,2682,30.89,415,610,2267
26.06.2019 17:00,2626,30.71,589,704,2037
26.06.2019 18:00,2606,33.45,679,750,1927
26.06.2019 19:00,2547,35.16,771,763,1776
26.06.2019 20:00,2552,30.73,766,751,1786
26.06.2019 21:00,2435,30.04,696,710,1739
26.06.2019 22:00,2360,29.36,644,667,1716
26.06.2019 23:00,2311,27.82,630,645,1681
27.06.2019 00:00,2135,15.84,624,637,1511
27.06.2019 01:00,1897,23.24,552,589,1345
27.06.2019 02:00,1776,23.86,559,597,1217
27.06.2019 03:00,1741,22.46,550,583,1191
27.06.2019 04:00,1775,21.32,529,557,1246
27.06.2019 05:00,1759,16.47,494,524,1265
27.06.2019 06:00,1780,23.37,434,479,1346
27.06.2019 07:00,2127,28.62,385,436,1742
27.06.2019 08:00,2474,42.25,371,408,2103
27.06.2019 09:00,2617,41.09,334,379,2283
27.06.2019 10:00,2660,36.5,277,353,2383
27.06.2019 11:00,2703,34.56,259,338,2444
27.06.2019 12:00,2739,34.47,272,348,2467
27.06.2019 13:00,2721,31.97,304,373,2417
27.06.2019 14:00,2776,30.93,326,402,2450
27.06.2019 15:00,2776,30.91,327,430,2449
27.06.2019 16:00,2740,30.56,340,447,2400
27.06.2019 17:00,2620,31.17,338,456,2282
27.06.2019 18:00,2607,35.11,309,444,2298
27.06.2019 19:00,2534,40.9,288,412,2246
27.06.2019 20:00,2496,52.81,265,378,2231
27.06.2019 21:00,2424,50.98,240,342,2184
27.06.2019 22:00,2369,42.96,239,322,2130
27.06.2019 23:00,2312,30.03,249,318,2063
28.06.2019 00:00,2136,28.38,242,314,1894
28.06.2019 01:00,1985,26.04,245,247,1740
28.06.2019 02:00,1891,26.08,263,235,1628
28.06.2019 03:00,1912,25.96,279,230,1633
28.06.2019 04:00,1912,26.06,292,234,1620
28.06.2019 05:00,1810,25.37,274,238,1536
28.06.2019 06:00,1873,29.4,218,198,1655
28.06.2019 07:00,2231,48.22,164,138,2067
28.06.2019 08:00,2545,60.49,129,101,2416
28.06.2019 09:00,2729,60.18,105,89,2624
28.06.2019 10:00,2702,49.28,91,95,2611
28.06.2019 11:00,2729,43.99,65,113,2664
28.06.2019 12:00,2683,39.53,75,141,2608
28.06.2019 13:00,2658,36.75,105,182,2553
28.06.2019 14:00,2625,34.33,141,222,2484
28.06.2019 15:00,2586,33.08,184,256,2402
28.06.2019 16:00,2523,33.1,225,285,2298
28.06.2019 17:00,2474,33.57,264,311,2210
28.06.2019 18:00,2451,38.11,259,305,2192
28.06.2019 19:00,2380,52.83,246,276,2134
28.06.2019 20:00,2307,64.93,228,246,2079
28.06.2019 21:00,2211,63.44,211,226,2000
28.06.2019 22:00,2132,29.79,219,221,1913
28.06.2019 23:00,2086,28.69,205,231,1881
29.06.2019 00:00,2010,25.38,222,246,1788
29.06.2019 01:00,1854,24.14,232,251,1622
29.06.2019 02:00,1811,22.23,264,264,1547
29.06.2019 03:00,1720,21.94,295,276,1425
29.06.2019 04:00,1644,18.61,281,275,1363
29.06.2019 05:00,1584,13.54,282,266,1302
29.06.2019 06:00,1648,15.04,295,241,1353
29.06.2019 07:00,1786,22.98,300,220,1486
29.06.2019 08:00,1955,24.93,271,225,1684
29.06.2019 09:00,2136,25.43,306,261,1830
29.06.2019 10:00,2185,26.92,308,311,1877
29.06.2019 11:00,2256,27.4,349,369,1907
29.06.2019 12:00,2290,27.34,407,427,1883
29.06.2019 13:00,2260,27.34,448,483,1812
29.06.2019 14:00,2269,25.2,484,533,1785
29.06.2019 15:00,2204,24.46,502,559,1702
29.06.2019 16:00,2175,24.59,498,565,1677
29.06.2019 17:00,2221,25.76,498,561,1723
29.06.2019 18:00,2323,29.45,484,545,1839
29.06.2019 19:00,2312,35.02,467,515,1845
29.06.2019 20:00,2304,25.64,436,489,1868
29.06.2019 21:00,2244,25.16,427,464,1817
29.06.2019 22:00,2145,25.02,428,447,1717
29.06.2019 23:00,2066,23.63,427,447,1639
30.06.2019 00:00,1911,22.24,441,441,1470
30.06.2019 01:00,1749,24.05,458,461,1291
30.06.2019 02:00,1631,23.74,451,440,1180
30.06.2019 03:00,1551,21.04,427,416,1124
30.06.2019 04:00,1525,17.13,393,388,1132
30.06.2019 05:00,1495,14.92,353,353,1142
30.06.2019 06:00,1425,10.16,297,301,1128
30.06.2019 07:00,1521,12.68,235,243,1286
30.06.2019 08:00,1662,15.03,192,207,1470
30.06.2019 09:00,1855,21.35,192,214,1663
30.06.2019 10:00,2014,22.23,210,256,1804
30.06.2019 11:00,2136,23.13,252,325,1884
30.06.2019 12:00,2158,23.63,344,432,1814
30.06.2019 13:00,2148,24.23,483,562,1665
30.06.2019 14:00,2136,23.58,615,696,1521
30.06.2019 15:00,2092,21.03,733,812,1359
30.06.2019 16:00,2077,4.84,812,921,1265
30.06.2019 17:00,2140,2.25,934,1025,1206
30.06.2019 18:00,2230,20.05,1128,1089,1102
30.06.2019 19:00,2368,25.51,1166,1127,1202
30.06.2019 20:00,2374,24.21,1159,1148,1215
30.06.2019 21:00,2335,23.77,1127,1135,1208
30.06.2019 22:00,2276,22.49,1130,1119,1146
30.06.2019 23:00,2187,19.2,1105,1112,1082
07.01.2019 00:00,2089,4.33,1105,1108,984
07.01.2019 01:00,1963,20.71,1104,1080,859
07.01.2019 02:00,1867,19.82,1076,1070,791
07.01.2019 03:00,1861,19.84,1028,1033,833
07.01.2019 04:00,1903,20.56,961,976,942
07.01.2019 05:00,1921,21.09,900,923,1021
07.01.2019 06:00,2047,24.07,873,907,1174
07.01.2019 07:00,2332,27.7,894,938,1438
07.01.2019 08:00,2575,29.67,979,989,1596
07.01.2019 09:00,2683,31.97,1000,1022,1683
07.01.2019 10:00,2761,32,999,1047,1762
07.01.2019 11:00,2850,31.15,1031,1077,1819
07.01.2019 12:00,2865,29.91,1083,1124,1782
07.01.2019 13:00,2881,28.52,1101,1172,1780
07.01.2019 14:00,2918,27.39,1149,1208,1769
07.01.2019 15:00,2873,27.25,1172,1236,1701
07.01.2019 16:00,2770,27,1205,1256,1565
07.01.2019 17:00,2695,26.72,1174,1262,1521
07.01.2019 18:00,2776,27.5,1228,1247,1548
07.01.2019 19:00,2753,28.04,1231,1218,1522
07.01.2019 20:00,2582,27.89,1194,1180,1388
07.01.2019 21:00,2528,27.67,1153,1143,1375
07.01.2019 22:00,2413,27.29,1122,1106,1291
07.01.2019 23:00,2365,27.15,1094,1076,1271
07.02.2019 00:00,2178,26.08,1092,1061,1086
07.02.2019 01:00,2060,24.99,1112,1122,948
07.02.2019 02:00,1973,24.09,1114,1125,859
07.02.2019 03:00,1964,22.73,1124,1129,840
07.02.2019 04:00,1930,21.53,1134,1132,796
07.02.2019 05:00,1877,20.57,1143,1139,734
07.02.2019 06:00,1968,21.36,1154,1152,814
07.02.2019 07:00,2230,24.29,1171,1176,1059
07.02.2019 08:00,2525,26.86,1208,1212,1317
07.02.2019 09:00,2661,27.49,1239,1256,1422
07.02.2019 10:00,2746,28.48,1276,1299,1470
07.02.2019 11:00,2806,28.82,1305,1334,1501
07.02.2019 12:00,2825,29.79,1327,1350,1498
07.02.2019 13:00,2735,28.11,1324,1342,1411
07.02.2019 14:00,2712,28.84,1298,1315,1414
07.02.2019 15:00,2663,28.82,1259,1284,1404
07.02.2019 16:00,2610,28.89,1199,1248,1411
07.02.2019 17:00,2548,29,1166,1191,1382
07.02.2019 18:00,2546,30.22,1112,1129,1434
07.02.2019 19:00,2528,29.16,1024,1066,1504
07.02.2019 20:00,2501,30.96,934,989,1567
07.02.2019 21:00,2507,30.95,864,922,1643
07.02.2019 22:00,2535,30.43,841,862,1694
07.02.2019 23:00,2448,29.98,820,814,1628
07.03.2019 00:00,2264,27.61,791,805,1473
07.03.2019 01:00,2080,26.12,799,838,1281
07.03.2019 02:00,1955,25.7,805,848,1150
07.03.2019 03:00,1954,25.37,812,856,1142
07.03.2019 04:00,1963,25.15,822,856,1141
07.03.2019 05:00,1901,25.33,822,852,1079
07.03.2019 06:00,2040,26.73,802,850,1238
07.03.2019 07:00,2443,30.15,789,866,1654
07.03.2019 08:00,2690,31.35,821,903,1869
07.03.2019 09:00,2764,31.8,847,939,1917
07.03.2019 10:00,2760,31.8,891,971,1869
07.03.2019 11:00,2729,31.96,929,1003,1800
07.03.2019 12:00,2743,31.71,955,1041,1788
07.03.2019 13:00,2680,30.45,972,1077,1708
07.03.2019 14:00,2670,29.93,992,1107,1678
07.03.2019 15:00,2603,29.4,1035,1122,1568
07.03.2019 16:00,2654,29.26,1038,1117,1616
07.03.2019 17:00,2565,29.12,1027,1098,1538
07.03.2019 18:00,2579,29.99,972,1055,1607
07.03.2019 19:00,2581,30.3,911,992,1670
07.03.2019 20:00,2519,30.25,871,914,1648
07.03.2019 21:00,2444,29.95,792,834,1652
07.03.2019 22:00,2420,29.55,734,771,1686
07.03.2019 23:00,2380,29.46,713,741,1667
07.04.2019 00:00,2201,27.59,711,743,1490
07.04.2019 01:00,1966,27.78,673,698,1293
07.04.2019 02:00,1893,27.29,684,692,1209
07.04.2019 03:00,1887,26.82,730,700,1157
07.04.2019 04:00,1874,26.98,736,720,1138
07.04.2019 05:00,1838,27.11,769,745,1069
07.04.2019 06:00,1991,28.07,810,793,1181
07.04.2019 07:00,2380,28.47,883,868,1497
07.04.2019 08:00,2698,29.62,984,966,1714
07.04.2019 09:00,2715,30.83,991,1034,1724
07.04.2019 10:00,2756,30.91,1000,1068,1756
07.04.2019 11:00,2815,30.69,1007,1093,1808
07.04.2019 12:00,2842,29.9,1073,1128,1769
07.04.2019 13:00,2886,29.01,1129,1170,1757
07.04.2019 14:00,2861,28.94,1169,1207,1692
07.04.2019 15:00,2808,28.82,1198,1245,1610
07.04.2019 16:00,2796,28.9,1222,1276,1574
07.04.2019 17:00,2755,28.85,1252,1292,1503
07.04.2019 18:00,2706,29.33,1259,1290,1447
07.04.2019 19:00,2675,29.15,1280,1283,1395
07.04.2019 20:00,2605,29.02,1264,1261,1341
07.04.2019 21:00,2556,28.91,1257,1218,1299
07.04.2019 22:00,2483,28.43,1210,1157,1273
07.04.2019 23:00,2469,28.37,1143,1093,1326
07.05.2019 00:00,2289,27.26,1074,1035,1215
07.05.2019 01:00,2114,26.19,1064,1065,1050
07.05.2019 02:00,1976,25.84,967,966,1009
07.05.2019 03:00,1867,25.46,848,865,1019
07.05.2019 04:00,1859,25.52,777,769,1082
07.05.2019 05:00,1800,25.9,692,688,1108
07.05.2019 06:00,1952,26.76,635,620,1317
07.05.2019 07:00,2320,28.28,583,570,1737
07.05.2019 08:00,2569,29.88,521,546,2048
07.05.2019 09:00,2607,30.79,512,553,2095
07.05.2019 10:00,2512,31.26,519,582,1993
07.05.2019 11:00,2502,31.39,611,631,1891
07.05.2019 12:00,2454,31.44,685,682,1769
07.05.2019 13:00,2444,31.25,768,720,1676
07.05.2019 14:00,2416,30.05,766,738,1650
07.05.2019 15:00,2345,29.42,748,721,1597
07.05.2019 16:00,2306,29.2,710,670,1596
07.05.2019 17:00,2252,29.48,657,603,1595
07.05.2019 18:00,2245,30.41,573,516,1672
07.05.2019 19:00,2275,30.41,472,420,1803
07.05.2019 20:00,2293,30.47,381,336,1912
07.05.2019 21:00,2308,29.97,332,282,1976
07.05.2019 22:00,2188,29.59,333,270,1855
07.05.2019 23:00,2137,29.47,348,289,1789
07.06.2019 00:00,1977,28.56,360,312,1617
07.06.2019 01:00,1792,29.5,426,431,1366
07.06.2019 02:00,1681,28.54,408,414,1273
07.06.2019 03:00,1695,27.14,400,379,1295
07.06.2019 04:00,1745,27.03,348,337,1397
07.06.2019 05:00,1682,27.48,301,291,1381
07.06.2019 06:00,1650,28.06,247,233,1403
07.06.2019 07:00,1738,28.51,196,183,1542
07.06.2019 08:00,1856,29.03,179,163,1677
07.06.2019 09:00,2037,30.06,176,161,1861
07.06.2019 10:00,2169,30.25,169,167,2000
07.06.2019 11:00,2202,29.7,159,182,2043
07.06.2019 12:00,2176,28.53,182,206,1994
07.06.2019 13:00,2143,27.52,244,242,1899
07.06.2019 14:00,2047,27.17,332,280,1715
07.06.2019 15:00,1972,26.81,373,323,1599
07.06.2019 16:00,1997,26.29,405,374,1592
07.06.2019 17:00,1990,27.64,493,446,1497
07.06.2019 18:00,2025,28.99,562,501,1463
07.06.2019 19:00,2012,29.75,574,546,1438
07.06.2019 20:00,2078,30.03,642,592,1436
07.06.2019 21:00,2080,29.02,597,602,1483
07.06.2019 22:00,2036,28.79,610,594,1426
07.06.2019 23:00,1941,29.19,591,602,1350
07.07.2019 00:00,1819,28.39,576,614,1243
07.07.2019 01:00,1714,28.21,536,588,1178
07.07.2019 02:00,1652,25.98,532,564,1120
07.07.2019 03:00,1616,25.03,553,533,1063
07.07.2019 04:00,1617,24.27,544,504,1073
07.07.2019 05:00,1618,23.36,533,485,1085
07.07.2019 06:00,1570,24.11,493,462,1077
07.07.2019 07:00,1630,25.09,449,438,1181
07.07.2019 08:00,1747,25.7,436,436,1311
07.07.2019 09:00,1853,26.9,437,433,1416
07.07.2019 10:00,1996,28.01,434,416,1562
07.07.2019 11:00,1983,28.59,392,391,1591
07.07.2019 12:00,2021,28.42,365,357,1656
07.07.2019 13:00,2015,27.96,343,321,1672
07.07.2019 14:00,1979,27.74,348,299,1631
07.07.2019 15:00,1905,27,321,294,1584
07.07.2019 16:00,1856,26.99,320,291,1536
07.07.2019 17:00,1923,27.48,326,288,1597
07.07.2019 18:00,2028,28.17,310,281,1718
07.07.2019 19:00,2106,29.2,312,263,1794
07.07.2019 20:00,2149,30.98,273,238,1876
07.07.2019 21:00,2129,31.21,245,229,1884
07.07.2019 22:00,2090,31.72,237,236,1853
07.07.2019 23:00,2048,31.25,249,249,1799
07.08.2019 00:00,1966,29.81,267,258,1699
07.08.2019 01:00,1815,28.93,256,290,1559
07.08.2019 02:00,1754,28.52,266,296,1488
07.08.2019 03:00,1766,28.18,274,301,1492
07.08.2019 04:00,1735,27.95,294,303,1441
07.08.2019 05:00,1752,28.26,288,297,1464
07.08.2019 06:00,1782,29.16,255,266,1527
07.08.2019 07:00,2033,31.4,217,228,1816
07.08.2019 08:00,2314,38.12,188,206,2126
07.08.2019 09:00,2525,39.03,186,198,2339
07.08.2019 10:00,2595,37.66,175,201,2420
07.08.2019 11:00,2603,36.39,180,202,2423
07.08.2019 12:00,2583,38.98,205,209,2378
07.08.2019 13:00,2478,37.75,250,235,2228
07.08.2019 14:00,2391,34.25,305,276,2086
07.08.2019 15:00,2385,32.67,372,311,2013
07.08.2019 16:00,2395,32.95,416,338,1979
07.08.2019 17:00,2505,33.64,467,359,2038
07.08.2019 18:00,2476,34.08,442,364,2034
07.08.2019 19:00,2408,37.08,395,349,2013
07.08.2019 20:00,2365,41.87,378,337,1987
07.08.2019 21:00,2305,31.56,372,343,1933
07.08.2019 22:00,2231,31.15,389,381,1842
07.08.2019 23:00,2152,30.75,414,435,1738
07.09.2019 00:00,1971,29.72,440,476,1531
07.09.2019 01:00,1851,30.55,462,445,1389
07.09.2019 02:00,1727,29.51,441,454,1286
07.09.2019 03:00,1705,29.17,411,451,1294
07.09.2019 04:00,1756,28.98,422,439,1334
07.09.2019 05:00,1781,29.23,418,418,1363
07.09.2019 06:00,1847,30.07,375,375,1472
07.09.2019 07:00,2139,33.21,317,330,1822
07.09.2019 08:00,2411,42.9,278,305,2133
07.09.2019 09:00,2536,43,254,301,2282
07.09.2019 10:00,2560,40.11,256,316,2304
07.09.2019 11:00,2590,37.25,284,337,2306
07.09.2019 12:00,2611,37.13,315,360,2296
07.09.2019 13:00,2603,36.17,353,378,2250
07.09.2019 14:00,2596,34.31,390,394,2206
07.09.2019 15:00,2505,33.92,383,396,2122
07.09.2019 16:00,2456,33.42,350,383,2106
07.09.2019 17:00,2413,33.9,324,364,2089
07.09.2019 18:00,2455,35.83,313,325,2142
07.09.2019 19:00,2434,39.37,282,278,2152
07.09.2019 20:00,2429,45.87,226,232,2203
07.09.2019 21:00,2351,46.75,178,199,2173
07.09.2019 22:00,2230,44.79,189,197,2041
07.09.2019 23:00,2176,32.95,199,219,1977
07.10.2019 00:00,2000,31.47,229,244,1771
07.10.2019 01:00,1835,32.88,270,298,1565
07.10.2019 02:00,1722,32.06,324,340,1398
07.10.2019 03:00,1661,31.44,365,362,1296
07.10.2019 04:00,1690,31.15,394,359,1296
07.10.2019 05:00,1677,31.12,364,347,1313
07.10.2019 06:00,1733,32.31,338,314,1395
07.10.2019 07:00,1971,40.92,310,268,1661
07.10.2019 08:00,2245,33.38,273,241,1972
07.10.2019 09:00,2466,33.82,265,260,2201
07.10.2019 10:00,2521,33.98,290,314,2231
07.10.2019 11:00,2559,34.09,346,385,2213
07.10.2019 12:00,2544,33.98,382,445,2162
07.10.2019 13:00,2476,33.87,439,489,2037
07.10.2019 14:00,2398,33.73,480,520,1918
07.10.2019 15:00,2408,33.69,501,530,1907
07.10.2019 16:00,2365,33.55,498,526,1867
07.10.2019 17:00,2400,33.34,467,508,1933
07.10.2019 18:00,2391,33.32,407,459,1984
07.10.2019 19:00,2413,33.24,386,397,2027
07.10.2019 20:00,2316,33.71,334,333,1982
07.10.2019 21:00,2223,33.59,278,276,1945
07.10.2019 22:00,2216,46.35,242,240,1974
07.10.2019 23:00,2200,33.45,221,230,1979
07.11.2019 00:00,2016,32.89,218,237,1798
07.11.2019 01:00,1840,34.4,225,246,1615
07.11.2019 02:00,1789,34.21,232,262,1557
07.11.2019 03:00,1810,33.99,265,262,1545
07.11.2019 04:00,1817,33.77,264,248,1553
07.11.2019 05:00,1799,33.54,237,226,1562
07.11.2019 06:00,1843,34.15,198,176,1645
07.11.2019 07:00,2036,41.39,132,117,1904
07.11.2019 08:00,2270,35.28,74,85,2196
07.11.2019 09:00,2421,35.8,53,76,2368
07.11.2019 10:00,2512,51.57,57,81,2455
07.11.2019 11:00,2537,50.54,57,91,2480
07.11.2019 12:00,2484,52.69,45,106,2439
07.11.2019 13:00,2497,50.19,50,121,2447
07.11.2019 14:00,2491,48.8,56,133,2435
07.11.2019 15:00,2444,45.53,70,142,2374
07.11.2019 16:00,2414,44.41,85,147,2329
07.11.2019 17:00,2392,35.56,94,147,2298
07.11.2019 18:00,2383,35.38,105,133,2278
07.11.2019 19:00,2334,35.13,93,117,2241
07.11.2019 20:00,2282,34.99,96,101,2186
07.11.2019 21:00,2203,34.96,88,86,2115
07.11.2019 22:00,2167,47.86,91,80,2076
07.11.2019 23:00,2159,46.31,91,80,2068
07.12.2019 00:00,2012,34.53,81,77,1931
07.12.2019 01:00,1884,36.95,66,69,1818
07.12.2019 02:00,1816,36.68,56,65,1760
07.12.2019 03:00,1773,36.19,44,58,1729
07.12.2019 04:00,1766,36.01,42,51,1724
07.12.2019 05:00,1735,35.54,41,46,1694
07.12.2019 06:00,1767,36.05,36,39,1731
07.12.2019 07:00,1986,47.23,28,34,1958
07.12.2019 08:00,2211,36.85,23,35,2188
07.12.2019 09:00,2390,37.26,22,40,2368
07.12.2019 10:00,2497,37.57,24,50,2473
07.12.2019 11:00,2549,37.98,19,56,2530
07.12.2019 12:00,2532,37.78,15,65,2517
07.12.2019 13:00,2487,37.73,22,72,2465
07.12.2019 14:00,2393,37.4,33,82,2360
07.12.2019 15:00,2296,37.07,38,87,2258
07.12.2019 16:00,2259,36.58,41,86,2218
07.12.2019 17:00,2228,36.47,47,80,2181
07.12.2019 18:00,2284,36.57,61,72,2223
07.12.2019 19:00,2279,36.37,56,59,2223
07.12.2019 20:00,2197,36.21,53,53,2144
07.12.2019 21:00,2077,36.55,37,50,2040
07.12.2019 22:00,2038,36.7,35,53,2003
07.12.2019 23:00,2021,36.26,45,61,1976
13.07.2019 00:00,1894,35.64,51,65,1843
13.07.2019 01:00,1763,37.65,52,51,1711
13.07.2019 02:00,1681,37.15,46,50,1635
13.07.2019 03:00,1632,36.48,51,47,1581
13.07.2019 04:00,1614,36.12,50,44,1564
13.07.2019 05:00,1565,36.13,41,41,1524
13.07.2019 06:00,1519,35.36,35,37,1484
13.07.2019 07:00,1613,36.07,30,41,1583
13.07.2019 08:00,1767,36.58,29,47,1738
13.07.2019 09:00,1952,37.23,29,54,1923
13.07.2019 10:00,2052,38.87,30,60,2022
13.07.2019 11:00,2133,38.86,33,72,2100
13.07.2019 12:00,2169,38.06,44,92,2125
13.07.2019 13:00,2138,36.83,56,109,2082
13.07.2019 14:00,2028,35.7,79,132,1949
13.07.2019 15:00,1928,35.06,100,145,1828
13.07.2019 16:00,1889,34.62,139,155,1750
13.07.2019 17:00,1875,34.67,176,161,1699
13.07.2019 18:00,1955,35.56,155,143,1800
13.07.2019 19:00,2037,36.52,135,124,1902
13.07.2019 20:00,2020,37.07,113,103,1907
13.07.2019 21:00,1952,36.92,105,83,1847
13.07.2019 22:00,1892,36.82,69,73,1823
13.07.2019 23:00,1914,37.28,48,68,1866
14.07.2019 00:00,1818,36.95,42,62,1776
14.07.2019 01:00,1654,35.85,40,45,1614
14.07.2019 02:00,1544,35.04,40,43,1504
14.07.2019 03:00,1514,34.05,37,42,1477
14.07.2019 04:00,1506,33.77,58,43,1448
14.07.2019 05:00,1466,33.21,64,45,1402
14.07.2019 06:00,1424,33.2,58,42,1366
14.07.2019 07:00,1448,33.87,47,38,1401
14.07.2019 08:00,1596,34.76,47,50,1549
14.07.2019 09:00,1771,36.33,54,59,1717
14.07.2019 10:00,1925,36.92,63,73,1862
14.07.2019 11:00,1994,37.44,64,86,1930
14.07.2019 12:00,2012,37.94,59,101,1953
14.07.2019 13:00,2037,37.23,73,114,1964
14.07.2019 14:00,1983,36.13,73,126,1910
14.07.2019 15:00,1969,35.36,81,136,1888
14.07.2019 16:00,1952,35.09,89,143,1863
14.07.2019 17:00,1992,35.31,82,141,1910
14.07.2019 18:00,2074,36.58,94,93,1980
14.07.2019 19:00,2098,37.84,98,90,2000
14.07.2019 20:00,2085,38.29,112,94,1973
14.07.2019 21:00,2069,38.95,116,110,1953
14.07.2019 22:00,2025,38.45,139,133,1886
14.07.2019 23:00,2036,38.61,156,161,1880
15.07.2019 00:00,1923,37.42,147,178,1776
15.07.2019 01:00,1769,36.97,141,156,1628
15.07.2019 02:00,1670,36.58,141,160,1529
15.07.2019 03:00,1588,36.45,124,163,1464
15.07.2019 04:00,1530,35.16,128,163,1402
15.07.2019 05:00,1539,34.93,147,159,1392
15.07.2019 06:00,1610,36.84,141,141,1469
15.07.2019 07:00,1870,39.36,129,121,1741
15.07.2019 08:00,2148,48.82,119,117,2029
15.07.2019 09:00,2333,48.86,142,136,2191
15.07.2019 10:00,2413,46.79,166,173,2247
15.07.2019 11:00,2463,45.09,177,221,2286
15.07.2019 12:00,2434,44.21,228,273,2206
15.07.2019 13:00,2408,39.02,277,314,2131
15.07.2019 14:00,2424,39,307,341,2117
15.07.2019 15:00,2402,37.93,338,357,2064
15.07.2019 16:00,2371,37.78,368,364,2003
15.07.2019 17:00,2296,37.26,385,364,1911
15.07.2019 18:00,2332,37.77,355,334,1977
15.07.2019 19:00,2357,38.78,301,290,2056
15.07.2019 20:00,2318,38.72,244,251,2074
15.07.2019 21:00,2207,38.41,200,229,2007
15.07.2019 22:00,2135,38.16,192,229,1943
15.07.2019 23:00,2082,38.19,168,237,1914
16.07.2019 00:00,1935,37.24,157,233,1778
16.07.2019 01:00,1721,36.82,154,179,1567
16.07.2019 02:00,1611,36.27,164,180,1447
16.07.2019 03:00,1574,34.93,177,182,1397
16.07.2019 04:00,1556,33.89,177,181,1379
16.07.2019 05:00,1586,33.13,194,178,1392
16.07.2019 06:00,1634,35.74,185,159,1449
16.07.2019 07:00,1875,37.96,139,127,1736
16.07.2019 08:00,2125,45.82,96,114,2029
16.07.2019 09:00,2292,47.97,109,144,2183
16.07.2019 10:00,2386,46.8,159,216,2227
16.07.2019 11:00,2404,46,168,309,2236
16.07.2019 12:00,2396,45.8,218,405,2178
16.07.2019 13:00,2392,41.06,314,490,2078
16.07.2019 14:00,2358,38.17,408,572,1950
16.07.2019 15:00,2251,38.2,488,624,1763
16.07.2019 16:00,2234,38.02,569,647,1665
16.07.2019 17:00,2243,38.04,608,654,1635
16.07.2019 18:00,2264,38.3,661,622,1603
16.07.2019 19:00,2272,38.45,708,565,1564
16.07.2019 20:00,2291,38.43,613,505,1678
16.07.2019 21:00,2210,38.61,513,461,1697
16.07.2019 22:00,2118,38.88,415,435,1703
16.07.2019 23:00,2062,38.82,369,420,1693
17.07.2019 00:00,1948,38.58,376,398,1572
17.07.2019 01:00,1749,38.74,335,357,1414
17.07.2019 02:00,1627,37.94,309,328,1318
17.07.2019 03:00,1564,37.68,290,298,1274
17.07.2019 04:00,1561,37.28,280,268,1281
17.07.2019 05:00,1538,37.6,266,238,1272
17.07.2019 06:00,1643,38.16,236,194,1407
17.07.2019 07:00,1913,38.56,188,150,1725
17.07.2019 08:00,2158,52.63,160,121,1998
17.07.2019 09:00,2280,53.48,121,112,2159
17.07.2019 10:00,2347,49.02,89,114,2258
17.07.2019 11:00,2360,47.61,61,115,2299
17.07.2019 12:00,2371,46.55,52,111,2319
17.07.2019 13:00,2342,43.92,53,111,2289
17.07.2019 14:00,2327,42.11,56,115,2271
17.07.2019 15:00,2281,39.55,61,121,2220
17.07.2019 16:00,2287,39.57,81,128,2206
17.07.2019 17:00,2272,40.6,94,135,2178
17.07.2019 18:00,2285,46.85,92,128,2193
17.07.2019 19:00,2284,50.75,94,115,2190
17.07.2019 20:00,2224,52.72,87,99,2137
17.07.2019 21:00,2172,53.71,83,85,2089
17.07.2019 22:00,2115,52.78,80,77,2035
17.07.2019 23:00,2094,49.42,66,72,2028
18.07.2019 00:00,1958,39.17,61,65,1897
18.07.2019 01:00,1847,39.18,55,57,1792
18.07.2019 02:00,1759,38.43,46,48,1713
18.07.2019 03:00,1719,37.82,41,41,1678
18.07.2019 04:00,1715,37.71,40,36,1675
18.07.2019 05:00,1694,37.49,34,32,1660
18.07.2019 06:00,1746,37.6,27,27,1719
18.07.2019 07:00,1919,42.75,18,24,1901
18.07.2019 08:00,2118,48.54,13,28,2105
18.07.2019 09:00,2280,47.79,10,37,2270
18.07.2019 10:00,2350,46.36,7,44,2343
18.07.2019 11:00,2397,43.83,13,54,2384
18.07.2019 12:00,2397,43.49,19,63,2378
18.07.2019 13:00,2388,40.41,28,72,2360
18.07.2019 14:00,2365,38.86,31,83,2334
18.07.2019 15:00,2330,38.78,43,90,2287
18.07.2019 16:00,2305,38.77,57,92,2248
18.07.2019 17:00,2287,38.41,62,92,2225
18.07.2019 18:00,2326,46.76,72,87,2254
18.07.2019 19:00,2310,48.74,74,78,2236
18.07.2019 20:00,2247,53.47,75,74,2172
18.07.2019 21:00,2167,52.72,75,74,2092
18.07.2019 22:00,2106,48.21,89,85,2017
18.07.2019 23:00,2097,46.85,104,103,1993
19.07.2019 00:00,1976,38.59,114,113,1862
19.07.2019 01:00,1826,37.86,126,143,1700
19.07.2019 02:00,1733,37.06,137,152,1596
19.07.2019 03:00,1685,37,148,152,1537
19.07.2019 04:00,1666,36.66,160,148,1506
19.07.2019 05:00,1629,36.68,162,142,1467
19.07.2019 06:00,1647,37.53,155,127,1492
19.07.2019 07:00,1839,41.81,149,113,1690
19.07.2019 08:00,2083,50.82,155,109,1928
19.07.2019 09:00,2298,51.22,144,112,2154
19.07.2019 10:00,2360,48.24,151,124,2209
19.07.2019 11:00,2388,46.71,158,144,2230
19.07.2019 12:00,2371,45.9,167,159,2204
19.07.2019 13:00,2303,42.96,184,167,2119
19.07.2019 14:00,2280,38.64,209,173,2071
19.07.2019 15:00,2255,38.45,205,173,2050
19.07.2019 16:00,2269,38.26,196,169,2073
19.07.2019 17:00,2236,38.42,170,160,2066
19.07.2019 18:00,2268,45.1,152,140,2116
19.07.2019 19:00,2264,50.04,140,118,2124
19.07.2019 20:00,2246,53.68,112,101,2134
19.07.2019 21:00,2155,38.45,103,94,2052
19.07.2019 22:00,2089,38.45,102,97,1987
19.07.2019 23:00,2058,38.45,94,104,1964
20.07.2019 00:00,1926,38.43,93,103,1833
20.07.2019 01:00,1808,39.35,100,102,1708
20.07.2019 02:00,1682,38.08,94,96,1588
20.07.2019 03:00,1607,36.81,89,87,1518
20.07.2019 04:00,1628,35.61,85,82,1543
20.07.2019 05:00,1582,34.36,75,72,1507
20.07.2019 06:00,1528,34.03,69,60,1459
20.07.2019 07:00,1566,35,45,46,1521
20.07.2019 08:00,1681,35.9,33,43,1648
20.07.2019 09:00,1834,36.79,33,50,1801
20.07.2019 10:00,1976,36.8,50,72,1926
20.07.2019 11:00,2038,36.22,61,96,1977
20.07.2019 12:00,2014,36.01,79,124,1935
20.07.2019 13:00,1992,35.31,100,148,1892
20.07.2019 14:00,1983,34.93,122,166,1861
20.07.2019 15:00,1930,34.68,164,175,1766
20.07.2019 16:00,1909,34.24,189,182,1720
20.07.2019 17:00,1950,34.22,207,190,1743
20.07.2019 18:00,1972,35.6,251,197,1721
20.07.2019 19:00,2030,36.92,261,207,1769
20.07.2019 20:00,2009,37.52,310,234,1699
20.07.2019 21:00,1908,37.53,371,281,1537
20.07.2019 22:00,1835,37.46,457,349,1378
20.07.2019 23:00,1802,37.95,508,419,1294
21.07.2019 00:00,1750,37.29,495,443,1255
21.07.2019 01:00,1728,35.35,497,497,1231
21.07.2019 02:00,1652,33.47,477,475,1175
21.07.2019 03:00,1653,33.03,429,423,1224
21.07.2019 04:00,1626,31.27,352,356,1274
21.07.2019 05:00,1602,30.99,301,298,1301
21.07.2019 06:00,1552,31.55,234,252,1318
21.07.2019 07:00,1595,33.35,189,219,1406
21.07.2019 08:00,1691,35.13,158,206,1533
21.07.2019 09:00,1834,35.8,163,204,1671
21.07.2019 10:00,1965,36.4,164,218,1801
21.07.2019 11:00,2032,36.5,171,244,1861
21.07.2019 12:00,2097,36.34,201,282,1896
21.07.2019 13:00,2043,35.42,245,323,1798
21.07.2019 14:00,2002,34.54,319,375,1683
21.07.2019 15:00,1920,33.48,393,417,1527
21.07.2019 16:00,1855,32.9,442,452,1413
21.07.2019 17:00,1881,33.84,508,485,1373
21.07.2019 18:00,1949,35.09,556,504,1393
21.07.2019 19:00,2012,36.44,571,514,1441
21.07.2019 20:00,1970,37.89,580,523,1390
21.07.2019 21:00,1905,38.58,592,534,1313
21.07.2019 22:00,1927,38.71,583,554,1344
21.07.2019 23:00,1988,38.68,600,575,1388
22.07.2019 00:00,1787,38.21,632,588,1155
22.07.2019 01:00,1713,37.47,632,618,1081
22.07.2019 02:00,1662,35.11,610,606,1052
22.07.2019 03:00,1539,34.23,585,585,954
22.07.2019 04:00,1548,34.22,558,558,990
22.07.2019 05:00,1568,34.16,531,532,1037
22.07.2019 06:00,1608,36.18,492,501,1116
22.07.2019 07:00,1860,37.26,433,464,1427
22.07.2019 08:00,2082,37.63,389,446,1693
22.07.2019 09:00,2240,37.91,377,439,1863
22.07.2019 10:00,2262,38.12,362,434,1900
22.07.2019 11:00,2256,38.17,337,433,1919
22.07.2019 12:00,2220,38.07,342,440,1878
22.07.2019 13:00,2235,37.66,349,446,1886
22.07.2019 14:00,2268,37.34,347,441,1921
22.07.2019 15:00,2275,37.19,351,439,1924
22.07.2019 16:00,2273,37.4,341,437,1932
22.07.2019 17:00,2220,37.67,367,432,1853
22.07.2019 18:00,2236,37.85,318,405,1918
22.07.2019 19:00,2317,38.42,281,371,2036
22.07.2019 20:00,2256,38.4,266,341,1990
22.07.2019 21:00,2149,38.31,263,313,1886
22.07.2019 22:00,2128,38.12,275,292,1853
22.07.2019 23:00,2054,38.05,268,275,1786
23.07.2019 00:00,1913,38.04,258,255,1655
23.07.2019 01:00,1801,37.96,216,224,1585
23.07.2019 02:00,1715,37.58,197,209,1518
23.07.2019 03:00,1636,36.98,186,199,1450
23.07.2019 04:00,1610,36.52,196,192,1414
23.07.2019 05:00,1565,36.32,200,187,1365
23.07.2019 06:00,1583,37.7,186,184,1397
23.07.2019 07:00,1762,37.5,183,183,1579
23.07.2019 08:00,1996,37.72,188,190,1808
23.07.2019 09:00,2145,37.95,197,193,1948
23.07.2019 10:00,2277,38.06,195,196,2082
23.07.2019 11:00,2378,38.2,199,200,2179
23.07.2019 12:00,2406,38.21,205,212,2201
23.07.2019 13:00,2402,38.16,215,226,2187
23.07.2019 14:00,2391,37.98,217,242,2174
23.07.2019 15:00,2366,37.94,203,249,2163
23.07.2019 16:00,2326,37.9,188,243,2138
23.07.2019 17:00,2276,37.87,181,231,2095
23.07.2019 18:00,2242,37.81,164,200,2078
23.07.2019 19:00,2225,57.71,133,160,2092
23.07.2019 20:00,2199,62.98,102,127,2097
23.07.2019 21:00,2164,61.89,89,104,2075
23.07.2019 22:00,2118,59.42,91,94,2027
23.07.2019 23:00,2086,54.53,92,90,1994
24.07.2019 00:00,1902,44.41,80,83,1822
24.07.2019 01:00,1763,42.25,74,88,1689
24.07.2019 02:00,1678,39.65,70,77,1608
24.07.2019 03:00,1634,38.48,63,65,1571
24.07.2019 04:00,1618,38.14,59,57,1559
24.07.2019 05:00,1595,37.94,52,50,1543
24.07.2019 06:00,1601,38.53,38,41,1563
24.07.2019 07:00,1733,38.26,31,35,1702
24.07.2019 08:00,1952,51.79,25,35,1927
24.07.2019 09:00,2131,57.35,17,40,2114
24.07.2019 10:00,2229,57.75,19,48,2210
24.07.2019 11:00,2299,51.44,15,57,2284
24.07.2019 12:00,2312,47.46,12,63,2300
24.07.2019 13:00,2291,45.65,14,68,2277
24.07.2019 14:00,2285,44.08,19,75,2266
24.07.2019 15:00,2262,45.12,20,79,2242
24.07.2019 16:00,2251,45.87,23,77,2228
24.07.2019 17:00,2223,49.41,26,71,2197
24.07.2019 18:00,2243,56.36,36,65,2207
24.07.2019 19:00,2228,66.57,50,61,2178
24.07.2019 20:00,2185,72.28,42,54,2143
24.07.2019 21:00,2119,66.52,43,50,2076
24.07.2019 22:00,2059,57.93,48,53,2011
24.07.2019 23:00,2049,56.42,60,61,1989
25.07.2019 00:00,1879,48.6,64,68,1815
25.07.2019 01:00,1709,44.53,71,81,1638
25.07.2019 02:00,1617,41.04,76,88,1541
25.07.2019 03:00,1602,39.58,94,89,1508
25.07.2019 04:00,1607,38.8,97,81,1510
25.07.2019 05:00,1621,38.48,81,72,1540
25.07.2019 06:00,1616,39.69,67,61,1549
25.07.2019 07:00,1728,38.42,61,53,1667
25.07.2019 08:00,1961,57.53,44,49,1917
25.07.2019 09:00,2136,53.98,33,53,2103
25.07.2019 10:00,2233,55.34,31,64,2202
25.07.2019 11:00,2284,51.51,21,76,2263
25.07.2019 12:00,2291,50.65,20,86,2271
25.07.2019 13:00,2277,47.85,26,93,2251
25.07.2019 14:00,2292,46.94,34,97,2258
25.07.2019 15:00,2259,44.59,35,97,2224
25.07.2019 16:00,2237,46.63,35,95,2202
25.07.2019 17:00,2216,48.95,36,89,2180
25.07.2019 18:00,2226,55.49,35,76,2191
25.07.2019 19:00,2249,62.05,35,63,2214
25.07.2019 20:00,2219,67.91,31,59,2188
25.07.2019 21:00,2137,61.86,29,56,2108
25.07.2019 22:00,2067,56.75,30,59,2037
25.07.2019 23:00,2025,50.74,39,61,1986
26.07.2019 00:00,1879,41.88,38,59,1841
26.07.2019 01:00,1741,38.65,35,37,1706
26.07.2019 02:00,1652,37.73,40,38,1612
26.07.2019 03:00,1594,37.19,44,43,1550
26.07.2019 04:00,1559,36.57,53,53,1506
26.07.2019 05:00,1543,36.37,61,68,1482
26.07.2019 06:00,1560,38.49,68,76,1492
26.07.2019 07:00,1732,38.39,73,78,1659
26.07.2019 08:00,1996,38.86,64,75,1932
26.07.2019 09:00,2157,43.06,65,77,2092
26.07.2019 10:00,2263,54.55,70,91,2193
26.07.2019 11:00,2308,52.38,83,111,2225
26.07.2019 12:00,2298,40.25,94,135,2204
26.07.2019 13:00,2259,39.6,123,160,2136
26.07.2019 14:00,2215,39.05,157,182,2058
26.07.2019 15:00,2179,38.72,176,193,2003
26.07.2019 16:00,2096,38.85,209,197,1887
26.07.2019 17:00,2061,39.36,225,196,1836
26.07.2019 18:00,2053,39.74,251,201,1802
26.07.2019 19:00,2082,52.07,264,211,1818
26.07.2019 20:00,2077,53.62,302,216,1775
26.07.2019 21:00,2023,52.06,301,222,1722
26.07.2019 22:00,1974,48.97,300,242,1674
26.07.2019 23:00,1950,48.14,301,261,1649
27.07.2019 00:00,1825,38.67,306,281,1519
27.07.2019 01:00,1719,39.01,322,320,1397
27.07.2019 02:00,1569,37.59,321,338,1248
27.07.2019 03:00,1479,37.01,342,364,1137
27.07.2019 04:00,1478,36.04,374,400,1104
27.07.2019 05:00,1519,35.1,428,442,1091
27.07.2019 06:00,1460,35.28,440,454,1020
27.07.2019 07:00,1540,35.33,438,442,1102
27.07.2019 08:00,1697,36.05,442,433,1255
27.07.2019 09:00,1912,37.42,457,474,1455
27.07.2019 10:00,2050,39.21,524,570,1526
27.07.2019 11:00,1939,38.38,644,696,1295
27.07.2019 12:00,1844,37.82,752,809,1092
27.07.2019 13:00,1908,37.04,827,878,1081
27.07.2019 14:00,1985,36.83,884,910,1101
27.07.2019 15:00,1955,36.74,892,919,1063
27.07.2019 16:00,2001,36.55,921,910,1080
27.07.2019 17:00,2052,36.62,898,891,1154
27.07.2019 18:00,2075,36.79,869,857,1206
27.07.2019 19:00,2067,38.29,796,806,1271
27.07.2019 20:00,1990,38.94,714,737,1276
27.07.2019 21:00,1944,37.91,664,677,1280
27.07.2019 22:00,1973,36.19,633,649,1340
27.07.2019 23:00,1952,36.19,593,632,1359
28.07.2019 00:00,1832,35.03,565,626,1267
28.07.2019 01:00,1724,34.75,588,620,1136
28.07.2019 02:00,1669,32.39,583,608,1086
28.07.2019 03:00,1671,29.13,549,600,1122
28.07.2019 04:00,1641,27.13,554,599,1087
28.07.2019 05:00,1637,27.1,559,598,1078
28.07.2019 06:00,1549,26.8,563,601,986
28.07.2019 07:00,1589,29.91,569,610,1020
28.07.2019 08:00,1723,34.39,579,635,1144
28.07.2019 09:00,1956,35.56,582,680,1374
28.07.2019 10:00,2074,36.99,622,738,1452
28.07.2019 11:00,2162,37.57,622,790,1540
28.07.2019 12:00,2160,37.64,660,825,1500
28.07.2019 13:00,2002,37.23,700,839,1302
28.07.2019 14:00,1867,37.01,739,844,1128
28.07.2019 15:00,1824,36.92,752,840,1072
28.07.2019 16:00,1823,36.88,744,827,1079
28.07.2019 17:00,1850,37.02,739,808,1111
28.07.2019 18:00,1932,37.85,693,770,1239
28.07.2019 19:00,2087,38.49,637,704,1450
28.07.2019 20:00,2127,39.9,559,634,1568
28.07.2019 21:00,2136,40.04,500,605,1636
28.07.2019 22:00,2135,39.9,502,612,1633
28.07.2019 23:00,2073,40.14,481,622,1592
29.07.2019 00:00,1910,38.85,500,609,1410
29.07.2019 01:00,1660,36.96,423,475,1237
29.07.2019 02:00,1564,35.18,422,453,1142
29.07.2019 03:00,1571,33.73,412,424,1159
29.07.2019 04:00,1576,34.37,396,393,1180
29.07.2019 05:00,1563,34.8,345,365,1218
29.07.2019 06:00,1547,36.41,320,330,1227
29.07.2019 07:00,1806,39.77,276,280,1530
29.07.2019 08:00,2075,51.95,219,226,1856
29.07.2019 09:00,2291,57.4,197,194,2094
29.07.2019 10:00,2408,51.51,191,188,2217
29.07.2019 11:00,2420,48.84,150,188,2270
29.07.2019 12:00,2432,48.29,140,188,2292
29.07.2019 13:00,2409,47.35,125,184,2284
29.07.2019 14:00,2452,45.72,125,175,2327
29.07.2019 15:00,2421,45.3,118,164,2303
29.07.2019 16:00,2348,45.13,109,152,2239
29.07.2019 17:00,2312,44.95,91,140,2221
29.07.2019 18:00,2352,45.21,97,127,2255
29.07.2019 19:00,2332,49.5,107,116,2225
29.07.2019 20:00,2244,60.74,102,104,2142
29.07.2019 21:00,2190,56.07,98,104,2092
29.07.2019 22:00,2194,51.96,115,119,2079
29.07.2019 23:00,2135,43.02,136,135,1999
30.07.2019 00:00,1993,39.39,126,140,1867
30.07.2019 01:00,1743,38.8,97,87,1646
30.07.2019 02:00,1601,38.35,80,82,1521
30.07.2019 03:00,1567,38.16,72,82,1495
30.07.2019 04:00,1562,38,91,86,1471
30.07.2019 05:00,1609,38.16,103,96,1506
30.07.2019 06:00,1637,38.59,100,104,1537
30.07.2019 07:00,1812,47.33,110,112,1702
30.07.2019 08:00,2010,53.66,116,122,1894
30.07.2019 09:00,2136,54.81,123,142,2013
30.07.2019 10:00,2226,52.95,156,165,2070
30.07.2019 11:00,2410,49.9,197,193,2213
30.07.2019 12:00,2454,44.86,260,234,2194
30.07.2019 13:00,2433,41.06,327,295,2106
30.07.2019 14:00,2495,40.65,386,367,2109
30.07.2019 15:00,2519,40,437,415,2082
30.07.2019 16:00,2421,39.95,463,436,1958
30.07.2019 17:00,2357,39.78,510,456,1847
30.07.2019 18:00,2357,41.03,513,476,1844
30.07.2019 19:00,2274,45.79,528,503,1746
30.07.2019 20:00,2199,41.92,527,523,1672
30.07.2019 21:00,2127,41.43,546,530,1581
30.07.2019 22:00,2114,40.58,525,521,1589
30.07.2019 23:00,2059,39.96,548,507,1511
31.07.2019 00:00,1818,38.66,510,488,1308
31.07.2019 01:00,1677,37.98,482,458,1195
31.07.2019 02:00,1620,37.54,493,449,1127
31.07.2019 03:00,1557,35.98,481,441,1076
31.07.2019 04:00,1548,35.78,471,429,1077
31.07.2019 05:00,1578,36.19,432,413,1146
31.07.2019 06:00,1573,37.8,427,383,1146
31.07.2019 07:00,1794,40.12,386,353,1408
31.07.2019 08:00,2111,59.64,352,324,1759
31.07.2019 09:00,2299,60.46,333,307,1966
31.07.2019 10:00,2371,58.35,310,299,2061
31.07.2019 11:00,2409,50.23,277,293,2132
31.07.2019 12:00,2454,50.71,266,282,2188
31.07.2019 13:00,2438,47.7,253,260,2185
31.07.2019 14:00,2397,45.83,202,242,2195
31.07.2019 15:00,2362,44.01,175,231,2187
31.07.2019 16:00,2305,43.17,150,220,2155
31.07.2019 17:00,2279,42.89,138,202,2141
31.07.2019 18:00,2305,46.75,151,181,2154
31.07.2019 19:00,2270,50.77,150,160,2120
31.07.2019 20:00,2222,54.59,133,142,2089
31.07.2019 21:00,2148,64.13,132,127,2016
31.07.2019 22:00,2135,49.92,125,124,2010
31.07.2019 23:00,2073,42.84,111,124,1962
08.01.2019 00:00,1912,40.45,102,120,1810
08.01.2019 01:00,1758,39,95,99,1663
08.01.2019 02:00,1607,37.98,98,95,1509
08.01.2019 03:00,1579,37.44,101,91,1478
08.01.2019 04:00,1609,37.26,92,87,1517
08.01.2019 05:00,1636,37.37,97,89,1539
08.01.2019 06:00,1647,38.39,93,90,1554
08.01.2019 07:00,1824,41.08,101,87,1723
08.01.2019 08:00,2084,45.79,117,84,1967
08.01.2019 09:00,2288,45.69,96,81,2192
08.01.2019 10:00,2357,42.43,74,79,2283
08.01.2019 11:00,2355,40.83,79,77,2276
08.01.2019 12:00,2366,40.83,56,74,2310
08.01.2019 13:00,2335,40.49,49,71,2286
08.01.2019 14:00,2329,40.54,45,68,2284
08.01.2019 15:00,2342,40.2,52,62,2290
08.01.2019 16:00,2324,40.11,28,55,2296
08.01.2019 17:00,2296,40.15,22,48,2274
08.01.2019 18:00,2299,44.24,32,43,2267
08.01.2019 19:00,2264,54.62,39,43,2225
08.01.2019 20:00,2238,63.38,33,46,2205
08.01.2019 21:00,2147,66.43,41,51,2106
08.01.2019 22:00,2115,57.94,60,64,2055
08.01.2019 23:00,1995,40.09,84,87,1911
08.02.2019 00:00,1792,39.61,103,107,1689
08.02.2019 01:00,1673,39.04,130,122,1543
08.02.2019 02:00,1599,38.89,162,146,1437
08.02.2019 03:00,1593,38.2,193,161,1400
08.02.2019 04:00,1593,37.93,207,165,1386
08.02.2019 05:00,1633,38.1,215,167,1418
08.02.2019 06:00,1643,39.88,196,147,1447
08.02.2019 07:00,1830,40.55,152,108,1678
08.02.2019 08:00,2067,46.81,99,77,1968
08.02.2019 09:00,2236,48.27,80,64,2156
08.02.2019 10:00,2308,49.26,77,64,2231
08.02.2019 11:00,2364,47.95,69,71,2295
08.02.2019 12:00,2379,44.96,50,73,2329
08.02.2019 13:00,2355,42.31,42,79,2313
08.02.2019 14:00,2307,41.28,49,86,2258
08.02.2019 15:00,2211,40.12,60,95,2151
08.02.2019 16:00,2124,40.22,68,106,2056
08.02.2019 17:00,2088,41.46,81,116,2007
08.02.2019 18:00,2128,43.04,101,117,2027
08.02.2019 19:00,2103,44.85,103,119,2000
08.02.2019 20:00,2056,48.32,104,117,1952
08.02.2019 21:00,2016,47.82,96,120,1920
08.02.2019 22:00,2004,41.58,108,128,1896
08.02.2019 23:00,1970,40.76,115,135,1855
08.03.2019 00:00,1853,39.98,118,134,1735
08.03.2019 01:00,1710,38.96,105,108,1605
08.03.2019 02:00,1625,38.16,98,106,1527
08.03.2019 03:00,1564,38.05,91,103,1473
08.03.2019 04:00,1525,37.74,88,105,1437
08.03.2019 05:00,1512,37.66,97,110,1415
08.03.2019 06:00,1468,37.87,102,107,1366
08.03.2019 07:00,1496,38.11,93,94,1403
08.03.2019 08:00,1608,38.41,77,80,1531
08.03.2019 09:00,1766,38.97,66,78,1700
08.03.2019 10:00,1905,39.73,62,88,1843
08.03.2019 11:00,1956,39.87,74,105,1882
08.03.2019 12:00,1983,39.61,89,129,1894
08.03.2019 13:00,1979,39.42,104,156,1875
08.03.2019 14:00,1903,39.14,126,182,1777
08.03.2019 15:00,1841,38.95,146,202,1695
08.03.2019 16:00,1814,38.91,150,211,1664
08.03.2019 17:00,1883,38.89,167,206,1716
08.03.2019 18:00,1947,38.96,159,173,1788
08.03.2019 19:00,1960,39.75,131,130,1829
08.03.2019 20:00,1986,41.08,112,100,1874
08.03.2019 21:00,1950,41.02,108,76,1842
08.03.2019 22:00,1944,40.59,86,67,1858
08.03.2019 23:00,1893,40.84,57,59,1836
08.04.2019 00:00,1749,39.47,43,51,1706
08.04.2019 01:00,1597,38.93,44,58,1553
08.04.2019 02:00,1522,38.04,44,58,1478
08.04.2019 03:00,1482,37.45,45,57,1437
08.04.2019 04:00,1492,37.18,52,59,1440
08.04.2019 05:00,1496,37.06,54,61,1442
08.04.2019 06:00,1446,36.48,49,58,1397
08.04.2019 07:00,1439,37.4,37,54,1402
08.04.2019 08:00,1528,38.09,32,53,1496
08.04.2019 09:00,1680,38.69,28,60,1652
08.04.2019 10:00,1809,39.63,28,72,1781
08.04.2019 11:00,1890,40.03,37,88,1853
08.04.2019 12:00,1933,40.02,59,106,1874
08.04.2019 13:00,1942,39.98,62,127,1880
08.04.2019 14:00,1921,39.46,80,153,1841
08.04.2019 15:00,1864,39.3,106,167,1758
08.04.2019 16:00,1831,39.2,118,165,1713
08.04.2019 17:00,1857,39.12,118,158,1739
08.04.2019 18:00,1955,39.32,126,144,1829
08.04.2019 19:00,2010,39.98,126,121,1884
08.04.2019 20:00,1997,42,116,99,1881
08.04.2019 21:00,1991,42.93,89,87,1902
08.04.2019 22:00,2008,43.42,80,86,1928
08.04.2019 23:00,1934,41.4,85,91,1849
08.05.2019 00:00,1791,40.31,81,92,1710
08.05.2019 01:00,1639,39.05,54,59,1585
08.05.2019 02:00,1585,36.89,50,59,1535
08.05.2019 03:00,1570,36.55,42,57,1528
08.05.2019 04:00,1569,36.56,39,52,1530
08.05.2019 05:00,1592,36.81,38,47,1554
08.05.2019 06:00,1636,39.33,41,40,1595
08.05.2019 07:00,1917,43.15,38,36,1879
08.05.2019 08:00,2224,44.66,31,39,2193
08.05.2019 09:00,2429,54.5,37,46,2392
08.05.2019 10:00,2467,54.7,37,56,2430
08.05.2019 11:00,2513,54.39,35,71,2478
08.05.2019 12:00,2542,52.6,49,85,2493
08.05.2019 13:00,2515,45.22,60,99,2455
08.05.2019 14:00,2481,47.24,72,115,2409
08.05.2019 15:00,2451,43.87,88,126,2363
08.05.2019 16:00,2446,44.32,109,135,2337
08.05.2019 17:00,2372,44.93,110,137,2262
08.05.2019 18:00,2410,45.17,108,132,2302
08.05.2019 19:00,2396,46.6,108,121,2288
08.05.2019 20:00,2343,44.72,101,112,2242
08.05.2019 21:00,2285,44.56,101,110,2184
08.05.2019 22:00,2254,44.18,106,114,2148
08.05.2019 23:00,2152,43.51,117,117,2035
08.06.2019 00:00,1913,39.87,117,118,1796
08.06.2019 01:00,1756,38.79,111,112,1645
08.06.2019 02:00,1653,37.83,111,107,1542
08.06.2019 03:00,1667,36.91,122,105,1545
08.06.2019 04:00,1678,36.83,130,109,1548
08.06.2019 05:00,1690,36.78,137,117,1553
08.06.2019 06:00,1709,38.47,121,125,1588
08.06.2019 07:00,1936,39.4,106,133,1830
08.06.2019 08:00,2324,42.59,139,152,2185
08.06.2019 09:00,2506,43.92,179,182,2327
08.06.2019 10:00,2553,43.97,211,221,2342
08.06.2019 11:00,2576,41.96,218,266,2358
08.06.2019 12:00,2545,41.27,258,318,2287
08.06.2019 13:00,2442,40.15,300,382,2142
08.06.2019 14:00,2392,39.97,368,453,2024
08.06.2019 15:00,2383,39.93,403,495,1980
08.06.2019 16:00,2404,39.95,404,508,2000
08.06.2019 17:00,2338,40.13,399,505,1939
08.06.2019 18:00,2399,42.78,355,456,2044
08.06.2019 19:00,2414,43.64,313,371,2101
08.06.2019 20:00,2407,43.18,258,292,2149
08.06.2019 21:00,2351,42.37,217,261,2134
08.06.2019 22:00,2295,42.27,224,262,2071
08.06.2019 23:00,2114,40.81,255,266,1859
08.07.2019 00:00,1925,39.66,240,264,1685
08.07.2019 01:00,1763,38.26,252,247,1511
08.07.2019 02:00,1643,36.28,265,246,1378
08.07.2019 03:00,1580,35.76,245,234,1335
08.07.2019 04:00,1673,35.76,246,215,1427
08.07.2019 05:00,1731,35.69,236,191,1495
08.07.2019 06:00,1811,37.59,201,162,1610
08.07.2019 07:00,2041,39.85,141,134,1900
08.07.2019 08:00,2367,43.88,104,116,2263
08.07.2019 09:00,2560,44.98,96,125,2464
08.07.2019 10:00,2590,44.98,100,154,2490
08.07.2019 11:00,2628,44.34,96,190,2532
08.07.2019 12:00,2555,44.47,104,225,2451
08.07.2019 13:00,2574,42.16,130,269,2444
08.07.2019 14:00,2556,42.84,164,308,2392
08.07.2019 15:00,2543,40.73,217,327,2326
08.07.2019 16:00,2530,41.15,239,328,2291
08.07.2019 17:00,2455,42.05,225,320,2230
08.07.2019 18:00,2335,44.22,199,281,2136
08.07.2019 19:00,2411,43.48,171,224,2240
08.07.2019 20:00,2389,43.15,197,185,2192
08.07.2019 21:00,2303,42.68,196,166,2107
08.07.2019 22:00,2262,41.94,172,162,2090
08.07.2019 23:00,2114,39.87,187,168,1927
08.08.2019 00:00,1930,38.31,186,172,1744
08.08.2019 01:00,1769,36.5,199,178,1570
08.08.2019 02:00,1688,35.38,197,190,1491
08.08.2019 03:00,1691,35.04,217,204,1474
08.08.2019 04:00,1670,34.95,214,217,1456
08.08.2019 05:00,1679,35.38,212,225,1467
08.08.2019 06:00,1701,36.62,210,218,1491
08.08.2019 07:00,1987,37.88,186,198,1801
08.08.2019 08:00,2368,42.76,171,190,2197
08.08.2019 09:00,2547,39.98,184,196,2363
08.08.2019 10:00,2521,40.32,178,206,2343
08.08.2019 11:00,2579,40.3,192,223,2387
08.08.2019 12:00,2635,39.91,234,244,2401
08.08.2019 13:00,2566,39.94,256,280,2310
08.08.2019 14:00,2551,39.73,295,323,2256
08.08.2019 15:00,2535,39.12,338,363,2197
08.08.2019 16:00,2489,38.84,351,396,2138
08.08.2019 17:00,2553,38.36,349,421,2204
08.08.2019 18:00,2592,38.28,364,422,2228
08.08.2019 19:00,2496,39.04,402,397,2094
08.08.2019 20:00,2477,41.8,337,370,2140
08.08.2019 21:00,2391,42.32,325,357,2066
08.08.2019 22:00,2388,42.58,326,366,2062
08.08.2019 23:00,2182,40.98,365,373,1817
08.09.2019 00:00,1951,38.12,368,368,1583
08.09.2019 01:00,1836,36.23,377,373,1459
08.09.2019 02:00,1780,35,367,360,1413
08.09.2019 03:00,1730,33.97,344,344,1386
08.09.2019 04:00,1734,34.06,324,319,1410
08.09.2019 05:00,1714,33.83,286,289,1428
08.09.2019 06:00,1774,37.26,244,256,1530
08.09.2019 07:00,2067,42.03,202,220,1865
08.09.2019 08:00,2422,46.24,182,189,2240
08.09.2019 09:00,2567,48.7,144,164,2423
08.09.2019 10:00,2606,43.93,121,149,2485
08.09.2019 11:00,2635,40.82,90,135,2545
08.09.2019 12:00,2596,40.4,83,126,2513
08.09.2019 13:00,2526,40.34,72,121,2454
08.09.2019 14:00,2478,40.13,65,120,2413
08.09.2019 15:00,2369,39.9,62,121,2307
08.09.2019 16:00,2302,39.51,61,112,2241
08.09.2019 17:00,2280,39.05,59,99,2221
08.09.2019 18:00,2286,40.81,62,86,2224
08.09.2019 19:00,2259,43.66,63,76,2196
08.09.2019 20:00,2218,42.36,58,72,2160
08.09.2019 21:00,2162,39.6,63,78,2099
08.09.2019 22:00,2144,37.7,83,98,2061
08.09.2019 23:00,2017,35.33,127,133,1890
08.10.2019 00:00,1858,35.74,187,184,1671
08.10.2019 01:00,1676,34.87,236,234,1440
08.10.2019 02:00,1665,34.67,301,300,1364
08.10.2019 03:00,1599,33.92,394,379,1205
08.10.2019 04:00,1589,32.73,522,471,1067
08.10.2019 05:00,1537,31.7,601,564,936
08.10.2019 06:00,1529,31.42,674,656,855
08.10.2019 07:00,1559,32.17,734,740,825
08.10.2019 08:00,1687,33.99,778,786,909
08.10.2019 09:00,1970,35.24,750,782,1220
08.10.2019 10:00,2221,36.05,675,727,1546
08.10.2019 11:00,2344,36.07,563,669,1781
08.10.2019 12:00,2393,35.88,520,646,1873
08.10.2019 13:00,2319,35.54,524,644,1795
08.10.2019 14:00,2213,35.11,546,647,1667
08.10.2019 15:00,2146,34.91,586,663,1560
08.10.2019 16:00,2238,34.82,592,693,1646
08.10.2019 17:00,2366,34.96,619,722,1747
08.10.2019 18:00,2362,35.32,661,734,1701
08.10.2019 19:00,2323,35.13,682,753,1641
08.10.2019 20:00,2288,34.01,612,762,1676
08.10.2019 21:00,2090,34,605,781,1485
08.10.2019 22:00,2057,32.43,615,836,1442
08.10.2019 23:00,1961,31.83,686,891,1275
08.11.2019 00:00,1838,32.01,781,956,1057
08.11.2019 01:00,1726,28.84,780,845,946
08.11.2019 02:00,1664,21.14,890,935,774
08.11.2019 03:00,1672,14.55,974,1001,698
08.11.2019 04:00,1623,12.7,1003,1034,620
08.11.2019 05:00,1642,13.13,933,1044,709
08.11.2019 06:00,1622,13.62,933,1039,689
08.11.2019 07:00,1626,14.91,985,1042,641
08.11.2019 08:00,1721,21.19,1024,1050,697
08.11.2019 09:00,1818,29.11,1049,1095,769
08.11.2019 10:00,1966,31.99,1090,1155,876
08.11.2019 11:00,2102,33.21,1132,1203,970
08.11.2019 12:00,2087,33.25,1162,1240,925
08.11.2019 13:00,2082,32.13,1158,1263,924
08.11.2019 14:00,2081,31.96,1189,1274,892
08.11.2019 15:00,2084,31.62,1166,1261,918
08.11.2019 16:00,2106,32.47,1152,1227,954
08.11.2019 17:00,2060,32.61,1109,1178,951
08.11.2019 18:00,2079,34.01,994,1096,1085
08.11.2019 19:00,2177,35.97,865,980,1312
08.11.2019 20:00,2229,37.1,731,848,1498
08.11.2019 21:00,2238,37.68,625,746,1613
08.11.2019 22:00,2325,37.75,556,677,1769
08.11.2019 23:00,2207,37.59,554,619,1653
08.12.2019 00:00,1987,36.4,527,583,1460
08.12.2019 01:00,1817,34.32,466,485,1351
08.12.2019 02:00,1782,30.04,444,459,1338
08.12.2019 03:00,1758,28.38,466,466,1292
08.12.2019 04:00,1702,27.5,488,498,1214
08.12.2019 05:00,1787,28.1,532,535,1255
08.12.2019 06:00,1847,32.32,523,541,1324
08.12.2019 07:00,2200,38.2,527,526,1673
08.12.2019 08:00,2608,44.92,513,513,2095
08.12.2019 09:00,2779,39.58,542,530,2237
08.12.2019 10:00,2686,38.71,568,575,2118
08.12.2019 11:00,2627,38.5,574,627,2053
08.12.2019 12:00,2624,38.56,608,672,2016
08.12.2019 13:00,2552,38.35,640,713,1912
08.12.2019 14:00,2625,38.26,664,744,1961
08.12.2019 15:00,2630,38.11,706,752,1924
08.12.2019 16:00,2578,37.51,707,750,1871
08.12.2019 17:00,2524,38.71,734,730,1790
08.12.2019 18:00,2572,44.44,681,684,1891
08.12.2019 19:00,2558,59.09,631,613,1927
08.12.2019 20:00,2532,65.02,555,531,1977
08.12.2019 21:00,2463,38.82,513,477,1950
08.12.2019 22:00,2383,38.82,475,452,1908
08.12.2019 23:00,2214,38.33,422,433,1792
13.08.2019 00:00,2006,36.13,381,421,1625
13.08.2019 01:00,1877,34.97,366,413,1511
13.08.2019 02:00,1824,34.01,352,380,1472
13.08.2019 03:00,1761,33.07,340,346,1421
13.08.2019 04:00,1757,33.27,318,313,1439
13.08.2019 05:00,1768,33.19,286,284,1482
13.08.2019 06:00,1866,35.31,283,261,1583
13.08.2019 07:00,2151,42.2,287,239,1864
13.08.2019 08:00,2538,52.96,239,225,2299
13.08.2019 09:00,2765,49.97,223,228,2542
13.08.2019 10:00,2829,40.85,240,244,2589
13.08.2019 11:00,2818,38.17,210,264,2608
13.08.2019 12:00,2828,37.38,186,290,2642
13.08.2019 13:00,2776,37.88,208,309,2568
13.08.2019 14:00,2678,37.68,233,323,2445
13.08.2019 15:00,2612,36.99,275,338,2337
13.08.2019 16:00,2581,36.71,298,353,2283
13.08.2019 17:00,2510,36.26,376,359,2134
13.08.2019 18:00,2526,36.46,403,355,2123
13.08.2019 19:00,2620,37.6,437,349,2183
13.08.2019 20:00,2588,45.69,416,344,2172
13.08.2019 21:00,2501,48.74,401,356,2100
13.08.2019 22:00,2411,46.77,418,390,1993
13.08.2019 23:00,2134,37.16,421,427,1713
14.08.2019 00:00,1987,35.43,498,461,1489
14.08.2019 01:00,1934,32.72,543,546,1391
14.08.2019 02:00,1850,30.45,553,546,1297
14.08.2019 03:00,1793,28.43,542,534,1251
14.08.2019 04:00,1755,28.27,533,518,1222
14.08.2019 05:00,1812,29.68,538,501,1274
14.08.2019 06:00,1886,32.64,503,469,1383
14.08.2019 07:00,2224,36.64,461,439,1763
14.08.2019 08:00,2626,48.24,435,413,2191
14.08.2019 09:00,2792,44.74,438,410,2354
14.08.2019 10:00,2735,37.77,452,426,2283
14.08.2019 11:00,2788,36.54,434,439,2354
14.08.2019 12:00,2809,35.92,401,458,2408
14.08.2019 13:00,2757,35.34,413,471,2344
14.08.2019 14:00,2732,35.16,420,485,2312
14.08.2019 15:00,2635,35.01,428,496,2207
14.08.2019 16:00,2558,34.91,465,510,2093
14.08.2019 17:00,2481,34.98,483,516,1998
14.08.2019 18:00,2552,37.6,438,477,2114
14.08.2019 19:00,2485,48.08,400,412,2085
14.08.2019 20:00,2465,63.62,373,347,2092
14.08.2019 21:00,2403,66.3,312,311,2091
14.08.2019 22:00,2379,51.48,284,299,2095
14.08.2019 23:00,2129,36.91,288,288,1841
15.08.2019 00:00,1893,35.09,269,273,1624
15.08.2019 01:00,1834,33.01,292,280,1542
15.08.2019 02:00,1804,31.45,290,253,1514
15.08.2019 03:00,1814,29.34,268,222,1546
15.08.2019 04:00,1837,27.81,250,192,1587
15.08.2019 05:00,1896,26.7,226,165,1670
15.08.2019 06:00,2009,30.58,206,156,1803
15.08.2019 07:00,2236,33.88,205,160,2031
15.08.2019 08:00,2531,35.26,198,176,2333
15.08.2019 09:00,2710,35.91,216,195,2494
15.08.2019 10:00,2754,35.64,251,234,2503
15.08.2019 11:00,2773,35.62,297,286,2476
15.08.2019 12:00,2698,35.57,324,346,2374
15.08.2019 13:00,2697,35.16,374,404,2323
15.08.2019 14:00,2712,35.05,406,457,2306
15.08.2019 15:00,2658,34.67,458,499,2200
15.08.2019 16:00,2614,34.86,491,527,2123
15.08.2019 17:00,2553,34.67,512,540,2041
15.08.2019 18:00,2598,34.8,505,529,2093
15.08.2019 19:00,2573,35.9,476,508,2097
15.08.2019 20:00,2595,38.06,445,496,2150
15.08.2019 21:00,2647,39.93,444,500,2203
15.08.2019 22:00,2501,36.15,450,510,2051
15.08.2019 23:00,2351,35.07,429,509,1922
16.08.2019 00:00,2142,33.33,414,484,1728
16.08.2019 01:00,1996,31.11,368,389,1628
16.08.2019 02:00,1944,29.53,336,356,1608
16.08.2019 03:00,1888,28.79,301,318,1587
16.08.2019 04:00,1880,29.01,257,292,1623
16.08.2019 05:00,1894,29.93,248,277,1646
16.08.2019 06:00,1993,31.99,237,262,1756
16.08.2019 07:00,2240,34.88,232,237,2008
16.08.2019 08:00,2534,40.04,212,217,2322
16.08.2019 09:00,2703,43.93,176,206,2527
16.08.2019 10:00,2662,39.95,160,206,2502
16.08.2019 11:00,2717,36.91,150,214,2567
16.08.2019 12:00,2679,35.76,186,232,2493
16.08.2019 13:00,2635,35.63,222,258,2413
16.08.2019 14:00,2519,35.12,235,285,2284
16.08.2019 15:00,2433,34.46,242,299,2191
16.08.2019 16:00,2331,34.35,238,302,2093
16.08.2019 17:00,2315,34.05,223,295,2092
16.08.2019 18:00,2443,36.64,225,269,2218
16.08.2019 19:00,2441,45.84,237,229,2204
16.08.2019 20:00,2407,56.52,232,197,2175
16.08.2019 21:00,2302,39.61,217,186,2085
16.08.2019 22:00,2217,37.13,201,186,2016
16.08.2019 23:00,2052,35.99,190,188,1862
17.08.2019 00:00,1907,31.96,181,178,1726
17.08.2019 01:00,1747,32.22,163,170,1584
17.08.2019 02:00,1711,27.39,179,174,1532
17.08.2019 03:00,1694,23.54,228,204,1466
17.08.2019 04:00,1624,18.62,293,259,1331
17.08.2019 05:00,1635,13.91,388,332,1247
17.08.2019 06:00,1579,15.08,425,392,1154
17.08.2019 07:00,1593,25.53,494,448,1099
17.08.2019 08:00,1797,30.55,539,493,1258
17.08.2019 09:00,2094,32.16,556,543,1538
17.08.2019 10:00,2272,33.2,608,606,1664
17.08.2019 11:00,2337,33.32,652,674,1685
17.08.2019 12:00,2318,32.99,692,716,1626
17.08.2019 13:00,2307,31.52,690,741,1617
17.08.2019 14:00,2326,31.27,695,764,1631
17.08.2019 15:00,2330,30.91,723,766,1607
17.08.2019 16:00,2269,30.94,700,757,1569
17.08.2019 17:00,2229,31.19,679,739,1550
17.08.2019 18:00,2249,32.72,640,707,1609
17.08.2019 19:00,2285,33.35,595,663,1690
17.08.2019 20:00,2218,34.62,527,611,1691
17.08.2019 21:00,2229,34.97,508,574,1721
17.08.2019 22:00,2209,35.27,495,533,1714
17.08.2019 23:00,2115,34.56,451,490,1664
18.08.2019 00:00,1944,33.29,394,436,1550
18.08.2019 01:00,1819,31.8,340,388,1479
18.08.2019 02:00,1683,28.61,305,338,1378
18.08.2019 03:00,1644,28.73,265,281,1379
18.08.2019 04:00,1654,29,239,228,1415
18.08.2019 05:00,1645,28.94,202,185,1443
18.08.2019 06:00,1652,28.48,184,163,1468
18.08.2019 07:00,1642,31.08,163,150,1479
18.08.2019 08:00,1726,33.26,140,137,1586
18.08.2019 09:00,1866,33.62,135,140,1731
18.08.2019 10:00,2003,34.27,124,154,1879
18.08.2019 11:00,2119,34.92,131,175,1988
18.08.2019 12:00,2169,34.86,129,189,2040
18.08.2019 13:00,2195,34.33,133,199,2062
18.08.2019 14:00,2190,34.26,144,205,2046
18.08.2019 15:00,2195,34.57,132,205,2063
18.08.2019 16:00,2212,34.69,134,198,2078
18.08.2019 17:00,2257,35.07,139,183,2118
18.08.2019 18:00,2345,35.54,149,182,2196
18.08.2019 19:00,2385,35.27,170,197,2215
18.08.2019 20:00,2339,35.89,215,223,2124
18.08.2019 21:00,2253,36.69,296,265,1957
18.08.2019 22:00,2167,36.78,381,324,1786
18.08.2019 23:00,2082,35.83,362,373,1720
19.08.2019 00:00,1963,33.81,394,395,1569
19.08.2019 01:00,1760,29.59,472,458,1288
19.08.2019 02:00,1700,27.45,452,468,1248
19.08.2019 03:00,1731,26.86,414,455,1317
19.08.2019 04:00,1767,28.16,391,423,1376
19.08.2019 05:00,1768,27.06,386,390,1382
19.08.2019 06:00,1887,31.96,350,373,1537
19.08.2019 07:00,2208,36.08,352,364,1856
19.08.2019 08:00,2584,42.84,367,366,2217
19.08.2019 09:00,2757,40.87,365,389,2392
19.08.2019 10:00,2683,36.98,410,430,2273
19.08.2019 11:00,2688,35.71,459,486,2229
19.08.2019 12:00,2705,35.77,491,549,2214
19.08.2019 13:00,2710,35.83,564,613,2146
19.08.2019 14:00,2716,35.76,602,664,2114
19.08.2019 15:00,2624,35.55,654,682,1970
19.08.2019 16:00,2539,35.35,617,680,1922
19.08.2019 17:00,2510,34.69,610,667,1900
19.08.2019 18:00,2489,34.85,642,631,1847
19.08.2019 19:00,2564,37.08,606,573,1958
19.08.2019 20:00,2630,43.5,557,514,2073
19.08.2019 21:00,2607,47.67,484,490,2123
19.08.2019 22:00,2447,36.53,473,500,1974
19.08.2019 23:00,2160,35.84,483,521,1677
20.08.2019 00:00,2026,34.08,508,536,1518
20.08.2019 01:00,1892,31.38,513,497,1379
20.08.2019 02:00,1818,29.74,521,482,1297
20.08.2019 03:00,1804,29.58,504,453,1300
20.08.2019 04:00,1849,28.67,486,416,1363
20.08.2019 05:00,1855,30.08,443,380,1412
20.08.2019 06:00,1929,33.33,400,344,1529
20.08.2019 07:00,2242,37.52,356,313,1886
20.08.2019 08:00,2622,44.66,342,290,2280
20.08.2019 09:00,2752,47.15,337,296,2415
20.08.2019 10:00,2731,44.04,359,324,2372
20.08.2019 11:00,2679,38.56,354,366,2325
20.08.2019 12:00,2614,37.98,362,413,2252
20.08.2019 13:00,2540,37.82,416,459,2124
20.08.2019 14:00,2576,37.35,456,484,2120
20.08.2019 15:00,2594,37.55,460,476,2134
20.08.2019 16:00,2625,37.53,424,456,2201
20.08.2019 17:00,2554,36.91,388,423,2166
20.08.2019 18:00,2710,43.89,348,376,2362
20.08.2019 19:00,2602,48.85,286,326,2316
20.08.2019 20:00,2564,52.56,246,273,2318
20.08.2019 21:00,2479,39.29,240,255,2239
20.08.2019 22:00,2419,36.98,246,254,2173
20.08.2019 23:00,2163,35.96,255,256,1908
21.08.2019 00:00,1944,34.99,253,259,1691
21.08.2019 01:00,1783,33.07,232,232,1551
21.08.2019 02:00,1736,33.11,256,223,1480
21.08.2019 03:00,1699,32.01,248,212,1451
21.08.2019 04:00,1722,31.23,243,200,1479
21.08.2019 05:00,1739,31.93,231,193,1508
21.08.2019 06:00,1869,33.97,221,185,1648
21.08.2019 07:00,2145,41.35,199,175,1946
21.08.2019 08:00,2488,57,191,169,2297
21.08.2019 09:00,2658,56.11,208,175,2450
21.08.2019 10:00,2631,41.95,220,201,2411
21.08.2019 11:00,2641,38,241,240,2400
21.08.2019 12:00,2613,37.3,271,287,2342
21.08.2019 13:00,2529,36.6,310,337,2219
21.08.2019 14:00,2502,36.04,339,389,2163
21.08.2019 15:00,2473,35.85,388,419,2085
21.08.2019 16:00,2419,35.69,421,433,1998
21.08.2019 17:00,2429,35.97,424,430,2005
21.08.2019 18:00,2462,39.64,369,390,2093
21.08.2019 19:00,2461,48.84,336,329,2125
21.08.2019 20:00,2444,65.15,267,272,2177
21.08.2019 21:00,2443,67.26,247,249,2196
21.08.2019 22:00,2334,51.63,248,242,2086
21.08.2019 23:00,2087,36.57,227,237,1860
22.08.2019 00:00,1870,35.87,236,225,1634
22.08.2019 01:00,1761,33.26,236,229,1525
22.08.2019 02:00,1712,32.35,231,225,1481
22.08.2019 03:00,1719,30.94,223,223,1496
22.08.2019 04:00,1730,30.77,224,219,1506
22.08.2019 05:00,1774,32.07,217,208,1557
22.08.2019 06:00,1879,34.37,215,198,1664
22.08.2019 07:00,2156,36.64,207,192,1949
22.08.2019 08:00,2470,41.93,193,183,2277
22.08.2019 09:00,2630,40.64,185,190,2445
22.08.2019 10:00,2650,38.34,214,229,2436
22.08.2019 11:00,2630,36.7,298,300,2332
22.08.2019 12:00,2595,36.59,364,368,2231
22.08.2019 13:00,2503,36.53,394,429,2109
22.08.2019 14:00,2518,36.3,456,477,2062
22.08.2019 15:00,2516,36.11,498,491,2018
22.08.2019 16:00,2480,36.05,515,474,1965
22.08.2019 17:00,2384,36.02,502,451,1882
22.08.2019 18:00,2396,36.69,467,427,1929
22.08.2019 19:00,2433,41.45,457,411,1976
22.08.2019 20:00,2395,54.03,463,413,1932
22.08.2019 21:00,2324,50.57,467,431,1857
22.08.2019 22:00,2274,39.54,477,452,1797
22.08.2019 23:00,2143,36.49,481,462,1662
23.08.2019 00:00,1944,33.95,507,455,1437
23.08.2019 01:00,1900,31.02,506,506,1394
23.08.2019 02:00,1856,30.17,462,478,1394
23.08.2019 03:00,1836,30.07,431,449,1405
23.08.2019 04:00,1772,30.03,393,419,1379
23.08.2019 05:00,1764,30.99,382,395,1382
23.08.2019 06:00,1856,34.06,394,379,1462
23.08.2019 07:00,2129,38.1,396,370,1733
23.08.2019 08:00,2492,42.87,401,363,2091
23.08.2019 09:00,2624,40.02,409,372,2215
23.08.2019 10:00,2650,36.68,433,405,2217
23.08.2019 11:00,2698,35.6,505,459,2193
23.08.2019 12:00,2628,35.54,542,522,2086
23.08.2019 13:00,2544,35.5,605,586,1939
23.08.2019 14:00,2455,35.51,642,635,1813
23.08.2019 15:00,2388,35.08,658,636,1730
23.08.2019 16:00,2385,34.98,658,599,1727
23.08.2019 17:00,2406,35.62,636,536,1770
23.08.2019 18:00,2465,37.01,553,455,1912
23.08.2019 19:00,2396,47.58,446,374,1950
23.08.2019 20:00,2284,58.14,358,306,1926
23.08.2019 21:00,2222,56.38,287,264,1935
23.08.2019 22:00,2190,42.7,256,241,1934
23.08.2019 23:00,2028,36.08,244,225,1784
24.08.2019 00:00,1856,34.68,224,206,1632
24.08.2019 01:00,1764,34.07,216,246,1548
24.08.2019 02:00,1734,31.92,205,214,1529
24.08.2019 03:00,1635,30.86,185,183,1450
24.08.2019 04:00,1613,30.82,150,151,1463
24.08.2019 05:00,1624,30.03,115,120,1509
24.08.2019 06:00,1639,31,91,92,1548
24.08.2019 07:00,1675,33.04,63,67,1612
24.08.2019 08:00,1762,35.08,43,48,1719
24.08.2019 09:00,1939,36.29,32,46,1907
24.08.2019 10:00,2074,36.37,24,50,2050
24.08.2019 11:00,2101,36.39,20,54,2081
24.08.2019 12:00,2128,36.32,18,62,2110
24.08.2019 13:00,2122,36.16,19,66,2103
24.08.2019 14:00,2080,35.86,19,68,2061
24.08.2019 15:00,2012,35.54,21,69,1991
24.08.2019 16:00,2000,35.52,24,66,1976
24.08.2019 17:00,2014,35.51,28,61,1986
24.08.2019 18:00,2030,35.13,29,55,2001
24.08.2019 19:00,2059,36.93,33,50,2026
24.08.2019 20:00,2049,41.37,40,48,2009
24.08.2019 21:00,2057,37.82,47,52,2010
24.08.2019 22:00,2037,36.29,53,57,1984
24.08.2019 23:00,1925,34.95,63,64,1862
25.08.2019 00:00,1753,31.67,78,78,1675
25.08.2019 01:00,1657,31.37,94,101,1563
25.08.2019 02:00,1611,29.98,109,114,1502
25.08.2019 03:00,1587,29.65,119,125,1468
25.08.2019 04:00,1589,29.43,126,131,1463
25.08.2019 05:00,1574,29.43,131,138,1443
25.08.2019 06:00,1562,28.96,142,149,1420
25.08.2019 07:00,1562,29.22,152,160,1410
25.08.2019 08:00,1657,31.27,147,162,1510
25.08.2019 09:00,1825,32.14,121,150,1704
25.08.2019 10:00,1933,35.03,100,143,1833
25.08.2019 11:00,2034,35.29,91,142,1943
25.08.2019 12:00,2054,35.19,91,147,1963
25.08.2019 13:00,2064,34.82,86,154,1978
25.08.2019 14:00,2044,33.38,101,160,1943
25.08.2019 15:00,2040,33.22,112,164,1928
25.08.2019 16:00,2028,33.17,117,163,1911
25.08.2019 17:00,2063,34.7,122,160,1941
25.08.2019 18:00,2131,35.33,119,153,2012
25.08.2019 19:00,2206,37.02,118,147,2088
25.08.2019 20:00,2207,36.94,130,152,2077
25.08.2019 21:00,2224,36.87,167,177,2057
25.08.2019 22:00,2203,36.31,195,204,2008
25.08.2019 23:00,1963,35.3,215,229,1748
26.08.2019 00:00,1767,33.78,218,230,1549
26.08.2019 01:00,1739,32.86,229,243,1510
26.08.2019 02:00,1688,32.18,210,206,1478
26.08.2019 03:00,1709,32.06,203,176,1506
26.08.2019 04:00,1727,32.23,180,158,1547
26.08.2019 05:00,1768,32.63,162,145,1606
26.08.2019 06:00,1885,33.7,140,138,1745
26.08.2019 07:00,2114,48.87,138,138,1976
26.08.2019 08:00,2477,67.65,128,135,2349
26.08.2019 09:00,2611,61.99,112,121,2499
26.08.2019 10:00,2713,49.18,128,108,2585
26.08.2019 11:00,2776,45.7,104,110,2672
26.08.2019 12:00,2781,43.74,85,125,2696
26.08.2019 13:00,2705,40.91,94,146,2611
26.08.2019 14:00,2672,39.37,95,161,2577
26.08.2019 15:00,2698,38.78,111,163,2587
26.08.2019 16:00,2692,38.39,120,152,2572
26.08.2019 17:00,2654,42.42,118,138,2536
26.08.2019 18:00,2693,53.02,107,126,2586
26.08.2019 19:00,2607,54.63,116,125,2491
26.08.2019 20:00,2522,65.52,135,138,2387
26.08.2019 21:00,2489,58.03,160,162,2329
26.08.2019 22:00,2366,54.32,176,188,2190
26.08.2019 23:00,2167,40.11,196,202,1971
27.08.2019 00:00,1983,37.32,205,204,1778
27.08.2019 01:00,1873,37.41,199,189,1674
27.08.2019 02:00,1827,35.26,189,177,1638
27.08.2019 03:00,1762,34.91,187,182,1575
27.08.2019 04:00,1712,34.67,204,202,1508
27.08.2019 05:00,1730,34.96,245,227,1485
27.08.2019 06:00,1860,35.91,283,246,1577
27.08.2019 07:00,2097,44.15,297,259,1800
27.08.2019 08:00,2424,55.4,296,248,2128
27.08.2019 09:00,2671,53.69,246,205,2425
27.08.2019 10:00,2744,52.25,211,177,2533
27.08.2019 11:00,2803,50.95,188,171,2615
27.08.2019 12:00,2780,48.82,165,183,2615
27.08.2019 13:00,2684,45.15,139,201,2545
27.08.2019 14:00,2674,44.98,148,216,2526
27.08.2019 15:00,2661,45.09,162,226,2499
27.08.2019 16:00,2690,44.02,176,231,2514
27.08.2019 17:00,2662,46.92,181,231,2481
27.08.2019 18:00,2675,49.99,185,236,2490
27.08.2019 19:00,2640,55.62,209,251,2431
27.08.2019 20:00,2542,61.91,255,285,2287
27.08.2019 21:00,2491,54.71,331,338,2160
27.08.2019 22:00,2261,49.97,393,395,1868
27.08.2019 23:00,2132,37.05,404,437,1728
28.08.2019 00:00,2043,36.33,423,449,1620
28.08.2019 01:00,1961,36.13,459,464,1502
28.08.2019 02:00,1765,35.55,451,457,1314
28.08.2019 03:00,1697,34.92,446,440,1251
28.08.2019 04:00,1660,34.84,425,414,1235
28.08.2019 05:00,1625,35.35,401,395,1224
28.08.2019 06:00,1869,37.04,390,392,1479
28.08.2019 07:00,2133,47.15,400,387,1733
28.08.2019 08:00,2466,64.55,334,364,2132
28.08.2019 09:00,2640,66.73,299,328,2341
28.08.2019 10:00,2753,56.07,275,316,2478
28.08.2019 11:00,2839,52.79,263,313,2576
28.08.2019 12:00,2875,51.7,283,313,2592
28.08.2019 13:00,2800,46.58,257,314,2543
28.08.2019 14:00,2715,44.73,242,313,2473
28.08.2019 15:00,2654,45,245,302,2409
28.08.2019 16:00,2658,45.6,234,281,2424
28.08.2019 17:00,2651,47.66,225,253,2426
28.08.2019 18:00,2668,54.58,197,230,2471
28.08.2019 19:00,2614,68.17,198,220,2416
28.08.2019 20:00,2568,72.13,199,214,2369
28.08.2019 21:00,2486,66.47,206,220,2280
28.08.2019 22:00,2352,56.03,223,222,2129
28.08.2019 23:00,2175,37.2,210,209,1965
29.08.2019 00:00,1983,35.64,221,191,1762
29.08.2019 01:00,1865,35.28,223,212,1642
29.08.2019 02:00,1775,34.79,222,191,1553
29.08.2019 03:00,1758,34.5,218,168,1540
29.08.2019 04:00,1840,33.98,187,142,1653
29.08.2019 05:00,1876,34.39,148,124,1728
29.08.2019 06:00,1949,35.39,122,107,1827
29.08.2019 07:00,2180,42.13,88,92,2092
29.08.2019 08:00,2451,52.54,100,85,2351
29.08.2019 09:00,2591,58.92,96,86,2495
29.08.2019 10:00,2638,56.92,107,103,2531
29.08.2019 11:00,2707,51.9,96,120,2611
29.08.2019 12:00,2793,50.01,147,136,2646
29.08.2019 13:00,2768,42.12,164,164,2604
29.08.2019 14:00,2776,39.62,187,180,2589
29.08.2019 15:00,2685,37.92,199,199,2486
29.08.2019 16:00,2640,37.71,184,224,2456
29.08.2019 17:00,2658,37.42,212,247,2446
29.08.2019 18:00,2633,42.94,234,253,2399
29.08.2019 19:00,2547,49.67,238,261,2309
29.08.2019 20:00,2506,60.49,223,275,2283
29.08.2019 21:00,2527,54.95,250,292,2277
29.08.2019 22:00,2366,38.93,252,307,2114
29.08.2019 23:00,2178,36.54,232,315,1946
30.08.2019 00:00,1974,35.42,236,302,1738
30.08.2019 01:00,1867,33.51,235,201,1632
30.08.2019 02:00,1770,33.1,210,182,1560
30.08.2019 03:00,1749,33.55,183,163,1566
30.08.2019 04:00,1732,32.25,153,142,1579
30.08.2019 05:00,1734,34.08,153,123,1581
30.08.2019 06:00,1867,35.29,128,108,1739
30.08.2019 07:00,2111,48.58,111,96,2000
30.08.2019 08:00,2469,51.28,108,88,2361
30.08.2019 09:00,2610,50.8,107,94,2503
30.08.2019 10:00,2639,46.04,103,115,2536
30.08.2019 11:00,2680,41.36,117,142,2563
30.08.2019 12:00,2664,38.19,127,166,2537
30.08.2019 13:00,2605,37.07,175,186,2430
30.08.2019 14:00,2538,36.63,210,202,2328
30.08.2019 15:00,2437,35.93,219,204,2218
30.08.2019 16:00,2413,36.32,209,196,2204
30.08.2019 17:00,2386,37.11,192,177,2194
30.08.2019 18:00,2462,43.4,170,153,2292
30.08.2019 19:00,2460,49.28,150,132,2310
30.08.2019 20:00,2343,51.08,131,129,2212
30.08.2019 21:00,2295,51.23,131,143,2164
30.08.2019 22:00,2155,50.28,153,167,2002
30.08.2019 23:00,1959,35.85,182,197,1777
31.08.2019 00:00,1845,35.63,205,211,1640
31.08.2019 01:00,1733,35.7,214,208,1519
31.08.2019 02:00,1697,32.66,229,198,1468
31.08.2019 03:00,1694,30.64,231,188,1463
31.08.2019 04:00,1692,31.05,222,177,1470
31.08.2019 05:00,1726,30.3,202,168,1524
31.08.2019 06:00,1774,31.01,179,161,1595
31.08.2019 07:00,1726,32.05,165,157,1561
31.08.2019 08:00,1803,33.64,147,143,1656
31.08.2019 09:00,1970,34.57,116,132,1854
31.08.2019 10:00,2139,35.53,116,139,2023
31.08.2019 11:00,2197,35.68,145,168,2052
31.08.2019 12:00,2223,35.49,182,216,2041
31.08.2019 13:00,2143,35.25,206,267,1937
31.08.2019 14:00,2142,34.43,263,315,1879
31.08.2019 15:00,2104,34.28,309,342,1795
31.08.2019 16:00,2087,34.35,304,349,1783
31.08.2019 17:00,2090,34.5,327,344,1763
31.08.2019 18:00,2126,34.97,345,334,1781
31.08.2019 19:00,2172,38.3,350,336,1822
31.08.2019 20:00,2162,45.45,359,368,1803
31.08.2019 21:00,2207,44.53,403,427,1804
31.08.2019 22:00,2097,38.01,460,480,1637
31.08.2019 23:00,1947,35.89,524,520,1423
09.01.2019 00:00,1740,33.02,550,553,1190
09.01.2019 01:00,1712,28.75,560,596,1152
09.01.2019 02:00,1655,27.36,648,607,1007
09.01.2019 03:00,1565,26.47,715,602,850
09.01.2019 04:00,1591,26.55,739,595,852
09.01.2019 05:00,1521,25.91,685,595,836
09.01.2019 06:00,1554,26.61,635,599,919
09.01.2019 07:00,1730,27.16,606,611,1124
09.01.2019 08:00,1879,27.36,578,590,1301
09.01.2019 09:00,2033,32.86,512,546,1521
09.01.2019 10:00,2180,34.99,468,509,1712
09.01.2019 11:00,2151,35.79,439,487,1712
09.01.2019 12:00,2069,35.72,438,470,1631
09.01.2019 13:00,2145,35,409,454,1736
09.01.2019 14:00,2172,34.27,393,448,1779
09.01.2019 15:00,2281,33.74,437,451,1844
09.01.2019 16:00,2303,32.99,401,450,1902
09.01.2019 17:00,2300,33.04,410,453,1890
09.01.2019 18:00,2328,32.4,385,429,1943
09.01.2019 19:00,2377,34.07,345,381,2032
09.01.2019 20:00,2318,36.52,299,336,2019
09.01.2019 21:00,2399,38.72,279,311,2120
09.01.2019 22:00,2270,37.83,263,309,2007
09.01.2019 23:00,2110,36.43,274,321,1836
09.02.2019 00:00,1954,34.24,263,330,1691
09.02.2019 01:00,1740,30,252,301,1488
09.02.2019 02:00,1630,26.97,269,299,1361
09.02.2019 03:00,1630,25.96,277,296,1353
09.02.2019 04:00,1671,25,292,285,1379
09.02.2019 05:00,1703,26.26,305,277,1398
09.02.2019 06:00,1817,29.96,307,276,1510
09.02.2019 07:00,2064,38.21,314,282,1750
09.02.2019 08:00,2402,46.09,312,282,2090
09.02.2019 09:00,2555,50.77,342,311,2213
09.02.2019 10:00,2554,48.29,392,380,2162
09.02.2019 11:00,2545,44.07,455,453,2090
09.02.2019 12:00,2537,41.81,515,522,2022
09.02.2019 13:00,2445,39.24,573,589,1872
09.02.2019 14:00,2577,39.12,626,649,1951
09.02.2019 15:00,2629,38.87,695,697,1934
09.02.2019 16:00,2648,38.46,703,722,1945
09.02.2019 17:00,2588,38.49,713,720,1875
09.02.2019 18:00,2612,40.84,654,681,1958
09.02.2019 19:00,2594,45.41,585,608,2009
09.02.2019 20:00,2531,61.67,500,524,2031
09.02.2019 21:00,2529,52.91,462,473,2067
09.02.2019 22:00,2360,46.92,431,446,1929
09.02.2019 23:00,2193,40.4,404,424,1789
09.03.2019 00:00,1998,35.24,412,399,1586
09.03.2019 01:00,1915,34.4,348,328,1567
09.03.2019 02:00,1845,34.22,304,300,1541
09.03.2019 03:00,1818,33.58,288,306,1530
09.03.2019 04:00,1849,34.11,344,333,1505
09.03.2019 05:00,1867,34.79,406,385,1461
09.03.2019 06:00,1992,35.63,450,438,1542
09.03.2019 07:00,2249,37.5,510,490,1739
09.03.2019 08:00,2481,40.74,551,540,1930
09.03.2019 09:00,2753,40.97,627,604,2126
09.03.2019 10:00,2866,39.55,749,709,2117
09.03.2019 11:00,2861,39.34,812,807,2049
09.03.2019 12:00,2923,38.65,822,834,2101
09.03.2019 13:00,2979,38.74,752,810,2227
09.03.2019 14:00,2992,38.43,721,768,2271
09.03.2019 15:00,2945,38.28,661,747,2284
09.03.2019 16:00,2819,38.22,598,731,2221
09.03.2019 17:00,2700,38.51,563,704,2137
09.03.2019 18:00,2666,39.76,567,662,2099
09.03.2019 19:00,2656,44.96,535,612,2121
09.03.2019 20:00,2663,50.83,530,573,2133
09.03.2019 21:00,2603,53.36,550,560,2053
09.03.2019 22:00,2415,46.12,535,558,1880
09.03.2019 23:00,2206,40.9,536,536,1670
09.04.2019 00:00,2040,36.08,546,505,1494
09.04.2019 01:00,1955,34.12,564,520,1391
09.04.2019 02:00,1856,33.45,516,490,1340
09.04.2019 03:00,1806,31.91,465,456,1341
09.04.2019 04:00,1801,32.95,434,417,1367
09.04.2019 05:00,1794,34.84,399,376,1395
09.04.2019 06:00,1959,36.94,336,318,1623
09.04.2019 07:00,2262,39.72,296,260,1966
09.04.2019 08:00,2585,46.96,246,212,2339
09.04.2019 09:00,2781,66.18,227,191,2554
09.04.2019 10:00,2788,66.77,219,209,2569
09.04.2019 11:00,2825,67.78,260,262,2565
09.04.2019 12:00,2817,59.98,306,322,2511
09.04.2019 13:00,2761,40.65,369,383,2392
09.04.2019 14:00,2754,40.2,411,444,2343
09.04.2019 15:00,2781,39.98,482,507,2299
09.04.2019 16:00,2732,39.91,525,566,2207
09.04.2019 17:00,2673,39.22,570,607,2103
09.04.2019 18:00,2700,38.97,590,602,2110
09.04.2019 19:00,2704,38.92,589,588,2115
09.04.2019 20:00,2687,40.26,563,603,2124
09.04.2019 21:00,2687,40.67,591,648,2096
09.04.2019 22:00,2539,38.25,656,701,1883
09.04.2019 23:00,2227,35.5,661,743,1566
09.05.2019 00:00,2035,34.27,659,756,1376
09.05.2019 01:00,1949,31.22,643,657,1306
09.05.2019 02:00,1846,29.79,625,610,1221
09.05.2019 03:00,1777,28.33,609,559,1168
09.05.2019 04:00,1815,27.64,532,506,1283
09.05.2019 05:00,1792,28.65,515,462,1277
09.05.2019 06:00,1898,29.5,477,431,1421
09.05.2019 07:00,2146,34.26,439,406,1707
09.05.2019 08:00,2486,38.67,417,379,2069
09.05.2019 09:00,2654,39.61,386,389,2268
09.05.2019 10:00,2671,37.19,432,450,2239
09.05.2019 11:00,2593,36,517,538,2076
09.05.2019 12:00,2639,35.84,583,620,2056
09.05.2019 13:00,2696,34.89,657,694,2039
09.05.2019 14:00,2633,35.11,699,755,1934
09.05.2019 15:00,2739,35.22,703,781,2036
09.05.2019 16:00,2727,34.92,756,789,1971
09.05.2019 17:00,2579,34.97,816,784,1763
09.05.2019 18:00,2669,35.15,803,777,1866
09.05.2019 19:00,2648,35.93,803,769,1845
09.05.2019 20:00,2646,37.7,818,761,1828
09.05.2019 21:00,2526,38.52,756,774,1770
09.05.2019 22:00,2349,37.51,785,806,1564
09.05.2019 23:00,2182,35.53,870,835,1312
09.06.2019 00:00,1914,31.6,876,861,1038
09.06.2019 01:00,1833,26.28,918,925,915
09.06.2019 02:00,1856,25.64,957,940,899
09.06.2019 03:00,1860,24.36,943,934,917
09.06.2019 04:00,1915,24.67,927,910,988
09.06.2019 05:00,1895,26.3,888,872,1007
09.06.2019 06:00,2031,28.18,802,805,1229
09.06.2019 07:00,2328,33.71,701,732,1627
09.06.2019 08:00,2684,37.6,689,662,1995
09.06.2019 09:00,2761,39.07,619,615,2142
09.06.2019 10:00,2760,38.99,633,611,2127
09.06.2019 11:00,2692,37.45,592,625,2100
09.06.2019 12:00,2626,35.72,607,626,2019
09.06.2019 13:00,2614,36.48,599,606,2015
09.06.2019 14:00,2643,36.11,566,583,2077
09.06.2019 15:00,2638,34.95,587,557,2051
09.06.2019 16:00,2537,34.91,602,537,1935
09.06.2019 17:00,2394,34.77,567,527,1827
09.06.2019 18:00,2391,35.1,561,523,1830
09.06.2019 19:00,2412,37.34,521,540,1891
09.06.2019 20:00,2453,37.57,547,573,1906
09.06.2019 21:00,2497,37.61,560,614,1937
09.06.2019 22:00,2388,36.8,625,660,1763
09.06.2019 23:00,2162,34.89,616,691,1546
09.07.2019 00:00,2098,34.07,595,731,1503
09.07.2019 01:00,2012,32.8,666,691,1346
09.07.2019 02:00,1854,31.07,738,722,1116
09.07.2019 03:00,1824,30.43,732,724,1092
09.07.2019 04:00,1810,30.72,742,727,1068
09.07.2019 05:00,1851,30.71,754,726,1097
09.07.2019 06:00,1876,31.02,703,692,1173
09.07.2019 07:00,1848,32.83,664,646,1184
09.07.2019 08:00,1941,34.84,587,588,1354
09.07.2019 09:00,2234,35.65,540,518,1694
09.07.2019 10:00,2331,37.55,470,459,1861
09.07.2019 11:00,2333,39.02,399,414,1934
09.07.2019 12:00,2210,36.93,350,390,1860
09.07.2019 13:00,2107,36,325,374,1782
09.07.2019 14:00,2063,35.09,315,351,1748
09.07.2019 15:00,2026,34.8,302,315,1724
09.07.2019 16:00,2036,34.34,270,274,1766
09.07.2019 17:00,2080,34.98,237,230,1843
09.07.2019 18:00,2123,37.29,196,178,1927
09.07.2019 19:00,2130,43,148,131,1982
09.07.2019 20:00,2125,45.59,119,111,2006
09.07.2019 21:00,2176,46.85,96,104,2080
09.07.2019 22:00,2073,38.06,82,96,1991
09.07.2019 23:00,2008,37.07,67,85,1941
09.08.2019 00:00,1886,34.78,53,66,1833
09.08.2019 01:00,1780,34.46,27,49,1753
09.08.2019 02:00,1704,33.41,24,32,1680
09.08.2019 03:00,1634,32.88,25,29,1609
09.08.2019 04:00,1638,32.75,19,29,1619
09.08.2019 05:00,1631,32.71,29,33,1602
09.08.2019 06:00,1633,32.86,43,41,1590
09.08.2019 07:00,1632,33.53,62,55,1570
09.08.2019 08:00,1708,34.02,79,68,1629
09.08.2019 09:00,1929,35,93,73,1836
09.08.2019 10:00,2098,37.27,98,81,2000
09.08.2019 11:00,2173,36.31,95,94,2078
09.08.2019 12:00,2214,36.19,98,112,2116
09.08.2019 13:00,2198,35.63,99,133,2099
09.08.2019 14:00,2160,34.98,99,156,2061
09.08.2019 15:00,2132,34.93,112,173,2020
09.08.2019 16:00,2173,34.87,128,180,2045
09.08.2019 17:00,2225,35.15,140,182,2085
09.08.2019 18:00,2277,38.31,132,181,2145
09.08.2019 19:00,2272,42.07,123,181,2149
09.08.2019 20:00,2282,48.36,135,190,2147
09.08.2019 21:00,2310,53.04,148,201,2162
09.08.2019 22:00,2159,44.4,162,209,1997
09.08.2019 23:00,2030,35.72,173,215,1857
09.09.2019 00:00,1938,35.05,171,208,1767
09.09.2019 01:00,1896,35.41,151,118,1745
09.09.2019 02:00,1832,34.05,146,103,1686
09.09.2019 03:00,1796,33.09,118,91,1678
09.09.2019 04:00,1777,32.88,95,84,1682
09.09.2019 05:00,1803,33.23,95,78,1708
09.09.2019 06:00,1911,34.16,82,70,1829
09.09.2019 07:00,2254,48.18,67,59,2187
09.09.2019 08:00,2586,63.52,63,51,2523
09.09.2019 09:00,2747,71.36,71,46,2676
09.09.2019 10:00,2826,56.51,68,47,2758
09.09.2019 11:00,2827,48.71,54,55,2773
09.09.2019 12:00,2793,47.83,65,62,2728
09.09.2019 13:00,2732,46,80,72,2652
09.09.2019 14:00,2714,45.23,89,85,2625
09.09.2019 15:00,2728,42.64,98,100,2630
09.09.2019 16:00,2681,42.23,122,116,2559
09.09.2019 17:00,2664,41.6,148,138,2516
09.09.2019 18:00,2682,45.14,175,163,2507
09.09.2019 19:00,2593,49.99,232,205,2361
09.09.2019 20:00,2577,60.94,288,271,2289
09.09.2019 21:00,2555,57.48,318,322,2237
09.09.2019 22:00,2441,44.83,330,357,2111
09.09.2019 23:00,2336,39.41,333,389,2003
09.10.2019 00:00,2124,34.35,313,398,1811
09.10.2019 01:00,1953,33.01,315,351,1638
09.10.2019 02:00,1883,32.45,291,321,1592
09.10.2019 03:00,1890,31.09,292,297,1598
09.10.2019 04:00,1775,30.76,265,283,1510
09.10.2019 05:00,1832,31.29,259,274,1573
09.10.2019 06:00,2007,33.21,277,276,1730
09.10.2019 07:00,2293,40.02,260,278,2033
09.10.2019 08:00,2610,44.95,245,273,2365
09.10.2019 09:00,2704,45.93,242,262,2462
09.10.2019 10:00,2766,41,245,256,2521
09.10.2019 11:00,2880,36,290,275,2590
09.10.2019 12:00,2903,35.36,289,287,2614
09.10.2019 13:00,2841,35.6,283,304,2558
09.10.2019 14:00,2773,35.47,282,323,2491
09.10.2019 15:00,2756,35.43,272,339,2484
09.10.2019 16:00,2752,35.04,250,342,2502
09.10.2019 17:00,2703,34.94,223,349,2480
09.10.2019 18:00,2768,38.24,212,335,2556
09.10.2019 19:00,2678,43.86,251,324,2427
09.10.2019 20:00,2717,46.86,286,342,2431
09.10.2019 21:00,2713,50.35,323,388,2390
09.10.2019 22:00,2545,41.72,381,453,2164
09.10.2019 23:00,2333,34.82,429,517,1904
09.11.2019 00:00,2116,31.7,494,582,1622
09.11.2019 01:00,1943,31.25,489,499,1454
09.11.2019 02:00,1935,30.23,545,558,1390
09.11.2019 03:00,1858,28.62,617,621,1241
09.11.2019 04:00,1795,28.88,686,695,1109
09.11.2019 05:00,1853,29.9,757,760,1096
09.11.2019 06:00,2005,32.71,765,776,1240
09.11.2019 07:00,2282,36.61,748,759,1534
09.11.2019 08:00,2689,41.55,715,734,1974
09.11.2019 09:00,2851,42.22,707,724,2144
09.11.2019 10:00,2832,38.86,734,751,2098
09.11.2019 11:00,2781,36.25,758,781,2023
09.11.2019 12:00,2725,34.28,814,822,1911
09.11.2019 13:00,2627,34.36,858,871,1769
09.11.2019 14:00,2629,34.02,919,924,1710
09.11.2019 15:00,2635,33.73,973,960,1662
09.11.2019 16:00,2618,33.24,1016,983,1602
09.11.2019 17:00,2575,32.82,1028,985,1547
09.11.2019 18:00,2643,33.06,1033,953,1610
09.11.2019 19:00,2620,35.06,1038,918,1582
09.11.2019 20:00,2677,35.01,1054,906,1623
09.11.2019 21:00,2592,34.71,1082,938,1510
09.11.2019 22:00,2442,33.92,1128,984,1314
09.11.2019 23:00,2255,32.21,1149,1015,1106
09.12.2019 00:00,2046,29.38,1086,993,960
09.12.2019 01:00,2064,27.21,1060,1060,1004
09.12.2019 02:00,2061,26.76,925,945,1136
09.12.2019 03:00,1985,26.87,809,830,1176
09.12.2019 04:00,1935,26.89,725,729,1210
09.12.2019 05:00,1980,28.03,641,655,1339
09.12.2019 06:00,2086,30.74,623,620,1463
09.12.2019 07:00,2431,32.96,595,610,1836
09.12.2019 08:00,2714,49.11,586,602,2128
09.12.2019 09:00,2847,54.21,597,609,2250
09.12.2019 10:00,2834,46.81,599,639,2235
09.12.2019 11:00,2789,42.88,640,675,2149
09.12.2019 12:00,2714,34.81,684,708,2030
09.12.2019 13:00,2699,34.22,733,742,1966
09.12.2019 14:00,2792,34.43,766,770,2026
09.12.2019 15:00,2735,32.68,770,783,1965
09.12.2019 16:00,2677,32.72,783,778,1894
09.12.2019 17:00,2635,32.75,784,755,1851
09.12.2019 18:00,2703,34.06,759,725,1944
09.12.2019 19:00,2676,34.01,702,696,1974
09.12.2019 20:00,2717,34.48,674,676,2043
09.12.2019 21:00,2688,34.4,681,686,2007
09.12.2019 22:00,2490,33.69,712,697,1778
09.12.2019 23:00,2246,32.46,715,701,1531
13.09.2019 00:00,2125,30.19,714,700,1411
13.09.2019 01:00,1974,29.33,726,719,1248
13.09.2019 02:00,1859,28.31,711,708,1148
13.09.2019 03:00,1860,27.11,677,678,1183
13.09.2019 04:00,1858,26.24,608,627,1250
13.09.2019 05:00,1909,27.05,550,561,1359
13.09.2019 06:00,1978,30.01,560,532,1418
13.09.2019 07:00,2216,39.05,550,528,1666
13.09.2019 08:00,2522,42.93,556,541,1966
13.09.2019 09:00,2754,44.62,606,616,2148
13.09.2019 10:00,2729,43.62,755,747,1974
13.09.2019 11:00,2654,35.08,965,902,1689
13.09.2019 12:00,2609,34.69,1060,1041,1549
13.09.2019 13:00,2578,34.44,1146,1142,1432
13.09.2019 14:00,2548,33.85,1183,1205,1365
13.09.2019 15:00,2478,33.29,1175,1223,1303
13.09.2019 16:00,2439,32.99,1182,1214,1257
13.09.2019 17:00,2417,32.96,1164,1179,1253
13.09.2019 18:00,2454,33.07,1129,1123,1325
13.09.2019 19:00,2561,33.46,1058,1055,1503
13.09.2019 20:00,2525,33.76,1002,988,1523
13.09.2019 21:00,2437,33.49,941,954,1496
13.09.2019 22:00,2305,32.73,937,946,1368
13.09.2019 23:00,2196,30.84,921,940,1275
14.09.2019 00:00,1988,29.01,926,931,1062
14.09.2019 01:00,1962,27.92,943,947,1019
14.09.2019 02:00,1874,27.25,935,926,939
14.09.2019 03:00,1833,26.7,888,892,945
14.09.2019 04:00,1802,27,861,853,941
14.09.2019 05:00,1827,27.26,839,815,988
14.09.2019 06:00,1868,27.9,800,767,1068
14.09.2019 07:00,1909,28.81,718,715,1191
14.09.2019 08:00,2080,31.64,686,670,1394
14.09.2019 09:00,2302,33.42,664,653,1638
14.09.2019 10:00,2352,34.55,692,688,1660
14.09.2019 11:00,2342,34.91,739,735,1603
14.09.2019 12:00,2315,32.54,775,756,1540
14.09.2019 13:00,2223,31.28,812,769,1411
14.09.2019 14:00,2152,30.04,830,770,1322
14.09.2019 15:00,2119,28.72,824,762,1295
14.09.2019 16:00,2095,28.71,776,743,1319
14.09.2019 17:00,2127,30.88,731,706,1396
14.09.2019 18:00,2247,34.28,666,650,1581
14.09.2019 19:00,2344,34.68,645,593,1699
14.09.2019 20:00,2291,34.19,630,569,1661
14.09.2019 21:00,2244,33.61,641,598,1603
14.09.2019 22:00,2106,32.72,691,658,1415
14.09.2019 23:00,2005,30.68,777,732,1228
15.09.2019 00:00,1866,28.34,893,837,973
15.09.2019 01:00,1813,27.46,1023,1012,790
15.09.2019 02:00,1811,24.31,1141,1130,670
15.09.2019 03:00,1782,18.96,1223,1213,559
15.09.2019 04:00,1796,17.29,1271,1264,525
15.09.2019 05:00,1758,15.9,1309,1302,449
15.09.2019 06:00,1775,17,1334,1325,441
15.09.2019 07:00,1840,17.92,1345,1339,495
15.09.2019 08:00,1873,19.15,1344,1345,529
15.09.2019 09:00,2032,24.24,1333,1337,699
15.09.2019 10:00,2184,24.83,1318,1320,866
15.09.2019 11:00,2278,23.37,1303,1304,975
15.09.2019 12:00,2338,24.26,1301,1303,1037
15.09.2019 13:00,2351,22.4,1292,1312,1059
15.09.2019 14:00,2286,21.01,1300,1326,986
15.09.2019 15:00,2209,18.67,1326,1342,883
15.09.2019 16:00,2265,18.41,1334,1352,931
15.09.2019 17:00,2312,25.48,1347,1354,965
15.09.2019 18:00,2423,30.9,1348,1347,1075
15.09.2019 19:00,2446,32.29,1344,1341,1102
15.09.2019 20:00,2483,32.91,1344,1338,1139
15.09.2019 21:00,2475,32.02,1350,1340,1125
15.09.2019 22:00,2348,28.39,1359,1347,989
15.09.2019 23:00,2166,24.43,1366,1351,800
16.09.2019 00:00,2036,23.61,1370,1350,666
16.09.2019 01:00,1987,15.03,1406,1403,581
16.09.2019 02:00,1978,6.56,1399,1398,579
16.09.2019 03:00,1971,6.6,1390,1390,581
16.09.2019 04:00,1979,9.26,1376,1379,603
16.09.2019 05:00,2008,17.22,1358,1362,650
16.09.2019 06:00,2147,25.5,1330,1337,817
16.09.2019 07:00,2523,33.63,1289,1299,1234
16.09.2019 08:00,2834,43.9,1250,1259,1584
16.09.2019 09:00,2920,48.16,1233,1244,1687
16.09.2019 10:00,2883,43.9,1234,1250,1649
16.09.2019 11:00,2877,43.8,1240,1252,1637
16.09.2019 12:00,2889,35.94,1226,1248,1663
16.09.2019 13:00,2825,35.34,1231,1236,1594
16.09.2019 14:00,2811,35.54,1217,1217,1594
16.09.2019 15:00,2788,35.4,1199,1195,1589
16.09.2019 16:00,2751,35.2,1199,1180,1552
16.09.2019 17:00,2696,46.96,1168,1147,1528
16.09.2019 18:00,2754,40.56,1090,1089,1664
16.09.2019 19:00,2818,52.99,997,1012,1821
16.09.2019 20:00,2964,58.54,940,938,2024
16.09.2019 21:00,2913,49.31,893,899,2020
16.09.2019 22:00,2663,43.85,895,886,1768
16.09.2019 23:00,2448,35.11,913,883,1535
17.09.2019 00:00,2257,32.24,912,888,1345
17.09.2019 01:00,2134,31.68,907,900,1227
17.09.2019 02:00,2064,31.63,903,896,1161
17.09.2019 03:00,2034,30.17,911,905,1123
17.09.2019 04:00,2031,30.04,931,931,1100
17.09.2019 05:00,2119,30.57,973,960,1146
17.09.2019 06:00,2304,33.15,1000,986,1304
17.09.2019 07:00,2673,36.48,1020,1006,1653
17.09.2019 08:00,2923,49.69,1032,1018,1891
17.09.2019 09:00,3025,50.78,1045,1035,1980
17.09.2019 10:00,2968,44.01,1060,1054,1908
17.09.2019 11:00,2986,37.4,1069,1071,1917
17.09.2019 12:00,3040,36.58,1067,1041,1973
17.09.2019 13:00,2916,35.94,1022,1003,1894
17.09.2019 14:00,2927,35.84,1000,974,1927
17.09.2019 15:00,2974,35.64,984,955,1990
17.09.2019 16:00,2979,35.48,1008,953,1971
17.09.2019 17:00,3029,35.3,1006,958,2023
17.09.2019 18:00,3002,35.35,1005,939,1997
17.09.2019 19:00,2935,35.63,989,912,1946
17.09.2019 20:00,3099,38.54,955,884,2144
17.09.2019 21:00,3022,38.81,941,852,2081
17.09.2019 22:00,2773,35.77,894,816,1879
17.09.2019 23:00,2449,33.23,852,773,1597
18.09.2019 00:00,2279,30.03,774,732,1505
18.09.2019 01:00,2174,30.27,720,724,1454
18.09.2019 02:00,2043,29.59,690,672,1353
18.09.2019 03:00,1942,29.4,656,630,1286
18.09.2019 04:00,1960,29.53,584,602,1376
18.09.2019 05:00,1994,30.49,596,582,1398
18.09.2019 06:00,2167,33.11,573,560,1594
18.09.2019 07:00,2522,36.84,548,538,1974
18.09.2019 08:00,2881,49.95,529,503,2352
18.09.2019 09:00,3056,51.22,464,456,2592
18.09.2019 10:00,3075,46.36,418,418,2657
18.09.2019 11:00,2985,36.9,391,423,2594
18.09.2019 12:00,2923,36.58,393,461,2530
18.09.2019 13:00,2822,36.45,498,512,2324
18.09.2019 14:00,2745,36.26,561,564,2184
18.09.2019 15:00,2688,35.99,578,597,2110
18.09.2019 16:00,2632,35.98,592,608,2040
18.09.2019 17:00,2631,35.89,597,596,2034
18.09.2019 18:00,2766,37.91,546,555,2220
18.09.2019 19:00,2810,47.13,532,502,2278
18.09.2019 20:00,2847,51.02,497,473,2350
18.09.2019 21:00,2768,51.89,491,461,2277
18.09.2019 22:00,2580,46.92,499,450,2081
18.09.2019 23:00,2363,35.89,495,430,1868
19.09.2019 00:00,2163,34.91,475,408,1688
19.09.2019 01:00,2103,33.34,465,442,1638
19.09.2019 02:00,2059,31.15,440,433,1619
19.09.2019 03:00,2042,30.78,435,429,1607
19.09.2019 04:00,2041,30.36,427,431,1614
19.09.2019 05:00,2085,31.43,451,434,1634
19.09.2019 06:00,2278,34.5,440,434,1838
19.09.2019 07:00,2624,47.57,423,424,2201
19.09.2019 08:00,2899,51.79,390,398,2509
19.09.2019 09:00,3025,54,351,342,2674
19.09.2019 10:00,3036,52,296,293,2740
19.09.2019 11:00,2971,50.19,276,279,2695
19.09.2019 12:00,2872,44.3,278,302,2594
19.09.2019 13:00,2770,37.81,318,345,2452
19.09.2019 14:00,2795,36.31,361,391,2434
19.09.2019 15:00,2741,36,387,418,2354
19.09.2019 16:00,2708,36.41,368,425,2340
19.09.2019 17:00,2691,37.95,371,412,2320
19.09.2019 18:00,2769,50,344,378,2425
19.09.2019 19:00,2777,52.2,315,342,2462
19.09.2019 20:00,2862,69.75,297,320,2565
19.09.2019 21:00,2799,50.21,275,299,2524
19.09.2019 22:00,2651,48.05,241,271,2410
19.09.2019 23:00,2471,41.3,188,245,2283
20.09.2019 00:00,2307,35.82,169,229,2138
20.09.2019 01:00,2219,35.74,145,160,2074
20.09.2019 02:00,2175,35.52,144,158,2031
20.09.2019 03:00,2175,35.04,156,160,2019
20.09.2019 04:00,2175,35.4,164,164,2011
20.09.2019 05:00,2232,35.71,172,166,2060
20.09.2019 06:00,2333,36.36,177,163,2156
20.09.2019 07:00,2648,48.77,196,164,2452
20.09.2019 08:00,2924,53.47,203,169,2721
20.09.2019 09:00,3009,60.73,195,167,2814
20.09.2019 10:00,3058,52.09,214,174,2844
20.09.2019 11:00,3112,49.48,252,197,2860
20.09.2019 12:00,3058,42.85,280,221,2778
20.09.2019 13:00,2958,37.02,325,256,2633
20.09.2019 14:00,2819,35.48,366,296,2453
20.09.2019 15:00,2679,34.67,404,332,2275
20.09.2019 16:00,2597,34.64,416,365,2181
20.09.2019 17:00,2650,35.64,441,387,2209
20.09.2019 18:00,2752,45.02,408,386,2344
20.09.2019 19:00,2726,51.69,388,374,2338
20.09.2019 20:00,2703,55.57,384,386,2319
20.09.2019 21:00,2543,50,406,398,2137
20.09.2019 22:00,2344,43.02,432,404,1912
20.09.2019 23:00,2235,34.56,401,407,1834
21.09.2019 00:00,2099,32.13,388,404,1711
21.09.2019 01:00,1971,33.07,357,370,1614
21.09.2019 02:00,1896,30.01,336,349,1560
21.09.2019 03:00,1899,29.45,326,327,1573
21.09.2019 04:00,1872,30.09,299,305,1573
21.09.2019 05:00,1869,31.97,279,283,1590
21.09.2019 06:00,1861,32.96,260,258,1601
21.09.2019 07:00,1937,33.54,246,236,1691
21.09.2019 08:00,2043,34.29,228,215,1815
21.09.2019 09:00,2228,42.36,191,184,2037
21.09.2019 10:00,2345,34.98,151,163,2194
21.09.2019 11:00,2360,33.25,130,150,2230
21.09.2019 12:00,2333,33.07,117,151,2216
21.09.2019 13:00,2297,32.97,105,156,2192
21.09.2019 14:00,2236,32.54,97,158,2139
21.09.2019 15:00,2193,32.42,91,154,2102
21.09.2019 16:00,2138,32.52,86,145,2052
21.09.2019 17:00,2172,33.02,79,137,2093
21.09.2019 18:00,2292,35.07,88,139,2204
21.09.2019 19:00,2367,48.8,126,160,2241
21.09.2019 20:00,2429,48.8,178,203,2251
21.09.2019 21:00,2408,44.54,209,232,2199
21.09.2019 22:00,2225,34.45,214,241,2011
21.09.2019 23:00,2098,33.1,198,238,1900
22.09.2019 00:00,1999,30.56,179,226,1820
22.09.2019 01:00,1897,30.38,159,177,1738
22.09.2019 02:00,1909,29.38,153,167,1756
22.09.2019 03:00,1928,29.16,148,159,1780
22.09.2019 04:00,1916,29.24,145,156,1771
22.09.2019 05:00,1926,29.87,138,151,1788
22.09.2019 06:00,1910,29.72,123,129,1787
22.09.2019 07:00,1861,29.42,107,106,1754
22.09.2019 08:00,1865,30.86,88,86,1777
22.09.2019 09:00,2027,33.29,63,65,1964
22.09.2019 10:00,2217,34.47,60,55,2157
22.09.2019 11:00,2285,34.92,52,54,2233
22.09.2019 12:00,2252,34.99,46,65,2206
22.09.2019 13:00,2193,34.67,52,88,2141
22.09.2019 14:00,2141,34.39,79,115,2062
22.09.2019 15:00,2077,34.19,103,148,1974
22.09.2019 16:00,2029,34.16,133,186,1896
22.09.2019 17:00,2096,34.28,193,236,1903
22.09.2019 18:00,2271,34.99,265,301,2006
22.09.2019 19:00,2345,38.08,354,397,1991
22.09.2019 20:00,2368,39.99,487,538,1881
22.09.2019 21:00,2193,35.75,653,648,1540
22.09.2019 22:00,2084,34.44,790,715,1294
22.09.2019 23:00,2026,33.4,869,761,1157
23.09.2019 00:00,1940,31.99,873,778,1067
23.09.2019 01:00,1845,28.51,857,808,988
23.09.2019 02:00,1773,27.2,836,795,937
23.09.2019 03:00,1752,27.38,808,772,944
23.09.2019 04:00,1787,27.31,785,754,1002
23.09.2019 05:00,1831,27.6,773,744,1058
23.09.2019 06:00,2047,32.08,761,735,1286
23.09.2019 07:00,2474,38.2,733,726,1741
23.09.2019 08:00,2792,47.81,721,723,2071
23.09.2019 09:00,2818,48.8,714,724,2104
23.09.2019 10:00,2881,48.78,793,767,2088
23.09.2019 11:00,2810,48.79,795,804,2015
23.09.2019 12:00,2803,49.27,803,798,2000
23.09.2019 13:00,2739,45.48,792,773,1947
23.09.2019 14:00,2698,43.37,753,739,1945
23.09.2019 15:00,2660,40.13,711,703,1949
23.09.2019 16:00,2659,40.59,675,671,1984
23.09.2019 17:00,2592,41.7,649,629,1943
23.09.2019 18:00,2646,52.67,615,585,2031
23.09.2019 19:00,2704,54.24,582,546,2122
23.09.2019 20:00,2799,63.42,548,525,2251
23.09.2019 21:00,2713,51.83,501,502,2212
23.09.2019 22:00,2619,46.37,449,477,2170
23.09.2019 23:00,2406,41.82,407,452,1999
24.09.2019 00:00,2248,35.05,365,433,1883
24.09.2019 01:00,2190,36.29,350,415,1840
24.09.2019 02:00,2079,35.44,337,401,1742
24.09.2019 03:00,2050,35.24,323,383,1727
24.09.2019 04:00,2078,35.43,318,366,1760
24.09.2019 05:00,2127,35.46,317,352,1810
24.09.2019 06:00,2259,36.34,316,351,1943
24.09.2019 07:00,2640,54.64,312,352,2328
24.09.2019 08:00,2898,65.17,303,350,2595
24.09.2019 09:00,2955,65.19,290,332,2665
24.09.2019 10:00,2921,53.04,297,320,2624
24.09.2019 11:00,2915,52.95,289,321,2626
24.09.2019 12:00,2904,50.9,289,317,2615
24.09.2019 13:00,2892,49.15,269,307,2623
24.09.2019 14:00,2836,46.99,264,299,2572
24.09.2019 15:00,2830,45.74,248,295,2582
24.09.2019 16:00,2834,46.82,233,291,2601
24.09.2019 17:00,2796,49.77,214,281,2582
24.09.2019 18:00,2850,54.96,238,263,2612
24.09.2019 19:00,2838,60.2,227,255,2611
24.09.2019 20:00,2907,54.19,227,256,2680
24.09.2019 21:00,2832,51.18,238,256,2594
24.09.2019 22:00,2668,45.3,231,257,2437
24.09.2019 23:00,2459,36.68,210,259,2249
25.09.2019 00:00,2262,34.72,208,258,2054
25.09.2019 01:00,2084,35.16,180,205,1904
25.09.2019 02:00,2023,33.99,188,204,1835
25.09.2019 03:00,1988,33.81,195,205,1793
25.09.2019 04:00,1992,34.25,199,206,1793
25.09.2019 05:00,2013,34.98,209,209,1804
25.09.2019 06:00,2199,36.41,222,222,1977
25.09.2019 07:00,2548,38.13,238,240,2310
25.09.2019 08:00,2853,55.6,253,258,2600
25.09.2019 09:00,2926,60.59,263,270,2663
25.09.2019 10:00,2936,55.28,277,291,2659
25.09.2019 11:00,3008,50.43,297,320,2711
25.09.2019 12:00,3038,49.76,321,340,2717
25.09.2019 13:00,2994,48.61,341,349,2653
25.09.2019 14:00,2960,49.03,348,354,2612
25.09.2019 15:00,2910,48.82,369,356,2541
25.09.2019 16:00,2895,40.05,371,358,2524
25.09.2019 17:00,2808,36.73,381,354,2427
25.09.2019 18:00,2794,37.09,398,356,2396
25.09.2019 19:00,2799,37,422,373,2377
25.09.2019 20:00,2860,37.32,428,393,2432
25.09.2019 21:00,2735,36.71,417,401,2318
25.09.2019 22:00,2580,35.99,412,403,2168
25.09.2019 23:00,2356,35.21,414,402,1942
26.09.2019 00:00,2224,34.67,420,395,1804
26.09.2019 01:00,2130,34.18,415,438,1715
26.09.2019 02:00,2036,32.92,403,435,1633
26.09.2019 03:00,2025,31.94,392,429,1633
26.09.2019 04:00,2036,32.33,379,421,1657
26.09.2019 05:00,2007,32.91,375,414,1632
26.09.2019 06:00,2157,34.9,370,408,1787
26.09.2019 07:00,2528,35.97,363,404,2165
26.09.2019 08:00,2864,49.08,352,398,2512
26.09.2019 09:00,2963,50.27,334,390,2629
26.09.2019 10:00,2995,38.54,344,405,2651
26.09.2019 11:00,2968,37.53,357,420,2611
26.09.2019 12:00,2885,37.7,366,417,2519
26.09.2019 13:00,2825,37.3,358,403,2467
26.09.2019 14:00,2864,37.11,348,384,2516
26.09.2019 15:00,2804,36.8,331,365,2473
26.09.2019 16:00,2783,36.47,310,350,2473
26.09.2019 17:00,2735,36.54,306,332,2429
26.09.2019 18:00,2718,37.63,309,324,2409
26.09.2019 19:00,2755,37.49,340,345,2415
26.09.2019 20:00,2822,38.35,377,381,2445
26.09.2019 21:00,2731,36.59,408,416,2323
26.09.2019 22:00,2550,35.25,443,440,2107
26.09.2019 23:00,2319,33.11,464,462,1855
27.09.2019 00:00,2155,31.24,494,477,1661
27.09.2019 01:00,2082,31.01,512,515,1570
27.09.2019 02:00,2046,30.36,521,530,1525
27.09.2019 03:00,2017,29.78,545,550,1472
27.09.2019 04:00,2024,30.61,574,578,1450
27.09.2019 05:00,2092,31.28,578,607,1514
27.09.2019 06:00,2215,31.96,608,627,1607
27.09.2019 07:00,2579,34.94,627,639,1952
27.09.2019 08:00,2887,47.21,663,640,2224
27.09.2019 09:00,2989,49.1,646,604,2343
27.09.2019 10:00,2965,50.08,638,559,2327
27.09.2019 11:00,2943,46.14,643,519,2300
27.09.2019 12:00,2965,44.14,664,469,2301
27.09.2019 13:00,2932,37.88,586,417,2346
27.09.2019 14:00,2853,35.72,496,366,2357
27.09.2019 15:00,2799,34.46,439,329,2360
27.09.2019 16:00,2695,33.94,364,296,2331
27.09.2019 17:00,2538,35.91,303,266,2235
27.09.2019 18:00,2552,43.73,269,242,2283
27.09.2019 19:00,2595,45.43,247,223,2348
27.09.2019 20:00,2641,47.2,232,210,2409
27.09.2019 21:00,2471,46.35,218,189,2253
27.09.2019 22:00,2344,34.3,181,161,2163
27.09.2019 23:00,2235,33.18,164,138,2071
28.09.2019 00:00,2084,31.06,153,122,1931
28.09.2019 01:00,1978,31.55,135,128,1843
28.09.2019 02:00,1916,31.22,112,109,1804
28.09.2019 03:00,1887,29.85,107,114,1780
28.09.2019 04:00,1851,28.79,122,134,1729
28.09.2019 05:00,1878,28.86,143,158,1735
28.09.2019 06:00,1925,30.45,169,185,1756
28.09.2019 07:00,1995,29.77,192,212,1803
28.09.2019 08:00,2046,30.01,220,239,1826
28.09.2019 09:00,2259,32.92,233,262,2026
28.09.2019 10:00,2350,33.36,253,293,2097
28.09.2019 11:00,2401,32.1,271,334,2130
28.09.2019 12:00,2359,31.68,286,373,2073
28.09.2019 13:00,2304,31.43,284,403,2020
28.09.2019 14:00,2283,31.25,308,432,1975
28.09.2019 15:00,2234,31.09,320,456,1914
28.09.2019 16:00,2237,31.05,355,470,1882
28.09.2019 17:00,2313,31.36,356,473,1957
28.09.2019 18:00,2429,32.28,297,454,2132
28.09.2019 19:00,2533,33.61,325,439,2208
28.09.2019 20:00,2573,33.91,398,449,2175
28.09.2019 21:00,2369,32.91,453,485,1916
28.09.2019 22:00,2175,30.5,528,537,1647
28.09.2019 23:00,2037,29.7,580,591,1457
29.09.2019 00:00,1948,29.85,628,629,1320
29.09.2019 01:00,1858,30.73,634,636,1224
29.09.2019 02:00,1795,30.09,665,658,1130
29.09.2019 03:00,1709,28.59,696,670,1013
29.09.2019 04:00,1755,27.44,696,674,1059
29.09.2019 05:00,1765,27.72,698,677,1067
29.09.2019 06:00,1856,28.36,664,678,1192
29.09.2019 07:00,1963,28.85,661,678,1302
29.09.2019 08:00,1945,29.53,643,684,1302
29.09.2019 09:00,2037,30.36,649,684,1388
29.09.2019 10:00,2166,31.5,637,684,1529
29.09.2019 11:00,2271,32.01,603,676,1668
29.09.2019 12:00,2279,31.9,582,660,1697
29.09.2019 13:00,2297,31.8,575,642,1722
29.09.2019 14:00,2287,31.63,565,623,1722
29.09.2019 15:00,2249,31.65,538,573,1711
29.09.2019 16:00,2259,31.55,472,502,1787
29.09.2019 17:00,2366,31.72,425,426,1941
29.09.2019 18:00,2435,32.44,365,357,2070
29.09.2019 19:00,2500,33.45,296,299,2204
29.09.2019 20:00,2552,34.13,248,253,2304
29.09.2019 21:00,2469,33.83,206,216,2263
29.09.2019 22:00,2337,32.91,162,180,2175
29.09.2019 23:00,2176,31.94,115,147,2061
30.09.2019 00:00,2020,29.7,82,117,1938
30.09.2019 01:00,1915,28.76,48,50,1867
30.09.2019 02:00,1870,27.32,33,33,1837
30.09.2019 03:00,1880,26.83,26,26,1854
30.09.2019 04:00,1896,27.13,27,29,1869
30.09.2019 05:00,1932,27.97,28,40,1904
30.09.2019 06:00,2108,31.21,38,59,2070
30.09.2019 07:00,2541,33.41,52,84,2489
30.09.2019 08:00,2846,45.33,71,125,2775
30.09.2019 09:00,2966,40.33,105,161,2861
30.09.2019 10:00,2972,34.16,167,216,2805
30.09.2019 11:00,3054,34.33,229,310,2825
30.09.2019 12:00,3035,33.83,352,458,2683
30.09.2019 13:00,2932,33.81,531,658,2401
30.09.2019 14:00,2848,33.73,689,856,2159
30.09.2019 15:00,2824,33.57,870,1008,1954
30.09.2019 16:00,2773,33.28,1029,1102,1744
30.09.2019 17:00,2828,33.49,1142,1173,1686
30.09.2019 18:00,2909,34.52,1219,1218,1690
30.09.2019 19:00,2865,34.83,1271,1233,1594
30.09.2019 20:00,2962,35.13,1284,1224,1678
30.09.2019 21:00,2850,35.03,1264,1186,1586
30.09.2019 22:00,2798,34.38,1218,1130,1580
30.09.2019 23:00,2622,33.67,1163,1072,1459
10.01.2019 00:00,2509,32.2,1106,1037,1403
10.01.2019 01:00,2337,32.08,1079,1131,1258
10.01.2019 02:00,2297,31.26,1031,1073,1266
10.01.2019 03:00,2242,30.04,1023,1040,1219
10.01.2019 04:00,2211,30.2,1004,1018,1207
10.01.2019 05:00,2257,30.13,983,988,1274
10.01.2019 06:00,2398,33.01,916,934,1482
10.01.2019 07:00,2776,47.47,850,864,1926
10.01.2019 08:00,3031,50.98,788,794,2243
10.01.2019 09:00,3138,51.05,705,734,2433
10.01.2019 10:00,3175,49.63,663,716,2512
10.01.2019 11:00,3141,46.86,655,711,2486
10.01.2019 12:00,3086,44.92,629,683,2457
10.01.2019 13:00,3043,42.17,593,635,2450
10.01.2019 14:00,3039,41.04,543,578,2496
10.01.2019 15:00,3039,43.03,512,526,2527
10.01.2019 16:00,2995,43.02,467,475,2528
10.01.2019 17:00,3006,42.88,426,421,2580
10.01.2019 18:00,3012,50.08,389,382,2623
10.01.2019 19:00,3007,54.19,373,371,2634
10.01.2019 20:00,3038,54.99,394,395,2644
10.01.2019 21:00,2812,52.92,445,429,2367
10.01.2019 22:00,2592,49.01,504,465,2088
10.01.2019 23:00,2452,43.74,532,499,1920
10.02.2019 00:00,2275,32.85,556,521,1719
10.02.2019 01:00,2186,32.49,572,553,1614
10.02.2019 02:00,2134,31,575,569,1559
10.02.2019 03:00,2101,30.94,582,577,1519
10.02.2019 04:00,2094,31.32,587,580,1507
10.02.2019 05:00,2104,32.2,583,580,1521
10.02.2019 06:00,2297,33.8,560,569,1737
10.02.2019 07:00,2716,48.61,553,549,2163
10.02.2019 08:00,3013,52.79,531,523,2482
10.02.2019 09:00,3101,52.63,478,470,2623
10.02.2019 10:00,3140,51.75,414,439,2726
10.02.2019 11:00,3098,50,350,444,2748
10.02.2019 12:00,3050,48.04,333,456,2717
10.02.2019 13:00,2996,41.4,327,454,2669
10.02.2019 14:00,2894,36.58,299,444,2595
10.02.2019 15:00,2855,35.22,292,426,2563
10.02.2019 16:00,2800,34.92,276,394,2524
10.02.2019 17:00,2743,35.17,237,351,2506
10.02.2019 18:00,2875,40.49,181,303,2694
10.02.2019 19:00,2895,48.01,187,265,2708
10.02.2019 20:00,3025,51.61,169,253,2856
10.02.2019 21:00,2896,48.47,193,253,2703
10.02.2019 22:00,2717,40.21,203,257,2514
10.02.2019 23:00,2549,34.69,231,275,2318
10.03.2019 00:00,2289,32.98,242,308,2047
10.03.2019 01:00,2173,33.35,260,308,1913
10.03.2019 02:00,2152,32.29,309,348,1843
10.03.2019 03:00,2150,30.06,344,387,1806
10.03.2019 04:00,2154,30.06,372,426,1782
10.03.2019 05:00,2230,32.93,426,474,1804
10.03.2019 06:00,2389,33.94,484,513,1905
10.03.2019 07:00,2739,35.7,518,534,2221
10.03.2019 08:00,3124,42.98,531,542,2593
10.03.2019 09:00,3267,49.92,500,513,2767
10.03.2019 10:00,3270,47.89,464,508,2806
10.03.2019 11:00,3227,46.8,402,504,2825
10.03.2019 12:00,3226,47.61,361,475,2865
10.03.2019 13:00,3182,42.93,326,437,2856
10.03.2019 14:00,3142,37.82,305,404,2837
10.03.2019 15:00,3120,36.74,283,381,2837
10.03.2019 16:00,3125,36.86,288,365,2837
10.03.2019 17:00,3064,40.4,251,335,2813
10.03.2019 18:00,3055,54.83,218,298,2837
10.03.2019 19:00,3078,58.83,198,265,2880
10.03.2019 20:00,3106,66.33,193,247,2913
10.03.2019 21:00,2978,53.53,191,238,2787
10.03.2019 22:00,2802,48.06,192,233,2610
10.03.2019 23:00,2658,45.59,179,232,2479
10.04.2019 00:00,2472,35.93,186,234,2286
10.04.2019 01:00,2322,37.49,164,173,2158
10.04.2019 02:00,2263,34.96,173,186,2090
10.04.2019 03:00,2259,34.18,181,194,2078
10.04.2019 04:00,2278,33.78,187,202,2091
10.04.2019 05:00,2343,34.71,192,213,2151
10.04.2019 06:00,2481,35.66,207,225,2274
10.04.2019 07:00,2890,43.33,227,234,2663
10.04.2019 08:00,3202,48.77,253,246,2949
10.04.2019 09:00,3284,61.71,238,236,3046
10.04.2019 10:00,3305,67.4,219,220,3086
10.04.2019 11:00,3298,66.72,202,211,3096
10.04.2019 12:00,3231,66.7,193,206,3038
10.04.2019 13:00,3057,57.06,220,207,2837
10.04.2019 14:00,2974,47.78,209,211,2765
10.04.2019 15:00,2947,45.35,220,222,2727
10.04.2019 16:00,2865,47.93,253,239,2612
10.04.2019 17:00,2806,49.49,299,259,2507
10.04.2019 18:00,2876,50.05,328,274,2548
10.04.2019 19:00,2972,50.27,362,294,2610
10.04.2019 20:00,2970,53.52,390,331,2580
10.04.2019 21:00,2787,49.22,425,367,2362
10.04.2019 22:00,2626,40.5,465,402,2161
10.04.2019 23:00,2486,35.87,529,442,1957
10.05.2019 00:00,2371,34.35,554,475,1817
10.05.2019 01:00,2352,34.85,573,558,1779
10.05.2019 02:00,2298,34.32,574,578,1724
10.05.2019 03:00,2227,33.21,596,597,1631
10.05.2019 04:00,2227,32.35,612,606,1615
10.05.2019 05:00,2238,32.21,607,614,1631
10.05.2019 06:00,2294,32.92,608,608,1686
10.05.2019 07:00,2371,33.92,627,592,1744
10.05.2019 08:00,2451,34.49,598,568,1853
10.05.2019 09:00,2682,35.74,549,510,2133
10.05.2019 10:00,2855,42.95,486,462,2369
10.05.2019 11:00,2861,39.96,424,426,2437
10.05.2019 12:00,2767,37.7,369,390,2398
10.05.2019 13:00,2721,37.18,332,349,2389
10.05.2019 14:00,2650,36.51,300,312,2350
10.05.2019 15:00,2564,35.93,259,283,2305
10.05.2019 16:00,2516,36.27,229,250,2287
10.05.2019 17:00,2590,38.05,203,218,2387
10.05.2019 18:00,2688,43.59,182,194,2506
10.05.2019 19:00,2785,48.11,184,185,2601
10.05.2019 20:00,2815,52.09,188,193,2627
10.05.2019 21:00,2724,49.75,204,195,2520
10.05.2019 22:00,2607,41,217,192,2390
10.05.2019 23:00,2496,40,243,189,2253
10.06.2019 00:00,2348,35.9,248,189,2100
10.06.2019 01:00,2252,35.35,234,214,2018
10.06.2019 02:00,2206,34.64,214,196,1992
10.06.2019 03:00,2230,34.03,216,184,2014
10.06.2019 04:00,2239,33.58,208,179,2031
10.06.2019 05:00,2299,33.61,201,178,2098
10.06.2019 06:00,2386,33.85,207,186,2179
10.06.2019 07:00,2475,34.02,209,195,2266
10.06.2019 08:00,2522,34.28,209,198,2313
10.06.2019 09:00,2601,35.03,187,175,2414
10.06.2019 10:00,2731,35.85,150,144,2581
10.06.2019 11:00,2771,36.55,126,126,2645
10.06.2019 12:00,2668,36.52,106,116,2562
10.06.2019 13:00,2624,36.08,84,106,2540
10.06.2019 14:00,2602,35.69,74,95,2528
10.06.2019 15:00,2581,35.43,61,89,2520
10.06.2019 16:00,2577,35.47,62,85,2515
10.06.2019 17:00,2615,35.74,68,88,2547
10.06.2019 18:00,2751,36.64,85,92,2666
10.06.2019 19:00,2855,46.94,106,102,2749
10.06.2019 20:00,2967,52.19,128,127,2839
10.06.2019 21:00,2866,38.41,139,145,2727
10.06.2019 22:00,2731,36.09,147,156,2584
10.06.2019 23:00,2620,35.36,167,160,2453
10.07.2019 00:00,2558,34.39,166,156,2392
10.07.2019 01:00,2513,33.39,153,154,2360
10.07.2019 02:00,2466,33.28,158,156,2308
10.07.2019 03:00,2472,33.22,162,162,2310
10.07.2019 04:00,2479,33.34,162,164,2317
10.07.2019 05:00,2603,34.19,152,168,2451
10.07.2019 06:00,2814,36.16,160,172,2654
10.07.2019 07:00,3290,57.69,165,179,3125
10.07.2019 08:00,3656,71.01,165,183,3491
10.07.2019 09:00,3696,71.07,145,162,3551
10.07.2019 10:00,3586,71.02,108,133,3478
10.07.2019 11:00,3464,70.73,80,116,3384
10.07.2019 12:00,3325,70.41,75,115,3250
10.07.2019 13:00,3217,69.94,80,123,3137
10.07.2019 14:00,3149,68.3,82,127,3067
10.07.2019 15:00,3140,64.9,70,119,3070
10.07.2019 16:00,3103,64.18,58,103,3045
10.07.2019 17:00,3018,64.83,56,90,2962
10.07.2019 18:00,3063,67.77,73,80,2990
10.07.2019 19:00,3267,72.42,84,75,3183
10.07.2019 20:00,3349,75.28,91,74,3258
10.07.2019 21:00,3253,69.26,78,67,3175
10.07.2019 22:00,3100,56.77,57,59,3043
10.07.2019 23:00,2904,51.84,41,52,2863
10.08.2019 00:00,2773,35.81,42,58,2731
10.08.2019 01:00,2602,35.68,58,63,2544
10.08.2019 02:00,2534,34.91,90,103,2444
10.08.2019 03:00,2466,34.35,130,136,2336
10.08.2019 04:00,2442,34.03,164,164,2278
10.08.2019 05:00,2484,34.41,207,201,2277
10.08.2019 06:00,2662,36.1,241,260,2421
10.08.2019 07:00,3036,61.2,298,336,2738
10.08.2019 08:00,3080,60.18,370,415,2710
10.08.2019 09:00,3377,65.58,434,462,2943
10.08.2019 10:00,3420,65.78,505,512,2915
10.08.2019 11:00,3446,56.77,548,567,2898
10.08.2019 12:00,3457,57.26,558,595,2899
10.08.2019 13:00,3416,57.29,550,592,2866
10.08.2019 14:00,3443,60.05,515,573,2928
10.08.2019 15:00,3386,60.19,481,543,2905
10.08.2019 16:00,3262,58.47,457,509,2805
10.08.2019 17:00,3175,56.25,364,476,2811
10.08.2019 18:00,3238,56.18,358,451,2880
10.08.2019 19:00,3249,60.98,343,420,2906
10.08.2019 20:00,3208,57.28,362,411,2846
10.08.2019 21:00,3057,55.71,382,421,2675
10.08.2019 22:00,2819,35.93,446,449,2373
10.08.2019 23:00,2627,34.9,468,469,2159
10.09.2019 00:00,2425,33.62,433,478,1992
10.09.2019 01:00,2352,34.17,408,395,1944
10.09.2019 02:00,2230,34.07,409,385,1821
10.09.2019 03:00,2181,33.87,433,392,1748
10.09.2019 04:00,2206,33.87,452,413,1754
10.09.2019 05:00,2266,34.06,433,430,1833
10.09.2019 06:00,2478,35.05,433,425,2045
10.09.2019 07:00,2898,55.41,446,414,2452
10.09.2019 08:00,3073,57.94,453,408,2620
10.09.2019 09:00,3065,60.3,408,391,2657
10.09.2019 10:00,3095,62.4,361,379,2734
10.09.2019 11:00,3070,59.54,364,379,2706
10.09.2019 12:00,3005,60.47,323,383,2682
10.09.2019 13:00,2993,61.09,324,387,2669
10.09.2019 14:00,2958,61.39,325,400,2633
10.09.2019 15:00,3003,53.25,345,420,2658
10.09.2019 16:00,2966,57.83,360,431,2606
10.09.2019 17:00,2935,57.8,376,446,2559
10.09.2019 18:00,2990,61.39,384,450,2606
10.09.2019 19:00,3106,67.66,399,452,2707
10.09.2019 20:00,3084,64.7,403,444,2681
10.09.2019 21:00,2986,56.49,383,419,2603
10.09.2019 22:00,2841,46.08,357,378,2484
10.09.2019 23:00,2667,35.41,320,340,2347
10.10.2019 00:00,2434,34.1,298,318,2136
10.10.2019 01:00,2250,33.49,264,257,1986
10.10.2019 02:00,2207,33.14,229,235,1978
10.10.2019 03:00,2178,32.98,217,213,1961
10.10.2019 04:00,2145,32.96,208,198,1937
10.10.2019 05:00,2177,33.44,191,188,1986
10.10.2019 06:00,2367,34.49,195,189,2172
10.10.2019 07:00,2706,55.02,200,197,2506
10.10.2019 08:00,3019,57.14,207,205,2812
10.10.2019 09:00,3108,60.07,219,209,2889
10.10.2019 10:00,3127,60.07,235,225,2892
10.10.2019 11:00,3133,59.61,241,255,2892
10.10.2019 12:00,3145,59.38,265,296,2880
10.10.2019 13:00,3050,57.69,289,339,2761
10.10.2019 14:00,2952,44.73,313,380,2639
10.10.2019 15:00,2878,35.27,372,418,2506
10.10.2019 16:00,2844,35.21,437,448,2407
10.10.2019 17:00,2818,35.22,478,468,2340
10.10.2019 18:00,2897,43.35,521,494,2376
10.10.2019 19:00,2925,60.53,567,527,2358
10.10.2019 20:00,2943,56.94,593,570,2350
10.10.2019 21:00,2818,41.78,668,628,2150
10.10.2019 22:00,2653,34.95,722,692,1931
10.10.2019 23:00,2450,33.91,761,746,1689
10.11.2019 00:00,2243,32.6,797,776,1446
10.11.2019 01:00,2175,32.05,822,789,1353
10.11.2019 02:00,2128,28.89,805,781,1323
10.11.2019 03:00,2140,24.23,779,771,1361
10.11.2019 04:00,2150,25.3,752,756,1398
10.11.2019 05:00,2134,32.27,747,742,1387
10.11.2019 06:00,2258,32.92,741,744,1517
10.11.2019 07:00,2648,34.01,814,757,1834
10.11.2019 08:00,2950,38.69,873,787,2077
10.11.2019 09:00,2998,40.84,925,846,2073
10.11.2019 10:00,3088,37.42,981,929,2107
10.11.2019 11:00,3156,35.1,1050,998,2106
10.11.2019 12:00,3186,34.98,1079,1049,2107
10.11.2019 13:00,3075,34.75,1043,1080,2032
10.11.2019 14:00,3105,34.42,1033,1099,2072
10.11.2019 15:00,3039,34.14,1024,1096,2015
10.11.2019 16:00,3020,33.85,1015,1072,2005
10.11.2019 17:00,2935,33.79,1029,1051,1906
10.11.2019 18:00,2822,34.19,1019,1030,1803
10.11.2019 19:00,2861,34.76,1009,1011,1852
10.11.2019 20:00,2893,34.92,1025,992,1868
10.11.2019 21:00,2785,34.26,1028,978,1757
10.11.2019 22:00,2706,33.61,1015,951,1691
10.11.2019 23:00,2783,32.81,1000,919,1783
10.12.2019 00:00,2552,27.55,942,907,1610
10.12.2019 01:00,2286,32.74,914,964,1372
10.12.2019 02:00,2003,32.65,891,952,1112
10.12.2019 03:00,1970,32.25,877,941,1093
10.12.2019 04:00,2004,30.91,854,903,1150
10.12.2019 05:00,2031,32.2,805,852,1226
10.12.2019 06:00,2039,32.58,771,807,1268
10.12.2019 07:00,2093,32.9,763,783,1330
10.12.2019 08:00,2169,33.25,737,782,1432
10.12.2019 09:00,2290,33.78,765,811,1525
10.12.2019 10:00,2425,34.6,847,866,1578
10.12.2019 11:00,2495,35.24,881,932,1614
10.12.2019 12:00,2510,34.97,948,995,1562
10.12.2019 13:00,2427,34.48,974,1048,1453
10.12.2019 14:00,2422,34.1,1009,1086,1413
10.12.2019 15:00,2421,33.68,1020,1091,1401
10.12.2019 16:00,2412,33.62,1040,1064,1372
10.12.2019 17:00,2423,33.91,1051,1023,1372
10.12.2019 18:00,2450,35.74,1033,964,1417
10.12.2019 19:00,2529,42.07,996,912,1533
10.12.2019 20:00,2494,44.65,982,874,1512
10.12.2019 21:00,2446,40.13,944,841,1502
10.12.2019 22:00,2327,34.57,892,803,1435
10.12.2019 23:00,2195,33.61,828,764,1367
13.10.2019 00:00,2029,32.58,768,726,1261
13.10.2019 01:00,2060,33.4,769,792,1291
13.10.2019 02:00,1974,33.38,707,729,1267
13.10.2019 03:00,1925,33.26,640,661,1285
13.10.2019 04:00,1944,33.29,588,598,1356
13.10.2019 05:00,1915,33.41,536,533,1379
13.10.2019 06:00,1979,33.83,471,464,1508
13.10.2019 07:00,2055,33.8,411,391,1644
13.10.2019 08:00,2170,34.31,338,324,1832
13.10.2019 09:00,2243,35.07,267,255,1976
13.10.2019 10:00,2400,35.8,204,194,2196
13.10.2019 11:00,2519,36.33,163,148,2356
13.10.2019 12:00,2573,36.32,127,117,2446
13.10.2019 13:00,2555,36.27,100,97,2455
13.10.2019 14:00,2499,35.9,82,85,2417
13.10.2019 15:00,2537,35.82,75,86,2462
13.10.2019 16:00,2552,35.8,90,95,2462
13.10.2019 17:00,2612,35.98,110,115,2502
13.10.2019 18:00,2718,36.94,158,156,2560
13.10.2019 19:00,2748,37.36,247,219,2501
13.10.2019 20:00,2649,37.4,354,298,2295
13.10.2019 21:00,2472,35.92,473,382,1999
13.10.2019 22:00,2373,35.48,568,464,1805
13.10.2019 23:00,2308,34.81,703,549,1605
14.10.2019 00:00,2148,33.8,810,634,1338
14.10.2019 01:00,2168,31.75,974,947,1194
14.10.2019 02:00,2147,28.96,990,1018,1157
14.10.2019 03:00,2170,28.18,1097,1100,1073
14.10.2019 04:00,2021,30.04,1204,1192,817
14.10.2019 05:00,2022,31.74,1255,1279,767
14.10.2019 06:00,2253,33.18,1310,1327,943
14.10.2019 07:00,2684,35.27,1352,1355,1332
14.10.2019 08:00,3005,39.02,1369,1374,1636
14.10.2019 09:00,3079,50.24,1372,1373,1707
14.10.2019 10:00,3037,49.6,1361,1362,1676
14.10.2019 11:00,3029,48.34,1331,1342,1698
14.10.2019 12:00,3013,48,1300,1295,1713
14.10.2019 13:00,2940,45.25,1223,1215,1717
14.10.2019 14:00,2920,43,1109,1093,1811
14.10.2019 15:00,2958,39.5,932,928,2026
14.10.2019 16:00,2943,43.23,699,722,2244
14.10.2019 17:00,2963,55.98,508,510,2455
14.10.2019 18:00,2954,60.06,296,329,2658
14.10.2019 19:00,3051,70.91,174,204,2877
14.10.2019 20:00,3045,70.92,118,132,2927
14.10.2019 21:00,2906,53.04,95,103,2811
14.10.2019 22:00,2740,44.19,93,99,2647
14.10.2019 23:00,2545,36.6,119,113,2426
15.10.2019 00:00,2305,34.62,142,138,2163
15.10.2019 01:00,2194,34.41,173,181,2021
15.10.2019 02:00,2184,34.06,221,238,1963
15.10.2019 03:00,2096,33.86,328,311,1768
15.10.2019 04:00,2071,33.84,361,396,1710
15.10.2019 05:00,2172,34.13,478,493,1694
15.10.2019 06:00,2215,35.18,611,592,1604
15.10.2019 07:00,2664,40.61,676,676,1988
15.10.2019 08:00,3026,52.64,749,747,2277
15.10.2019 09:00,3003,55.21,771,778,2232
15.10.2019 10:00,2951,54.8,766,785,2185
15.10.2019 11:00,3006,51.76,769,785,2237
15.10.2019 12:00,2993,50.62,734,764,2259
15.10.2019 13:00,2907,47.9,643,724,2264
15.10.2019 14:00,3014,46.64,577,673,2437
15.10.2019 15:00,2973,44.58,522,625,2451
15.10.2019 16:00,2960,45.38,439,573,2521
15.10.2019 17:00,2889,47.96,413,532,2476
15.10.2019 18:00,2891,54.41,397,499,2494
15.10.2019 19:00,2991,58.56,394,473,2597
15.10.2019 20:00,2972,67.73,390,431,2582
15.10.2019 21:00,2825,55.29,280,376,2545
15.10.2019 22:00,2721,45.97,243,317,2478
15.10.2019 23:00,2494,38.52,183,266,2311
16.10.2019 00:00,2275,34.06,128,222,2147
16.10.2019 01:00,2178,34.81,79,90,2099
16.10.2019 02:00,2084,34.11,60,71,2024
16.10.2019 03:00,2064,33.97,55,62,2009
16.10.2019 04:00,2075,33.98,53,58,2022
16.10.2019 05:00,2085,34.43,56,59,2029
16.10.2019 06:00,2248,35.44,61,65,2187
16.10.2019 07:00,2629,44.6,67,70,2562
16.10.2019 08:00,2956,59.55,70,73,2886
16.10.2019 09:00,2980,63.46,65,65,2915
16.10.2019 10:00,2991,61.86,55,54,2936
16.10.2019 11:00,3036,59.56,52,48,2984
16.10.2019 12:00,3064,58.07,46,44,3018
16.10.2019 13:00,3131,56.61,43,47,3088
16.10.2019 14:00,3124,54.32,49,51,3075
16.10.2019 15:00,2836,52.02,50,72,2786
16.10.2019 16:00,2762,51.17,65,106,2697
16.10.2019 17:00,3011,44.84,95,154,2916
16.10.2019 18:00,3081,51.8,124,193,2957
16.10.2019 19:00,3113,56.99,164,243,2949
16.10.2019 20:00,3038,49.95,203,307,2835
16.10.2019 21:00,2886,45.01,227,349,2659
16.10.2019 22:00,2697,37.07,251,375,2446
16.10.2019 23:00,2477,35.44,251,397,2226
17.10.2019 00:00,2254,33.12,272,395,1982
17.10.2019 01:00,2091,33.85,263,237,1828
17.10.2019 02:00,2025,33.29,256,228,1769
17.10.2019 03:00,1980,32.85,216,197,1764
17.10.2019 04:00,1980,32.8,166,162,1814
17.10.2019 05:00,2048,33.59,131,127,1917
17.10.2019 06:00,2237,34.6,106,105,2131
17.10.2019 07:00,2669,40.5,96,101,2573
17.10.2019 08:00,2989,52.13,100,114,2889
17.10.2019 09:00,3035,55.76,107,129,2928
17.10.2019 10:00,3012,55.36,126,146,2886
17.10.2019 11:00,3040,53.24,143,168,2897
17.10.2019 12:00,3029,52.36,173,186,2856
17.10.2019 13:00,3001,49.9,188,200,2813
17.10.2019 14:00,3062,46.49,217,216,2845
17.10.2019 15:00,3036,46.45,217,215,2819
17.10.2019 16:00,3129,46.12,214,213,2915
17.10.2019 17:00,2953,55.79,202,210,2751
17.10.2019 18:00,2905,58.98,187,209,2718
17.10.2019 19:00,2954,65.15,182,217,2772
17.10.2019 20:00,2989,63.96,232,232,2757
17.10.2019 21:00,2800,54.41,187,239,2613
17.10.2019 22:00,2622,45.59,181,237,2441
17.10.2019 23:00,2421,39.34,175,223,2246
18.10.2019 00:00,2223,35.58,160,195,2063
18.10.2019 01:00,2153,35.81,137,141,2016
18.10.2019 02:00,2097,35.62,120,127,1977
18.10.2019 03:00,2062,35.43,98,106,1964
18.10.2019 04:00,2070,35.47,81,85,1989
18.10.2019 05:00,2123,35.71,69,76,2054
18.10.2019 06:00,2270,36.35,75,81,2195
18.10.2019 07:00,2628,38.2,108,102,2520
18.10.2019 08:00,2895,52.3,162,141,2733
18.10.2019 09:00,2938,65.14,215,174,2723
18.10.2019 10:00,2904,57.5,267,204,2637
18.10.2019 11:00,3003,62,286,234,2717
18.10.2019 12:00,2869,41.94,310,256,2559
18.10.2019 13:00,2851,38.31,305,281,2546
18.10.2019 14:00,2865,37.93,305,309,2560
18.10.2019 15:00,2810,37.54,314,326,2496
18.10.2019 16:00,2719,36.65,303,329,2416
18.10.2019 17:00,2648,36.64,302,334,2346
18.10.2019 18:00,2724,37.61,387,372,2337
18.10.2019 19:00,2788,39.51,478,436,2310
18.10.2019 20:00,2672,38.25,580,507,2092
18.10.2019 21:00,2438,35.82,687,586,1751
18.10.2019 22:00,2277,35.04,772,671,1505
18.10.2019 23:00,2244,34.56,875,752,1369
19.10.2019 00:00,2112,33.61,918,806,1194
19.10.2019 01:00,2031,35.03,926,909,1105
19.10.2019 02:00,1931,34.03,901,887,1030
19.10.2019 03:00,1851,32.01,879,852,972
19.10.2019 04:00,1850,31.18,855,816,995
19.10.2019 05:00,1899,31.31,841,788,1058
19.10.2019 06:00,1914,31.27,825,779,1089
19.10.2019 07:00,2007,33.49,843,783,1164
19.10.2019 08:00,2176,33.01,844,781,1332
19.10.2019 09:00,2290,33.76,825,741,1465
19.10.2019 10:00,2441,35.14,758,694,1683
19.10.2019 11:00,2538,36,701,650,1837
19.10.2019 12:00,2592,36.53,647,616,1945
19.10.2019 13:00,2624,35.2,589,583,2035
19.10.2019 14:00,2423,34.78,555,541,1868
19.10.2019 15:00,2261,34.6,499,485,1762
19.10.2019 16:00,2261,34.62,457,425,1804
19.10.2019 17:00,2391,35.68,426,383,1965
19.10.2019 18:00,2565,38.48,423,387,2142
19.10.2019 19:00,2687,44.08,427,413,2260
19.10.2019 20:00,2571,47.9,452,434,2119
19.10.2019 21:00,2475,39.17,470,447,2005
19.10.2019 22:00,2379,35.08,461,459,1918
19.10.2019 23:00,2232,35.05,483,469,1749
20.10.2019 00:00,2123,33.18,468,452,1655
20.10.2019 01:00,1975,29.99,394,373,1581
20.10.2019 02:00,1852,26.01,362,333,1490
20.10.2019 03:00,1832,27.01,324,290,1508
20.10.2019 04:00,1861,26.9,295,250,1566
20.10.2019 05:00,1873,26.51,262,216,1611
20.10.2019 06:00,1933,30.97,223,184,1710
20.10.2019 07:00,2025,27.69,174,156,1851
20.10.2019 08:00,2143,33.41,144,134,1999
20.10.2019 09:00,2233,34.57,115,108,2118
20.10.2019 10:00,2368,36.37,98,91,2270
20.10.2019 11:00,2434,37.47,99,87,2335
20.10.2019 12:00,2480,38.32,91,84,2389
20.10.2019 13:00,2497,37.9,79,80,2418
20.10.2019 14:00,2388,36.43,64,73,2324
20.10.2019 15:00,2334,36.33,51,66,2283
20.10.2019 16:00,2344,36.39,45,58,2299
20.10.2019 17:00,2400,36.92,38,52,2362
20.10.2019 18:00,2557,40.38,35,45,2522
20.10.2019 19:00,2684,48.75,33,41,2651
20.10.2019 20:00,2640,51.06,37,39,2603
20.10.2019 21:00,2507,47.1,40,41,2467
20.10.2019 22:00,2380,39.62,39,44,2341
20.10.2019 23:00,2258,38.07,46,47,2212
21.10.2019 00:00,2066,36.02,47,49,2019
21.10.2019 01:00,2006,32.9,38,38,1968
21.10.2019 02:00,1936,32.39,42,42,1894
21.10.2019 03:00,1976,32.72,49,49,1927
21.10.2019 04:00,1997,33.54,57,59,1940
21.10.2019 05:00,2032,35.69,69,71,1963
21.10.2019 06:00,2222,37.58,83,88,2139
21.10.2019 07:00,2654,39.24,94,102,2560
21.10.2019 08:00,3005,53.21,109,116,2896
21.10.2019 09:00,3094,53.72,99,117,2995
21.10.2019 10:00,3088,56.09,87,114,3001
21.10.2019 11:00,3102,51.56,77,115,3025
21.10.2019 12:00,3117,51.56,75,121,3042
21.10.2019 13:00,3044,45.57,67,130,2977
21.10.2019 14:00,3078,44.14,99,143,2979
21.10.2019 15:00,3023,45.21,96,158,2927
21.10.2019 16:00,3087,47.71,135,184,2952
21.10.2019 17:00,3016,50.03,122,211,2894
21.10.2019 18:00,3045,54.11,127,212,2918
21.10.2019 19:00,3121,59.45,135,216,2986
21.10.2019 20:00,3013,66.51,153,212,2860
21.10.2019 21:00,2865,52.2,157,201,2708
21.10.2019 22:00,2677,49.02,148,188,2529
21.10.2019 23:00,2526,43,129,178,2397
22.10.2019 00:00,2329,36.86,137,168,2192
22.10.2019 01:00,2143,38.84,151,170,1992
22.10.2019 02:00,2130,35.02,184,198,1946
22.10.2019 03:00,2139,33.81,222,241,1917
22.10.2019 04:00,2144,31.84,246,290,1898
22.10.2019 05:00,2185,33.69,256,339,1929
22.10.2019 06:00,2363,36.2,295,375,2068
22.10.2019 07:00,2718,46.99,326,405,2392
22.10.2019 08:00,3018,56.43,368,433,2650
22.10.2019 09:00,3075,61.3,415,460,2660
22.10.2019 10:00,3040,60,451,492,2589
22.10.2019 11:00,3030,55.49,480,538,2550
22.10.2019 12:00,2901,52.72,530,585,2371
22.10.2019 13:00,2944,46.35,635,621,2309
22.10.2019 14:00,2958,43.67,705,645,2253
22.10.2019 15:00,2884,43.99,689,655,2195
22.10.2019 16:00,2846,43.66,673,644,2173
22.10.2019 17:00,2864,46.24,670,628,2194
22.10.2019 18:00,2978,51.93,640,607,2338
22.10.2019 19:00,3050,60,642,604,2408
22.10.2019 20:00,2953,65.47,658,608,2295
22.10.2019 21:00,2764,52.95,682,616,2082
22.10.2019 22:00,2575,46.34,669,616,1906
22.10.2019 23:00,2407,41.16,699,612,1708
23.10.2019 00:00,2167,36.25,689,604,1478
23.10.2019 01:00,2139,34.76,698,675,1441
23.10.2019 02:00,2041,31.54,697,654,1344
23.10.2019 03:00,2007,30.61,672,623,1335
23.10.2019 04:00,2030,29.37,631,592,1399
23.10.2019 05:00,2058,30.39,596,555,1462
23.10.2019 06:00,2264,34.92,544,515,1720
23.10.2019 07:00,2689,40.7,496,483,2193
23.10.2019 08:00,3112,52.4,456,459,2656
23.10.2019 09:00,3143,59.77,437,440,2706
23.10.2019 10:00,3135,57.12,401,428,2734
23.10.2019 11:00,3193,54.11,402,429,2791
23.10.2019 12:00,3153,51.23,412,425,2741
23.10.2019 13:00,3068,44.48,386,404,2682
23.10.2019 14:00,3032,42.55,373,374,2659
23.10.2019 15:00,3050,41.94,354,335,2696
23.10.2019 16:00,3024,43.26,295,290,2729
23.10.2019 17:00,3004,47,231,244,2773
23.10.2019 18:00,3040,50.67,204,216,2836
23.10.2019 19:00,3049,53.49,193,216,2856
23.10.2019 20:00,2944,53.91,200,223,2744
23.10.2019 21:00,2824,44.81,227,229,2597
23.10.2019 22:00,2640,38.22,229,233,2411
23.10.2019 23:00,2485,37.34,226,238,2259
24.10.2019 00:00,2367,34.45,238,235,2129
24.10.2019 01:00,2252,34.23,226,217,2026
24.10.2019 02:00,2171,32.95,235,222,1936
24.10.2019 03:00,2131,32.19,250,242,1881
24.10.2019 04:00,2111,32.13,282,270,1829
24.10.2019 05:00,2188,32.92,296,301,1892
24.10.2019 06:00,2427,34.47,314,337,2113
24.10.2019 07:00,2835,37.97,353,380,2482
24.10.2019 08:00,3052,47.81,381,419,2671
24.10.2019 09:00,3097,52.81,423,441,2674
24.10.2019 10:00,3039,52.81,424,458,2615
24.10.2019 11:00,3045,49.85,457,477,2588
24.10.2019 12:00,3086,45.81,499,481,2587
24.10.2019 13:00,3032,42.88,489,471,2543
24.10.2019 14:00,3034,39.54,506,451,2528
24.10.2019 15:00,2937,38.41,449,435,2488
24.10.2019 16:00,3012,37.69,449,420,2563
24.10.2019 17:00,2966,38.07,427,416,2539
24.10.2019 18:00,3031,39.31,436,426,2595
24.10.2019 19:00,3178,42.51,430,441,2748
24.10.2019 20:00,3136,41.09,442,454,2694
24.10.2019 21:00,2941,36.85,457,451,2484
24.10.2019 22:00,2713,35.65,455,442,2258
24.10.2019 23:00,2484,34.57,468,429,2016
25.10.2019 00:00,2221,31.06,445,425,1776
25.10.2019 01:00,2115,30.68,475,475,1640
25.10.2019 02:00,2045,28.29,480,480,1565
25.10.2019 03:00,2082,25.2,500,529,1582
25.10.2019 04:00,2130,24.42,581,609,1549
25.10.2019 05:00,2130,26.07,673,713,1457
25.10.2019 06:00,2270,32.4,782,818,1488
25.10.2019 07:00,2625,35.98,934,932,1691
25.10.2019 08:00,3098,38.82,1015,1023,2083
25.10.2019 09:00,3244,39,1020,1048,2224
25.10.2019 10:00,3047,38.92,918,1059,2129
25.10.2019 11:00,3104,38.93,1007,1076,2097
25.10.2019 12:00,3009,38.49,978,1079,2031
25.10.2019 13:00,2901,35.65,1012,1063,1889
25.10.2019 14:00,2786,36.07,1068,1034,1718
25.10.2019 15:00,2686,34.78,1102,983,1584
25.10.2019 16:00,2692,35.33,1055,914,1637
25.10.2019 17:00,2790,36.03,984,834,1806
25.10.2019 18:00,2928,37.29,913,760,2015
25.10.2019 19:00,3012,38.27,822,699,2190
25.10.2019 20:00,2908,38.02,759,658,2149
25.10.2019 21:00,2784,34.58,680,636,2104
25.10.2019 22:00,2638,33.21,612,622,2026
25.10.2019 23:00,2478,30.35,560,616,1918
26.10.2019 00:00,2367,25.51,571,654,1796
26.10.2019 01:00,2196,23.54,671,706,1525
26.10.2019 02:00,2089,18.84,829,854,1260
26.10.2019 03:00,1980,19.89,1021,1043,959
26.10.2019 04:00,1968,15.78,1191,1215,777
26.10.2019 05:00,1997,8.55,1303,1317,694
26.10.2019 06:00,2045,15.84,1290,1369,755
26.10.2019 07:00,2150,14.62,1326,1398,824
26.10.2019 08:00,2304,24.61,1416,1418,888
26.10.2019 09:00,2411,29.36,1403,1413,1008
26.10.2019 10:00,2555,33.28,1396,1407,1159
26.10.2019 11:00,2610,34.15,1363,1388,1247
26.10.2019 12:00,2633,34.53,1330,1348,1303
26.10.2019 13:00,2593,34.46,1262,1280,1331
26.10.2019 14:00,2605,34.52,1161,1189,1444
26.10.2019 15:00,2636,34.59,1058,1076,1578
26.10.2019 16:00,2646,34.73,927,959,1719
26.10.2019 17:00,2627,35.71,817,859,1810
26.10.2019 18:00,2701,37.02,713,784,1988
26.10.2019 19:00,2787,37.97,683,746,2104
26.10.2019 20:00,2661,37.37,660,733,2001
26.10.2019 21:00,2469,35.77,681,744,1788
26.10.2019 22:00,2355,35.05,686,772,1669
26.10.2019 23:00,2310,33.96,761,806,1549
27.10.2019 00:00,2125,32.72,814,840,1311
27.10.2019 01:00,1918,32.21,786,738,1132
27.10.2019 02:00,1870,31.68,837,763,1033
27.10.2019 03:00,2761.949947,31.46,884,784,1877.949947
27.10.2019 03:00,1795,31.49,834,797,961
27.10.2019 04:00,1770,31.12,816,821,954
27.10.2019 05:00,1775,31.66,832,838,943
27.10.2019 06:00,1829,32.94,874,877,955
27.10.2019 07:00,1944,33.83,932,933,1012
27.10.2019 08:00,2022,34.67,971,978,1051
27.10.2019 09:00,2201,35.24,1005,1026,1196
27.10.2019 10:00,2346,36.1,1057,1083,1289
27.10.2019 11:00,2411,36.7,1066,1119,1345
27.10.2019 12:00,2444,36.66,1058,1119,1386
27.10.2019 13:00,2476,36.2,1031,1092,1445
27.10.2019 14:00,2516,36.04,963,1019,1553
27.10.2019 15:00,2699,36.37,931,914,1768
27.10.2019 16:00,2688,37.14,868,805,1820
27.10.2019 17:00,2784,38.49,785,729,1999
27.10.2019 18:00,2963,44.44,746,693,2217
27.10.2019 19:00,2880,44.73,742,683,2138
27.10.2019 20:00,2777,40.33,713,692,2064
27.10.2019 21:00,2653,38.52,696,691,1957
27.10.2019 22:00,2559,37.58,657,676,1902
27.10.2019 23:00,2423,36.55,618,644,1805
28.10.2019 00:00,2285,35.03,562,600,1723
28.10.2019 01:00,2121,35.48,473,471,1648
28.10.2019 02:00,2074,35.36,420,409,1654
28.10.2019 03:00,2095,35.5,374,362,1721
28.10.2019 04:00,2216,35.74,330,336,1886
28.10.2019 05:00,2272,36.96,306,321,1966
28.10.2019 06:00,2408,38.45,287,302,2121
28.10.2019 07:00,2793,40,272,270,2521
28.10.2019 08:00,3090,48.47,229,219,2861
28.10.2019 09:00,3254,45.93,156,166,3098
28.10.2019 10:00,3232,44.01,104,132,3128
28.10.2019 11:00,3202,43.06,82,112,3120
28.10.2019 12:00,3126,42.33,77,100,3049
28.10.2019 13:00,3045,40.58,66,92,2979
28.10.2019 14:00,3058,43.28,59,90,2999
28.10.2019 15:00,3036,48.83,52,89,2984
28.10.2019 16:00,3053,51.42,56,87,2997
28.10.2019 17:00,3108,54.99,110,103,2998
28.10.2019 18:00,3303,61.23,109,138,3194
28.10.2019 19:00,3230,63.62,147,178,3083
28.10.2019 20:00,3136,56.02,175,202,2961
28.10.2019 21:00,2987,47.53,204,221,2783
28.10.2019 22:00,2836,40.62,224,235,2612
28.10.2019 23:00,2696,39.33,233,248,2463
29.10.2019 00:00,2539,37.45,251,256,2288
29.10.2019 01:00,2485,37.02,231,210,2254
29.10.2019 02:00,2513,36.6,228,217,2285
29.10.2019 03:00,2488,35.83,235,224,2253
29.10.2019 04:00,2508,35.22,234,232,2274
29.10.2019 05:00,2603,36.06,241,248,2362
29.10.2019 06:00,2799,38.15,263,266,2536
29.10.2019 07:00,3183,43.26,280,288,2903
29.10.2019 08:00,3409,53.5,266,279,3143
29.10.2019 09:00,3482,55.81,240,247,3242
29.10.2019 10:00,3460,55.01,207,222,3253
29.10.2019 11:00,3376,51.56,190,215,3186
29.10.2019 12:00,3295,51.46,206,207,3089
29.10.2019 13:00,3206,47.32,178,196,3028
29.10.2019 14:00,3187,47.75,174,187,3013
29.10.2019 15:00,3145,52.3,178,175,2967
29.10.2019 16:00,3223,55.01,184,165,3039
29.10.2019 17:00,3316,57.2,224,175,3092
29.10.2019 18:00,3485,62.44,264,204,3221
29.10.2019 19:00,3381,64.74,278,232,3103
29.10.2019 20:00,3288,59.29,291,233,2997
29.10.2019 21:00,3173,53.91,267,218,2906
29.10.2019 22:00,3003,45.91,262,198,2741
29.10.2019 23:00,2871,39.93,253,176,2618
30.10.2019 00:00,2727,38.62,222,163,2505
30.10.2019 01:00,2638,38.44,190,158,2448
30.10.2019 02:00,2623,37.6,176,148,2447
30.10.2019 03:00,2642,37.34,154,128,2488
30.10.2019 04:00,2754,36.98,130,107,2624
30.10.2019 05:00,2876,37.91,103,85,2773
30.10.2019 06:00,3080,39.42,83,72,2997
30.10.2019 07:00,3487,46.67,74,68,3413
30.10.2019 08:00,3774,54.12,72,69,3702
30.10.2019 09:00,3821,57.6,80,75,3741
30.10.2019 10:00,3672,54.37,80,85,3592
30.10.2019 11:00,3558,50.39,82,92,3476
30.10.2019 12:00,3478,48.92,91,99,3387
30.10.2019 13:00,3375,47.31,109,117,3266
30.10.2019 14:00,3387,46.37,144,141,3243
30.10.2019 15:00,3390,49.95,173,166,3217
30.10.2019 16:00,3415,54.03,219,194,3196
30.10.2019 17:00,3449,56.17,265,230,3184
30.10.2019 18:00,3571,61.57,324,276,3247
30.10.2019 19:00,3420,65.1,376,324,3044
30.10.2019 20:00,3255,60,415,357,2840
30.10.2019 21:00,3105,53.59,451,378,2654
30.10.2019 22:00,2952,43.54,481,394,2471
30.10.2019 23:00,2728,38.32,476,398,2252
31.10.2019 00:00,2517,36.57,470,392,2047
31.10.2019 01:00,2467,36.2,490,476,1977
31.10.2019 02:00,2412,34.98,489,475,1923
31.10.2019 03:00,2379,33.94,500,472,1879
31.10.2019 04:00,2412,33.16,487,468,1925
31.10.2019 05:00,2447,34.85,487,463,1960
31.10.2019 06:00,2534,37.86,477,464,2057
31.10.2019 07:00,2930,39.86,487,464,2443
31.10.2019 08:00,3235,45.56,453,445,2782
31.10.2019 09:00,3337,47.21,410,407,2927
31.10.2019 10:00,3341,44.12,388,377,2953
31.10.2019 11:00,3356,40.52,369,383,2987
31.10.2019 12:00,3339,40.1,377,417,2962
31.10.2019 13:00,3229,39.38,381,444,2848
31.10.2019 14:00,3184,40.15,373,428,2811
31.10.2019 15:00,3192,42.9,332,378,2860
31.10.2019 16:00,3204,46.61,301,333,2903
31.10.2019 17:00,3271,51.08,290,311,2981
31.10.2019 18:00,3378,56.01,281,302,3097
31.10.2019 19:00,3223,55.44,279,294,2944
31.10.2019 20:00,3091,50.35,279,277,2812
31.10.2019 21:00,3010,47.93,260,253,2750
31.10.2019 22:00,2901,43.12,270,230,2631
31.10.2019 23:00,2669,39.68,252,216,2417
11.01.2019 00:00,2490,37.54,240,205,2250
11.01.2019 01:00,2444,36.51,245,226,2199
11.01.2019 02:00,2367,34.88,228,211,2139
11.01.2019 03:00,2329,34.51,206,192,2123
11.01.2019 04:00,2313,34.42,182,174,2131
11.01.2019 05:00,2369,35.57,157,158,2212
11.01.2019 06:00,2539,37.38,151,146,2388
11.01.2019 07:00,2896,38.51,148,140,2748
11.01.2019 08:00,3216,39.83,152,147,3064
11.01.2019 09:00,3296,40.17,166,165,3130
11.01.2019 10:00,3261,39.87,213,203,3048
11.01.2019 11:00,3245,39.74,251,245,2994
11.01.2019 12:00,3215,39.41,302,298,2913
11.01.2019 13:00,3094,38.91,375,355,2719
11.01.2019 14:00,3090,38.78,399,390,2691
11.01.2019 15:00,3105,38.44,435,408,2670
11.01.2019 16:00,3107,38.05,462,437,2645
11.01.2019 17:00,3216,38.62,512,495,2704
11.01.2019 18:00,3325,39.19,575,579,2750
11.01.2019 19:00,3203,39.02,649,653,2554
11.01.2019 20:00,2996,38.23,675,677,2321
11.01.2019 21:00,2850,37.31,643,663,2207
11.01.2019 22:00,2710,36.26,581,628,2129
11.01.2019 23:00,2610,34.04,530,587,2080
11.02.2019 00:00,2507,30.78,465,541,2042
11.02.2019 01:00,2424,31.5,412,421,2012
11.02.2019 02:00,2378,30.07,367,388,2011
11.02.2019 03:00,2350,28.01,333,361,2017
11.02.2019 04:00,2338,27,302,333,2036
11.02.2019 05:00,2349,28.06,258,301,2091
11.02.2019 06:00,2381,30.1,223,268,2158
11.02.2019 07:00,2401,34.43,194,236,2207
11.02.2019 08:00,2481,35.7,165,209,2316
11.02.2019 09:00,2614,36.59,143,185,2471
11.02.2019 10:00,2732,37.95,122,166,2610
11.02.2019 11:00,2800,38.43,95,152,2705
11.02.2019 12:00,2794,38.17,95,144,2699
11.02.2019 13:00,2784,37.47,88,140,2696
11.02.2019 14:00,2753,37.11,97,139,2656
11.02.2019 15:00,2721,37.04,140,143,2581
11.02.2019 16:00,2757,37.29,140,153,2617
11.02.2019 17:00,2847,38.42,165,173,2682
11.02.2019 18:00,2923,38.93,184,195,2739
11.02.2019 19:00,2871,39.44,216,218,2655
11.02.2019 20:00,2711,37.31,235,227,2476
11.02.2019 21:00,2603,36.88,227,228,2376
11.02.2019 22:00,2518,36.36,226,230,2292
11.02.2019 23:00,2387,35.19,221,218,2166
11.03.2019 00:00,2269,33.91,195,197,2074
11.03.2019 01:00,2227,34.52,169,205,2058
11.03.2019 02:00,2182,32.91,154,195,2028
11.03.2019 03:00,2167,30.43,144,186,2023
11.03.2019 04:00,2122,29.28,131,180,1991
11.03.2019 05:00,2106,30.44,129,169,1977
11.03.2019 06:00,2146,31.65,117,162,2029
11.03.2019 07:00,2174,33.48,111,149,2063
11.03.2019 08:00,2214,34.43,113,143,2101
11.03.2019 09:00,2302,35.88,112,131,2190
11.03.2019 10:00,2447,36.88,124,122,2323
11.03.2019 11:00,2592,37.59,172,121,2420
11.03.2019 12:00,2601,38.14,147,119,2454
11.03.2019 13:00,2666,38.69,182,122,2484
11.03.2019 14:00,2636,38.09,201,117,2435
11.03.2019 15:00,2612,38.23,194,111,2418
11.03.2019 16:00,2627,38.54,239,108,2388
11.03.2019 17:00,2787,39.76,313,113,2474
11.03.2019 18:00,2950,41.24,287,128,2663
11.03.2019 19:00,2898,41.8,298,145,2600
11.03.2019 20:00,2768,40.86,277,168,2491
11.03.2019 21:00,2670,39.24,322,199,2348
11.03.2019 22:00,2558,37.43,402,240,2156
11.03.2019 23:00,2381,35.86,422,290,1959
11.04.2019 00:00,2249,34.1,475,353,1774
11.04.2019 01:00,2240,34.76,573,567,1667
11.04.2019 02:00,2230,34.56,611,623,1619
11.04.2019 03:00,2241,34.6,666,680,1575
11.04.2019 04:00,2187,34.46,706,738,1481
11.04.2019 05:00,2232,35.47,763,799,1469
11.04.2019 06:00,2381,36.37,825,855,1556
11.04.2019 07:00,2791,39.51,890,900,1901
11.04.2019 08:00,3170,43.56,903,915,2267
11.04.2019 09:00,3269,45.35,904,902,2365
11.04.2019 10:00,3311,45.07,904,898,2407
11.04.2019 11:00,3396,43.97,905,898,2491
11.04.2019 12:00,3365,43.33,893,899,2472
11.04.2019 13:00,3289,41.71,903,900,2386
11.04.2019 14:00,3308,43.65,895,913,2413
11.04.2019 15:00,3340,44.39,898,939,2442
11.04.2019 16:00,3361,46.38,910,969,2451
11.04.2019 17:00,3440,48.19,923,994,2517
11.04.2019 18:00,3496,52.89,940,1012,2556
11.04.2019 19:00,3386,52.92,958,1021,2428
11.04.2019 20:00,3296,48.91,964,1012,2332
11.04.2019 21:00,3085,43.15,964,996,2121
11.04.2019 22:00,2910,40,948,975,1962
11.04.2019 23:00,2784,38.98,924,947,1860
11.05.2019 00:00,2622,36.6,915,914,1707
11.05.2019 01:00,2528,37.08,850,836,1678
11.05.2019 02:00,2511,36.57,806,801,1705
11.05.2019 03:00,2525,36.37,781,766,1744
11.05.2019 04:00,2543,36.48,761,735,1782
11.05.2019 05:00,2646,37.85,729,704,1917
11.05.2019 06:00,2877,40.62,688,671,2189
11.05.2019 07:00,3240,41.42,657,647,2583
11.05.2019 08:00,3576,45.52,632,630,2944
11.05.2019 09:00,3625,47.97,601,606,3024
11.05.2019 10:00,3612,47.43,593,593,3019
11.05.2019 11:00,3633,47.98,586,573,3047
11.05.2019 12:00,3605,48.43,562,542,3043
11.05.2019 13:00,3616,46.96,528,511,3088
11.05.2019 14:00,3667,48.34,530,485,3137
11.05.2019 15:00,3663,49.91,503,464,3160
11.05.2019 16:00,3701,50,497,450,3204
11.05.2019 17:00,3745,51.27,497,459,3248
11.05.2019 18:00,3825,60.71,499,473,3326
11.05.2019 19:00,3716,62.89,504,480,3212
11.05.2019 20:00,3609,51.05,490,466,3119
11.05.2019 21:00,3498,46.42,462,441,3036
11.05.2019 22:00,3296,42.38,439,413,2857
11.05.2019 23:00,3025,41.21,409,385,2616
11.06.2019 00:00,2783,39.57,385,362,2398
11.06.2019 01:00,2644,40.4,380,409,2264
11.06.2019 02:00,2608,39.99,382,402,2226
11.06.2019 03:00,2590,39.97,378,396,2212
11.06.2019 04:00,2615,40.2,374,393,2241
11.06.2019 05:00,2672,41.03,378,394,2294
11.06.2019 06:00,2892,41.39,378,397,2514
11.06.2019 07:00,3412,45.63,378,396,3034
11.06.2019 08:00,3710,55.77,356,378,3354
11.06.2019 09:00,3725,59.68,308,334,3417
11.06.2019 10:00,3712,56.92,266,291,3446
11.06.2019 11:00,3730,56.8,219,260,3511
11.06.2019 12:00,3675,56.44,187,234,3488
11.06.2019 13:00,3601,54.42,171,214,3430
11.06.2019 14:00,3594,55.8,155,200,3439
11.06.2019 15:00,3568,57.28,147,192,3421
11.06.2019 16:00,3581,57.39,146,184,3435
11.06.2019 17:00,3638,60.71,147,176,3491
11.06.2019 18:00,3725,76.25,140,163,3585
11.06.2019 19:00,3623,87.12,130,150,3493
11.06.2019 20:00,3490,63.44,121,133,3369
11.06.2019 21:00,3334,53.17,118,119,3216
11.06.2019 22:00,3186,47.52,130,106,3056
11.06.2019 23:00,2990,43.53,133,97,2857
11.07.2019 00:00,2771,41.39,108,90,2663
11.07.2019 01:00,2666,41.97,88,93,2578
11.07.2019 02:00,2648,41.14,80,86,2568
11.07.2019 03:00,2595,40.68,79,79,2516
11.07.2019 04:00,2633,40.97,75,75,2558
11.07.2019 05:00,2702,42.11,71,74,2631
11.07.2019 06:00,2861,43.06,70,75,2791
11.07.2019 07:00,3282,45.68,76,78,3206
11.07.2019 08:00,3586,53.9,79,79,3507
11.07.2019 09:00,3632,58.65,90,77,3542
11.07.2019 10:00,3606,52.87,88,76,3518
11.07.2019 11:00,3660,49.49,94,73,3566
11.07.2019 12:00,3619,47.89,95,69,3524
11.07.2019 13:00,3523,47.15,104,65,3419
11.07.2019 14:00,3504,46.83,119,66,3385
11.07.2019 15:00,3485,46.73,112,72,3373
11.07.2019 16:00,3548,47.42,123,82,3425
11.07.2019 17:00,3603,49.88,141,103,3462
11.07.2019 18:00,3678,52.43,159,125,3519
11.07.2019 19:00,3574,48.19,177,144,3397
11.07.2019 20:00,3478,46.72,175,155,3303
11.07.2019 21:00,3347,44.98,180,161,3167
11.07.2019 22:00,3142,43.39,173,169,2969
11.07.2019 23:00,2928,42.13,188,182,2740
11.08.2019 00:00,2678,41.27,213,200,2465
11.08.2019 01:00,2550,39.91,292,322,2258
11.08.2019 02:00,2503,39.4,333,364,2170
11.08.2019 03:00,2414,39.2,371,401,2043
11.08.2019 04:00,2386,39.23,401,435,1985
11.08.2019 05:00,2399,39.89,430,460,1969
11.08.2019 06:00,2585,41.96,445,471,2140
11.08.2019 07:00,3005,45.05,438,466,2567
11.08.2019 08:00,3351,51.78,409,428,2942
11.08.2019 09:00,3402,54.32,368,371,3034
11.08.2019 10:00,3376,55.62,313,325,3063
11.08.2019 11:00,3327,54.94,251,294,3076
11.08.2019 12:00,3245,53.95,237,267,3008
11.08.2019 13:00,3261,52.44,242,237,3019
11.08.2019 14:00,3225,52.52,194,194,3031
11.08.2019 15:00,3211,53.01,165,154,3046
11.08.2019 16:00,3170,52.19,129,127,3041
11.08.2019 17:00,3277,54.3,115,109,3162
11.08.2019 18:00,3352,66.47,99,92,3253
11.08.2019 19:00,3274,59.98,82,79,3192
11.08.2019 20:00,3167,50.73,70,67,3097
11.08.2019 21:00,3009,46.94,49,58,2960
11.08.2019 22:00,2860,43.83,42,53,2818
11.08.2019 23:00,2706,42.98,35,52,2671
11.09.2019 00:00,2537,40.64,42,56,2495
11.09.2019 01:00,2425,41.91,48,48,2377
11.09.2019 02:00,2333,40.5,63,64,2270
11.09.2019 03:00,2275,39.78,81,84,2194
11.09.2019 04:00,2264,39.24,99,109,2165
11.09.2019 05:00,2262,39.3,122,133,2140
11.09.2019 06:00,2307,39.49,136,150,2171
11.09.2019 07:00,2428,40.54,150,165,2278
11.09.2019 08:00,2565,41.56,156,170,2409
11.09.2019 09:00,2723,42.02,150,165,2573
11.09.2019 10:00,2824,44.57,129,158,2695
11.09.2019 11:00,2919,44.15,128,157,2791
11.09.2019 12:00,2971,43.1,122,161,2849
11.09.2019 13:00,2980,42.19,133,169,2847
11.09.2019 14:00,2943,41.33,141,180,2802
11.09.2019 15:00,2904,41.24,164,189,2740
11.09.2019 16:00,2944,41.69,171,200,2773
11.09.2019 17:00,3103,43.81,182,208,2921
11.09.2019 18:00,3169,48.75,200,210,2969
11.09.2019 19:00,3075,45.24,202,217,2873
11.09.2019 20:00,2996,44.09,206,219,2790
11.09.2019 21:00,2825,41.8,218,224,2607
11.09.2019 22:00,2679,40.71,248,231,2431
11.09.2019 23:00,2557,39.66,247,237,2310
11.10.2019 00:00,2488,36.67,251,246,2237
11.10.2019 01:00,2358,38.49,208,199,2150
11.10.2019 02:00,2295,37.47,210,201,2085
11.10.2019 03:00,2267,36.93,211,201,2056
11.10.2019 04:00,2258,36.75,216,198,2042
11.10.2019 05:00,2272,37.27,196,187,2076
11.10.2019 06:00,2326,37.56,175,177,2151
11.10.2019 07:00,2386,37.4,155,169,2231
11.10.2019 08:00,2508,38.94,144,152,2364
11.10.2019 09:00,2650,39.97,135,140,2515
11.10.2019 10:00,2793,40.41,117,130,2676
11.10.2019 11:00,2901,40.92,101,123,2800
11.10.2019 12:00,2891,41,81,115,2810
11.10.2019 13:00,2870,41.33,73,109,2797
11.10.2019 14:00,2842,40.88,62,99,2780
11.10.2019 15:00,2847,41.07,50,88,2797
11.10.2019 16:00,2917,42.37,39,73,2878
11.10.2019 17:00,3108,45.3,40,60,3068
11.10.2019 18:00,3244,50.92,46,52,3198
11.10.2019 19:00,3252,51.82,33,47,3219
11.10.2019 20:00,3191,51.25,49,42,3142
11.10.2019 21:00,3072,49.79,43,41,3029
11.10.2019 22:00,2932,44.84,54,46,2878
11.10.2019 23:00,2766,43.19,91,62,2675
11.11.2019 00:00,2576,40.86,132,86,2444
11.11.2019 01:00,2519,40.19,182,179,2337
11.11.2019 02:00,2465,39.84,230,223,2235
11.11.2019 03:00,2457,39.72,275,274,2182
11.11.2019 04:00,2449,39.78,324,333,2125
11.11.2019 05:00,2457,40.1,374,375,2083
11.11.2019 06:00,2631,41.34,390,403,2241
11.11.2019 07:00,3031,43.55,414,424,2617
11.11.2019 08:00,3400,47.69,451,446,2949
11.11.2019 09:00,3442,51,492,463,2950
11.11.2019 10:00,3388,48.64,498,487,2890
11.11.2019 11:00,3431,46.88,480,498,2951
11.11.2019 12:00,3402,46.42,497,503,2905
11.11.2019 13:00,3352,45.27,497,508,2855
11.11.2019 14:00,3318,45.6,493,496,2825
11.11.2019 15:00,3342,44.15,466,469,2876
11.11.2019 16:00,3409,44.62,451,452,2958
11.11.2019 17:00,3528,44.78,493,482,3035
11.11.2019 18:00,3648,47.99,531,548,3117
11.11.2019 19:00,3579,45.39,599,627,2980
11.11.2019 20:00,3461,42.69,670,697,2791
11.11.2019 21:00,3229,41.96,766,761,2463
11.11.2019 22:00,3014,40.99,824,815,2190
11.11.2019 23:00,2766,40.39,850,850,1916
11.12.2019 00:00,2575,39.38,862,861,1713
11.12.2019 01:00,2490,36.95,766,830,1724
11.12.2019 02:00,2468,36.6,741,830,1727
11.12.2019 03:00,2421,36.31,737,837,1684
11.12.2019 04:00,2463,36.35,742,846,1721
11.12.2019 05:00,2538,38.02,751,846,1787
11.12.2019 06:00,2724,40.5,799,831,1925
11.12.2019 07:00,3134,41.25,791,812,2343
11.12.2019 08:00,3465,43.87,763,778,2702
11.12.2019 09:00,3495,43.99,736,722,2759
11.12.2019 10:00,3532,43,707,668,2825
11.12.2019 11:00,3574,42.41,687,629,2887
11.12.2019 12:00,3586,42.03,651,597,2935
11.12.2019 13:00,3462,41.94,639,564,2823
11.12.2019 14:00,3443,42.6,611,530,2832
11.12.2019 15:00,3451,43.39,573,493,2878
11.12.2019 16:00,3467,43.98,542,467,2925
11.12.2019 17:00,3520,49.85,523,456,2997
11.12.2019 18:00,3650,57.79,526,455,3124
11.12.2019 19:00,3588,50,498,456,3090
11.12.2019 20:00,3394,42.84,467,432,2927
11.12.2019 21:00,3212,41.55,451,391,2761
11.12.2019 22:00,2983,40.95,399,348,2584
11.12.2019 23:00,2837,40.02,365,312,2472
13.11.2019 00:00,2667,37.64,334,283,2333
13.11.2019 01:00,2549,34.84,314,309,2235
13.11.2019 02:00,2458,34.83,293,296,2165
13.11.2019 03:00,2446,35.01,271,281,2175
13.11.2019 04:00,2464,35.22,242,266,2222
13.11.2019 05:00,2502,38.03,230,246,2272
13.11.2019 06:00,2665,40.75,223,226,2442
13.11.2019 07:00,3102,42.05,216,211,2886
13.11.2019 08:00,3469,47.7,208,202,3261
13.11.2019 09:00,3497,52.08,206,191,3291
13.11.2019 10:00,3463,51.56,195,184,3268
13.11.2019 11:00,3484,50.12,181,180,3303
13.11.2019 12:00,3477,50.59,182,179,3295
13.11.2019 13:00,3447,48.97,183,182,3264
13.11.2019 14:00,3423,55.12,191,177,3232
13.11.2019 15:00,3427,55.98,170,169,3257
13.11.2019 16:00,3481,58.42,168,171,3313
13.11.2019 17:00,3533,63.51,187,188,3346
13.11.2019 18:00,3607,67.2,210,206,3397
13.11.2019 19:00,3560,56.09,226,222,3334
13.11.2019 20:00,3442,52.94,216,211,3226
13.11.2019 21:00,3291,46.22,188,187,3103
13.11.2019 22:00,3125,42.91,166,159,2959
13.11.2019 23:00,2895,41.47,151,139,2744
14.11.2019 00:00,2675,40.72,130,125,2545
14.11.2019 01:00,2533,40.21,108,103,2425
14.11.2019 02:00,2505,39.9,101,90,2404
14.11.2019 03:00,2506,39.56,98,85,2408
14.11.2019 04:00,2510,39.67,91,84,2419
14.11.2019 05:00,2553,40.19,92,87,2461
14.11.2019 06:00,2760,41.03,103,94,2657
14.11.2019 07:00,3210,43.45,118,100,3092
14.11.2019 08:00,3543,53.17,116,100,3427
14.11.2019 09:00,3551,52.32,108,97,3443
14.11.2019 10:00,3490,49.1,105,95,3385
14.11.2019 11:00,3509,47.24,100,94,3409
14.11.2019 12:00,3506,47.95,90,94,3416
14.11.2019 13:00,3442,48.64,89,94,3353
14.11.2019 14:00,3422,50.62,78,85,3344
14.11.2019 15:00,3427,53.7,58,68,3369
14.11.2019 16:00,3447,54.12,53,57,3394
14.11.2019 17:00,3517,56.15,59,60,3458
14.11.2019 18:00,3568,59.19,68,73,3500
14.11.2019 19:00,3505,49.8,90,90,3415
14.11.2019 20:00,3398,45.06,103,110,3295
14.11.2019 21:00,3301,42.73,114,134,3187
14.11.2019 22:00,3173,42.05,119,165,3054
14.11.2019 23:00,2973,41.06,143,193,2830
15.11.2019 00:00,2741,40.67,187,223,2554
15.11.2019 01:00,2557,38.75,249,253,2308
15.11.2019 02:00,2474,37.03,292,305,2182
15.11.2019 03:00,2475,36.64,335,352,2140
15.11.2019 04:00,2447,36.82,397,411,2050
15.11.2019 05:00,2461,37.94,428,488,2033
15.11.2019 06:00,2635,40.02,568,570,2067
15.11.2019 07:00,2965,41.21,701,653,2264
15.11.2019 08:00,3242,42.44,761,738,2481
15.11.2019 09:00,3268,42.42,836,805,2432
15.11.2019 10:00,3298,41.96,902,866,2396
15.11.2019 11:00,3291,41.72,946,904,2345
15.11.2019 12:00,3323,41.64,986,937,2337
15.11.2019 13:00,3325,41.34,1036,972,2289
15.11.2019 14:00,3274,41.45,1065,1007,2209
15.11.2019 15:00,3233,42,1097,1034,2136
15.11.2019 16:00,3237,42.75,1135,1066,2102
15.11.2019 17:00,3383,43.6,1160,1092,2223
15.11.2019 18:00,3430,44.27,1173,1116,2257
15.11.2019 19:00,3328,43.41,1180,1127,2148
15.11.2019 20:00,3153,42.4,1164,1113,1989
15.11.2019 21:00,3010,41.55,1144,1081,1866
15.11.2019 22:00,2801,41.35,1109,1038,1692
15.11.2019 23:00,2623,40.04,1062,993,1561
16.11.2019 00:00,2510,38.46,1003,947,1507
16.11.2019 01:00,2443,36.98,992,983,1451
16.11.2019 02:00,2365,37.07,956,956,1409
16.11.2019 03:00,2275,36.53,933,931,1342
16.11.2019 04:00,2283,37.19,916,906,1367
16.11.2019 05:00,2289,37.32,893,890,1396
16.11.2019 06:00,2323,37.49,873,881,1450
16.11.2019 07:00,2514,38.42,865,876,1649
16.11.2019 08:00,2676,39.43,881,875,1795
16.11.2019 09:00,2823,41.11,862,872,1961
16.11.2019 10:00,2959,41.75,861,874,2098
16.11.2019 11:00,2994,41.51,860,879,2134
16.11.2019 12:00,3039,41.08,796,888,2243
16.11.2019 13:00,2941,40.26,787,889,2154
16.11.2019 14:00,2886,39.94,777,880,2109
16.11.2019 15:00,2884,40.12,734,857,2150
16.11.2019 16:00,2906,40.19,715,824,2191
16.11.2019 17:00,2981,41.25,731,818,2250
16.11.2019 18:00,3004,42.47,783,842,2221
16.11.2019 19:00,2938,41.55,832,883,2106
16.11.2019 20:00,2833,39.98,907,940,1926
16.11.2019 21:00,2699,38.63,983,1004,1716
16.11.2019 22:00,2578,38.58,1048,1052,1530
16.11.2019 23:00,2464,37.29,1104,1071,1360
17.11.2019 00:00,2309,36.44,1086,1069,1223
17.11.2019 01:00,2287,34.87,1133,1231,1154
17.11.2019 02:00,2289,34.45,1258,1246,1031
17.11.2019 03:00,2282,34.06,1240,1223,1042
17.11.2019 04:00,2264,33.8,1209,1187,1055
17.11.2019 05:00,2226,34.15,1156,1145,1070
17.11.2019 06:00,2399,34.41,1071,1089,1328
17.11.2019 07:00,2476,34.33,999,1011,1477
17.11.2019 08:00,2539,34.96,901,893,1638
17.11.2019 09:00,2559,36.85,786,755,1773
17.11.2019 10:00,2738,38.81,671,617,2067
17.11.2019 11:00,2926,39.72,536,498,2390
17.11.2019 12:00,2990,40.76,403,386,2587
17.11.2019 13:00,2902,40.15,288,279,2614
17.11.2019 14:00,2896,40.22,198,191,2698
17.11.2019 15:00,2869,40.26,135,127,2734
17.11.2019 16:00,2945,40.8,96,92,2849
17.11.2019 17:00,3102,41.79,92,87,3010
17.11.2019 18:00,3221,43.98,120,111,3101
17.11.2019 19:00,3173,43.48,155,163,3018
17.11.2019 20:00,3046,41.92,218,222,2828
17.11.2019 21:00,2873,40.85,302,290,2571
17.11.2019 22:00,2650,39.97,399,374,2251
17.11.2019 23:00,2488,38.64,493,468,1995
18.11.2019 00:00,2349,37.26,583,565,1766
18.11.2019 01:00,2253,37.93,693,704,1560
18.11.2019 02:00,2155,37.24,842,815,1313
18.11.2019 03:00,2134,36.81,938,909,1196
18.11.2019 04:00,2228,36.88,954,988,1274
18.11.2019 05:00,2331,38.67,952,1033,1379
18.11.2019 06:00,2497,39.91,1069,1054,1428
18.11.2019 07:00,2873,41.34,1069,1064,1804
18.11.2019 08:00,3219,43.14,1074,1062,2145
18.11.2019 09:00,3281,44.4,1052,1045,2229
18.11.2019 10:00,3302,44.89,1038,1024,2264
18.11.2019 11:00,3330,44.46,994,994,2336
18.11.2019 12:00,3354,43.97,940,954,2414
18.11.2019 13:00,3367,43.79,893,909,2474
18.11.2019 14:00,3464,43.57,835,873,2629
18.11.2019 15:00,3459,43.6,785,840,2674
18.11.2019 16:00,3494,43.77,743,810,2751
18.11.2019 17:00,3507,53.68,684,770,2823
18.11.2019 18:00,3491,54.94,654,718,2837
18.11.2019 19:00,3431,43.11,633,664,2798
18.11.2019 20:00,3219,41.62,628,610,2591
18.11.2019 21:00,3055,40.7,561,559,2494
18.11.2019 22:00,2868,40.38,551,511,2317
18.11.2019 23:00,2653,39.62,542,471,2111
19.11.2019 00:00,2456,37.11,526,443,1930
19.11.2019 01:00,2374,35.9,523,522,1851
19.11.2019 02:00,2311,34.85,533,545,1778
19.11.2019 03:00,2238,34.31,608,602,1630
19.11.2019 04:00,2198,34.28,687,665,1511
19.11.2019 05:00,2330,35.63,743,705,1587
19.11.2019 06:00,2631,38.16,761,726,1870
19.11.2019 07:00,2986,39.75,753,742,2233
19.11.2019 08:00,3358,41.93,765,753,2593
19.11.2019 09:00,3516,43.78,746,754,2770
19.11.2019 10:00,3561,41.99,721,761,2840
19.11.2019 11:00,3561,41.7,601,779,2960
19.11.2019 12:00,3580,41.77,529,789,3051
19.11.2019 13:00,3518,41.96,501,798,3017
19.11.2019 14:00,3562,43.11,519,813,3043
19.11.2019 15:00,3537,42.87,541,828,2996
19.11.2019 16:00,3525,43.12,617,856,2908
19.11.2019 17:00,3505,49.66,663,870,2842
19.11.2019 18:00,3625,53,781,877,2844
19.11.2019 19:00,3451,49.26,745,875,2706
19.11.2019 20:00,3311,42,754,865,2557
19.11.2019 21:00,3184,41.63,721,841,2463
19.11.2019 22:00,2958,41.27,679,802,2279
19.11.2019 23:00,2714,40.63,669,719,2045
20.11.2019 00:00,2517,39.28,599,613,1918
20.11.2019 01:00,2437,38.77,509,515,1928
20.11.2019 02:00,2414,38.96,407,416,2007
20.11.2019 03:00,2371,38.75,304,319,2067
20.11.2019 04:00,2407,39.1,220,239,2187
20.11.2019 05:00,2483,39.5,164,178,2319
20.11.2019 06:00,2637,40.79,126,140,2511
20.11.2019 07:00,3069,50.74,105,116,2964
20.11.2019 08:00,3342,59.06,100,107,3242
20.11.2019 09:00,3370,67.25,107,107,3263
20.11.2019 10:00,3395,47.83,126,113,3269
20.11.2019 11:00,3482,45.81,155,130,3327
20.11.2019 12:00,3463,45.8,194,163,3269
20.11.2019 13:00,3417,47.24,239,209,3178
20.11.2019 14:00,3373,53.07,295,267,3078
20.11.2019 15:00,3317,53.08,345,335,2972
20.11.2019 16:00,3315,58.23,408,417,2907
20.11.2019 17:00,3341,61.77,507,494,2834
20.11.2019 18:00,3374,59.59,557,557,2817
20.11.2019 19:00,3353,53.07,613,611,2740
20.11.2019 20:00,3291,43.85,632,629,2659
20.11.2019 21:00,3178,42.39,619,623,2559
20.11.2019 22:00,3012,41.6,636,605,2376
20.11.2019 23:00,2740,40.09,626,583,2114
21.11.2019 00:00,2560,38.61,602,565,1958
21.11.2019 01:00,2502,38.45,560,536,1942
21.11.2019 02:00,2434,37.59,528,520,1906
21.11.2019 03:00,2352,36.97,538,511,1814
21.11.2019 04:00,2313,37.32,529,504,1784
21.11.2019 05:00,2365,38.39,514,502,1851
21.11.2019 06:00,2532,39.96,515,508,2017
21.11.2019 07:00,2974,44.49,524,514,2450
21.11.2019 08:00,3326,56.59,524,518,2802
21.11.2019 09:00,3365,57,492,510,2873
21.11.2019 10:00,3368,43.76,490,516,2878
21.11.2019 11:00,3414,43.26,521,532,2893
21.11.2019 12:00,3494,42.99,537,554,2957
21.11.2019 13:00,3544,43.27,562,574,2982
21.11.2019 14:00,3549,47.36,575,583,2974
21.11.2019 15:00,3502,47.8,586,593,2916
21.11.2019 16:00,3515,50.7,628,611,2887
21.11.2019 17:00,3546,50.63,680,660,2866
21.11.2019 18:00,3597,53.02,722,713,2875
21.11.2019 19:00,3511,50.63,760,763,2751
21.11.2019 20:00,3344,42.56,808,804,2536
21.11.2019 21:00,3168,41.58,827,839,2341
21.11.2019 22:00,3028,40.19,840,877,2188
21.11.2019 23:00,2848,39.17,888,906,1960
22.11.2019 00:00,2657,36.65,896,925,1761
22.11.2019 01:00,2557,34.45,892,938,1665
22.11.2019 02:00,2492,33.89,895,946,1597
22.11.2019 03:00,2443,34.2,910,948,1533
22.11.2019 04:00,2469,34.5,921,943,1548
22.11.2019 05:00,2480,35.17,916,922,1564
22.11.2019 06:00,2640,37.47,855,887,1785
22.11.2019 07:00,3064,40.23,830,848,2234
22.11.2019 08:00,3384,44.43,815,810,2569
22.11.2019 09:00,3433,51.52,772,762,2661
22.11.2019 10:00,3448,42.43,712,711,2736
22.11.2019 11:00,3409,42.34,667,654,2742
22.11.2019 12:00,3400,42.34,611,596,2789
22.11.2019 13:00,3342,42.45,562,539,2780
22.11.2019 14:00,3260,45.91,516,489,2744
22.11.2019 15:00,3205,47.85,493,447,2712
22.11.2019 16:00,3242,48.31,471,417,2771
22.11.2019 17:00,3267,47.86,448,404,2819
22.11.2019 18:00,3243,50.66,441,397,2802
22.11.2019 19:00,3124,44.65,438,393,2686
22.11.2019 20:00,2934,40.27,429,386,2505
22.11.2019 21:00,2709,39.56,432,371,2277
22.11.2019 22:00,2598,39.27,440,355,2158
22.11.2019 23:00,2488,38.32,428,349,2060
23.11.2019 00:00,2353,35.49,412,355,1941
23.11.2019 01:00,2263,34.36,423,423,1840
23.11.2019 02:00,2173,34.04,443,441,1730
23.11.2019 03:00,2135,33.44,481,474,1654
23.11.2019 04:00,2119,33.17,547,511,1572
23.11.2019 05:00,2125,33.43,584,548,1541
23.11.2019 06:00,2167,33.94,624,577,1543
23.11.2019 07:00,2324,34.96,629,601,1695
23.11.2019 08:00,2515,36.23,568,627,1947
23.11.2019 09:00,2631,37.41,604,655,2027
23.11.2019 10:00,2680,38.66,682,692,1998
23.11.2019 11:00,2747,39.15,756,730,1991
23.11.2019 12:00,2834,39.16,768,753,2066
23.11.2019 13:00,2911,39.14,754,766,2157
23.11.2019 14:00,2923,39.05,771,777,2152
23.11.2019 15:00,2865,39.04,798,788,2067
23.11.2019 16:00,2934,39.31,806,807,2128
23.11.2019 17:00,3089,39.7,827,836,2262
23.11.2019 18:00,3059,40.35,839,861,2220
23.11.2019 19:00,2986,40.02,854,878,2132
23.11.2019 20:00,2839,38.43,890,869,1949
23.11.2019 21:00,2741,38.11,878,846,1863
23.11.2019 22:00,2575,37.9,845,823,1730
23.11.2019 23:00,2424,36.99,841,808,1583
24.11.2019 00:00,2303,35.53,814,803,1489
24.11.2019 01:00,2231,33.91,782,870,1449
24.11.2019 02:00,2172,33.32,790,869,1382
24.11.2019 03:00,2156,33.06,782,856,1374
24.11.2019 04:00,2188,33.04,770,841,1418
24.11.2019 05:00,2199,33.1,757,839,1442
24.11.2019 06:00,2284,34.02,756,842,1528
24.11.2019 07:00,2366,34.08,745,839,1621
24.11.2019 08:00,2461,35.05,825,832,1636
24.11.2019 09:00,2568,36.6,839,833,1729
24.11.2019 10:00,2714,37.8,831,843,1883
24.11.2019 11:00,2788,38.79,813,827,1975
24.11.2019 12:00,2855,39.81,800,789,2055
24.11.2019 13:00,2968,39.81,789,759,2179
24.11.2019 14:00,2998,39.76,770,749,2228
24.11.2019 15:00,2924,40.05,760,745,2164
24.11.2019 16:00,2965,40.68,777,748,2188
24.11.2019 17:00,3132,41.35,790,765,2342
24.11.2019 18:00,3192,41.42,779,785,2413
24.11.2019 19:00,3158,40.96,785,793,2373
24.11.2019 20:00,3036,41.16,771,768,2265
24.11.2019 21:00,2909,40.92,712,719,2197
24.11.2019 22:00,2767,40.63,633,659,2134
24.11.2019 23:00,2641,40.23,558,606,2083
25.11.2019 00:00,2442,39.26,530,562,1912
25.11.2019 01:00,2246,38.19,500,505,1746
25.11.2019 02:00,2181,36.3,492,493,1689
25.11.2019 03:00,2193,36.02,472,497,1721
25.11.2019 04:00,2301,35.4,498,505,1803
25.11.2019 05:00,2335,36.75,489,502,1846
25.11.2019 06:00,2534,40.65,478,493,2056
25.11.2019 07:00,3018,42.93,479,480,2539
25.11.2019 08:00,3398,43.78,456,468,2942
25.11.2019 09:00,3521,44.36,455,454,3066
25.11.2019 10:00,3524,43.56,409,444,3115
25.11.2019 11:00,3565,43.53,360,411,3205
25.11.2019 12:00,3577,43.62,325,366,3252
25.11.2019 13:00,3522,43.71,282,332,3240
25.11.2019 14:00,3564,43.76,276,319,3288
25.11.2019 15:00,3541,43.91,271,317,3270
25.11.2019 16:00,3580,45.06,262,324,3318
25.11.2019 17:00,3619,46.76,252,341,3367
25.11.2019 18:00,3649,53.79,280,363,3369
25.11.2019 19:00,3551,44.92,298,384,3253
25.11.2019 20:00,3492,43.57,289,375,3203
25.11.2019 21:00,3315,42.74,285,348,3030
25.11.2019 22:00,3163,42.22,251,317,2912
25.11.2019 23:00,2968,41.44,211,286,2757
26.11.2019 00:00,2715,40.58,190,257,2525
26.11.2019 01:00,2539,40.7,171,175,2368
26.11.2019 02:00,2487,40.04,165,164,2322
26.11.2019 03:00,2448,39.31,160,161,2288
26.11.2019 04:00,2459,38.36,161,162,2298
26.11.2019 05:00,2527,40.24,155,169,2372
26.11.2019 06:00,2707,40.93,166,179,2541
26.11.2019 07:00,3123,43.21,169,191,2954
26.11.2019 08:00,3475,46.76,187,200,3288
26.11.2019 09:00,3531,53.03,197,206,3334
26.11.2019 10:00,3511,48.18,208,209,3303
26.11.2019 11:00,3542,46.87,201,208,3341
26.11.2019 12:00,3569,46.19,208,197,3361
26.11.2019 13:00,3549,47.95,202,184,3347
26.11.2019 14:00,3551,47.46,190,168,3361
26.11.2019 15:00,3471,47.41,175,157,3296
26.11.2019 16:00,3542,48.69,173,153,3369
26.11.2019 17:00,3567,49.78,173,156,3394
26.11.2019 18:00,3603,53.24,174,160,3429
26.11.2019 19:00,3512,45.97,181,164,3331
26.11.2019 20:00,3386,43.94,178,161,3208
26.11.2019 21:00,3233,43.49,172,155,3061
26.11.2019 22:00,3064,42.49,174,149,2890
26.11.2019 23:00,2830,41.27,156,144,2674
27.11.2019 00:00,2583,39.72,144,138,2439
27.11.2019 01:00,2463,38.04,149,142,2314
27.11.2019 02:00,2364,36.31,151,138,2213
27.11.2019 03:00,2332,35.72,146,143,2186
27.11.2019 04:00,2316,35.9,138,149,2178
27.11.2019 05:00,2343,37.8,157,155,2186
27.11.2019 06:00,2519,40.31,169,161,2350
27.11.2019 07:00,2956,41.71,182,170,2774
27.11.2019 08:00,3308,43.7,193,182,3115
27.11.2019 09:00,3388,46.11,205,192,3183
27.11.2019 10:00,3349,45.44,222,203,3127
27.11.2019 11:00,3415,43.94,227,218,3188
27.11.2019 12:00,3401,43.93,267,238,3134
27.11.2019 13:00,3396,44.12,280,261,3116
27.11.2019 14:00,3400,43.87,307,298,3093
27.11.2019 15:00,3391,43.21,350,350,3041
27.11.2019 16:00,3454,43.41,408,409,3046
27.11.2019 17:00,3445,43.71,478,460,2967
27.11.2019 18:00,3493,44.44,504,504,2989
27.11.2019 19:00,3479,42.83,508,536,2971
27.11.2019 20:00,3398,41.8,503,546,2895
27.11.2019 21:00,3201,41.18,491,535,2710
27.11.2019 22:00,3008,40.71,468,515,2540
27.11.2019 23:00,2852,40.01,449,484,2403
28.11.2019 00:00,2649,38.29,427,451,2222
28.11.2019 01:00,2471,37.9,377,398,2094
28.11.2019 02:00,2414,36.43,373,382,2041
28.11.2019 03:00,2377,35.99,366,376,2011
28.11.2019 04:00,2383,36.18,360,379,2023
28.11.2019 05:00,2423,37.72,377,394,2046
28.11.2019 06:00,2595,40.01,401,419,2194
28.11.2019 07:00,2999,41.02,425,452,2574
28.11.2019 08:00,3347,42.83,460,486,2887
28.11.2019 09:00,3356,43.1,497,520,2859
28.11.2019 10:00,3294,42.73,560,557,2734
28.11.2019 11:00,3304,42.8,591,589,2713
28.11.2019 12:00,3330,42.52,619,609,2711
28.11.2019 13:00,3391,43.29,630,623,2761
28.11.2019 14:00,3327,43.02,646,630,2681
28.11.2019 15:00,3293,42.43,629,633,2664
28.11.2019 16:00,3398,42.08,636,632,2762
28.11.2019 17:00,3437,42.07,636,606,2801
28.11.2019 18:00,3445,42.01,587,563,2858
28.11.2019 19:00,3325,41.58,534,512,2791
28.11.2019 20:00,3245,40.93,458,463,2787
28.11.2019 21:00,3149,40.43,400,426,2749
28.11.2019 22:00,2949,39.88,376,398,2573
28.11.2019 23:00,2740,37.79,372,418,2368
29.11.2019 00:00,2540,34.89,396,470,2144
29.11.2019 01:00,2301,34.87,439,457,1862
29.11.2019 02:00,2213,34.08,472,491,1741
29.11.2019 03:00,2214,30.08,488,534,1726
29.11.2019 04:00,2247,30.68,478,589,1769
29.11.2019 05:00,2358,34.27,542,660,1816
29.11.2019 06:00,2577,38.89,629,741,1948
29.11.2019 07:00,3075,40.84,837,834,2238
29.11.2019 08:00,3468,42.02,931,924,2537
29.11.2019 09:00,3560,42.49,973,1026,2587
29.11.2019 10:00,3677,42.62,1058,1108,2619
29.11.2019 11:00,3735,42.42,1101,1136,2634
29.11.2019 12:00,3764,42.29,1112,1135,2652
29.11.2019 13:00,3736,41.65,1129,1116,2607
29.11.2019 14:00,3672,42.22,1094,1088,2578
29.11.2019 15:00,3613,42.48,1063,1044,2550
29.11.2019 16:00,3650,42.81,1029,996,2621
29.11.2019 17:00,3774,43.91,988,942,2786
29.11.2019 18:00,3782,52.75,932,889,2850
29.11.2019 19:00,3677,54.03,846,836,2831
29.11.2019 20:00,3554,43.43,785,786,2769
29.11.2019 21:00,3356,42.27,719,739,2637
29.11.2019 22:00,3178,41.41,666,688,2512
29.11.2019 23:00,2974,40.38,631,628,2343
30.11.2019 00:00,2840,38.33,571,570,2269
30.11.2019 01:00,2836,35.65,503,508,2333
30.11.2019 02:00,2804,35.54,450,464,2354
30.11.2019 03:00,2781,35.22,414,423,2367
30.11.2019 04:00,2723,35.34,380,391,2343
30.11.2019 05:00,2722,35.39,338,365,2384
30.11.2019 06:00,2808,36.03,329,342,2479
30.11.2019 07:00,2921,36.56,300,327,2621
30.11.2019 08:00,3184,39.07,283,308,2901
30.11.2019 09:00,3345,41.03,262,283,3083
30.11.2019 10:00,3446,41.74,263,256,3183
30.11.2019 11:00,3458,42.09,250,228,3208
30.11.2019 12:00,3389,41.67,221,206,3168
30.11.2019 13:00,3261,41.3,202,193,3059
30.11.2019 14:00,3174,40.77,202,199,2972
30.11.2019 15:00,3194,41.14,221,219,2973
30.11.2019 16:00,3304,41.98,246,244,3058
30.11.2019 17:00,3575,46.07,244,255,3331
30.11.2019 18:00,3632,46.56,233,250,3399
30.11.2019 19:00,3588,45.65,227,240,3361
30.11.2019 20:00,3512,44,207,218,3305
30.11.2019 21:00,3425,42.87,176,190,3249
30.11.2019 22:00,3311,41.92,145,162,3166
30.11.2019 23:00,3218,41.32,121,136,3097
12.01.2019 00:00,3091,39.17,105,118,2986
12.01.2019 01:00,2988,38.5,98,88,2890
12.01.2019 02:00,2938,37.07,92,83,2846
12.01.2019 03:00,2932,36.26,84,84,2848
12.01.2019 04:00,2906,35.93,91,93,2815
12.01.2019 05:00,2909,35.86,110,112,2799
12.01.2019 06:00,2946,35.92,124,139,2822
12.01.2019 07:00,3026,36.13,144,172,2882
12.01.2019 08:00,3079,37.14,170,200,2909
12.01.2019 09:00,3144,38.74,197,216,2947
12.01.2019 10:00,3257,41.11,209,220,3048
12.01.2019 11:00,3294,43.11,223,213,3071
12.01.2019 12:00,3297,43.33,233,212,3064
12.01.2019 13:00,3304,43.16,253,222,3051
12.01.2019 14:00,3239,42.87,285,248,2954
12.01.2019 15:00,3230,43.14,332,288,2898
12.01.2019 16:00,3309,43.54,401,339,2908
12.01.2019 17:00,3424,45.09,443,366,2981
12.01.2019 18:00,3488,44.12,462,371,3026
12.01.2019 19:00,3425,43.18,486,374,2939
12.01.2019 20:00,3282,42.19,494,385,2788
12.01.2019 21:00,3233,41.61,476,393,2757
12.01.2019 22:00,3126,40.41,466,395,2660
12.01.2019 23:00,2934,38.94,441,385,2493
12.02.2019 00:00,2782,36.93,444,365,2338
12.02.2019 01:00,2680,36.03,469,477,2211
12.02.2019 02:00,2566,36.21,442,440,2124
12.02.2019 03:00,2573,35.4,394,394,2179
12.02.2019 04:00,2578,34.46,353,360,2225
12.02.2019 05:00,2634,35.88,325,341,2309
12.02.2019 06:00,2844,39.92,316,336,2528
12.02.2019 07:00,3318,43.76,300,338,3018
12.02.2019 08:00,3732,52.97,291,335,3441
12.02.2019 09:00,3836,54.58,291,331,3545
12.02.2019 10:00,3814,54.09,267,325,3547
12.02.2019 11:00,3862,45.9,244,307,3618
12.02.2019 12:00,3825,43.59,245,289,3580
12.02.2019 13:00,3735,41.96,238,284,3497
12.02.2019 14:00,3786,42.87,258,307,3528
12.02.2019 15:00,3752,49,331,356,3421
12.02.2019 16:00,3849,52.95,364,416,3485
12.02.2019 17:00,3970,53.93,390,435,3580
12.02.2019 18:00,3994,57.23,413,430,3581
12.02.2019 19:00,3907,54.87,382,414,3525
12.02.2019 20:00,3862,54.17,347,388,3515
12.02.2019 21:00,3725,53.13,327,359,3398
12.02.2019 22:00,3520,48.15,306,330,3214
12.02.2019 23:00,3326,41.62,291,306,3035
12.03.2019 00:00,3142,40.48,264,285,2878
12.03.2019 01:00,3042,39.48,243,236,2799
12.03.2019 02:00,3018,39.14,230,220,2788
12.03.2019 03:00,3062,39.03,221,214,2841
12.03.2019 04:00,3049,38.5,225,213,2824
12.03.2019 05:00,3065,39.49,230,219,2835
12.03.2019 06:00,3287,42.81,233,232,3054
12.03.2019 07:00,3624,55.07,259,253,3365
12.03.2019 08:00,3871,67.28,293,280,3578
12.03.2019 09:00,3860,76.47,336,306,3524
12.03.2019 10:00,3776,71,407,335,3369
12.03.2019 11:00,3770,60.49,471,379,3299
12.03.2019 12:00,3820,59.31,525,443,3295
12.03.2019 13:00,3769,55.24,594,515,3175
12.03.2019 14:00,3758,53.19,669,608,3089
12.03.2019 15:00,3781,55.49,775,713,3006
12.03.2019 16:00,3859,56.51,878,823,2981
12.03.2019 17:00,3865,58.56,952,926,2913
12.03.2019 18:00,3828,55.84,1051,1013,2777
12.03.2019 19:00,3675,48.57,1097,1082,2578
12.03.2019 20:00,3552,42.49,1082,1104,2470
12.03.2019 21:00,3473,41.31,1073,1083,2400
12.03.2019 22:00,3295,39.92,1012,1042,2283
12.03.2019 23:00,3079,38.32,954,1006,2125
12.04.2019 00:00,2792,36.16,937,968,1855
12.04.2019 01:00,2534,35,909,900,1625
12.04.2019 02:00,2487,35,902,877,1585
12.04.2019 03:00,2489,34.62,876,852,1613
12.04.2019 04:00,2544,34.76,817,819,1727
12.04.2019 05:00,2528,35.99,793,784,1735
12.04.2019 06:00,2689,37.51,764,755,1925
12.04.2019 07:00,3149,41.67,730,729,2419
12.04.2019 08:00,3578,53.4,680,707,2898
12.04.2019 09:00,3626,54.76,679,681,2947
12.04.2019 10:00,3622,51.47,636,657,2986
12.04.2019 11:00,3718,45.22,593,637,3125
12.04.2019 12:00,3724,43.91,593,617,3131
12.04.2019 13:00,3578,43.81,569,597,3009
12.04.2019 14:00,3594,47.99,552,585,3042
12.04.2019 15:00,3590,53.69,557,585,3033
12.04.2019 16:00,3679,56.9,581,596,3098
12.04.2019 17:00,3718,61.19,604,609,3114
12.04.2019 18:00,3721,61.92,605,624,3116
12.04.2019 19:00,3632,58.62,628,645,3004
12.04.2019 20:00,3571,41.26,649,668,2922
12.04.2019 21:00,3457,40.45,661,697,2796
12.04.2019 22:00,3305,38.12,698,727,2607
12.04.2019 23:00,3083,36.43,717,753,2366
12.05.2019 00:00,2869,36.01,732,772,2137
12.05.2019 01:00,2715,32.91,754,758,1961
12.05.2019 02:00,2606,31.43,780,793,1826
12.05.2019 03:00,2515,30.38,819,819,1696
12.05.2019 04:00,2543,31.75,843,834,1700
12.05.2019 05:00,2680,33.79,811,828,1869
12.05.2019 06:00,2904,35.29,804,822,2100
12.05.2019 07:00,3314,39.57,813,834,2501
12.05.2019 08:00,3627,48.3,847,866,2780
12.05.2019 09:00,3651,54.09,892,904,2759
12.05.2019 10:00,3608,50,925,945,2683
12.05.2019 11:00,3682,41.31,950,984,2732
12.05.2019 12:00,3647,40.86,976,1013,2671
12.05.2019 13:00,3560,40.61,1033,1029,2527
12.05.2019 14:00,3582,40.52,1042,1039,2540
12.05.2019 15:00,3642,40.38,1041,1047,2601
12.05.2019 16:00,3714,41.37,1061,1064,2653
12.05.2019 17:00,3802,42.23,1084,1102,2718
12.05.2019 18:00,3813,42.43,1151,1149,2662
12.05.2019 19:00,3669,40.41,1189,1193,2480
12.05.2019 20:00,3577,38.15,1226,1229,2351
12.05.2019 21:00,3454,36.24,1264,1260,2190
12.05.2019 22:00,3258,34.89,1288,1285,1970
12.05.2019 23:00,3044,32.79,1300,1309,1744
12.06.2019 00:00,2789,24.94,1317,1329,1472
12.06.2019 01:00,2696,25.18,1344,1338,1352
12.06.2019 02:00,2655,25.03,1367,1359,1288
12.06.2019 03:00,2638,18.77,1385,1380,1253
12.06.2019 04:00,2659,18.92,1406,1400,1253
12.06.2019 05:00,2684,29.03,1419,1414,1265
12.06.2019 06:00,2851,34.35,1424,1419,1427
12.06.2019 07:00,3271,35.68,1420,1420,1851
12.06.2019 08:00,3618,38.86,1413,1411,2205
12.06.2019 09:00,3673,39.99,1390,1386,2283
12.06.2019 10:00,3623,38.89,1370,1362,2253
12.06.2019 11:00,3600,38.92,1341,1334,2259
12.06.2019 12:00,3586,38.9,1306,1299,2280
12.06.2019 13:00,3495,37.99,1258,1254,2237
12.06.2019 14:00,3504,37.79,1208,1200,2296
12.06.2019 15:00,3428,37.6,1151,1143,2277
12.06.2019 16:00,3540,37.43,1101,1089,2439
12.06.2019 17:00,3608,39.4,1066,1056,2542
12.06.2019 18:00,3621,40.07,1055,1043,2566
12.06.2019 19:00,3487,37.8,1042,1045,2445
12.06.2019 20:00,3319,37.18,1054,1051,2265
12.06.2019 21:00,3162,35.83,1073,1063,2089
12.06.2019 22:00,2983,35.4,1074,1081,1909
12.06.2019 23:00,2836,33.79,1087,1102,1749
12.07.2019 00:00,2681,32.18,1109,1119,1572
12.07.2019 01:00,2563,29.07,1084,1105,1479
12.07.2019 02:00,2474,26.94,1090,1098,1384
12.07.2019 03:00,2427,24.25,1075,1097,1352
12.07.2019 04:00,2440,23.32,1068,1098,1372
12.07.2019 05:00,2431,25.01,1075,1104,1356
12.07.2019 06:00,2514,26.24,1012,1119,1502
12.07.2019 07:00,2621,31.59,1010,1146,1611
12.07.2019 08:00,2834,33.66,1025,1173,1809
12.07.2019 09:00,2887,34.74,1041,1191,1846
12.07.2019 10:00,2891,36.06,1140,1220,1751
12.07.2019 11:00,3024,36.3,1119,1252,1905
12.07.2019 12:00,3018,36.5,1255,1277,1763
12.07.2019 13:00,2979,35.88,1287,1294,1692
12.07.2019 14:00,2945,35.57,1298,1273,1647
12.07.2019 15:00,3005,35.93,1289,1260,1716
12.07.2019 16:00,3111,38.03,1269,1240,1842
12.07.2019 17:00,3273,39.04,1240,1213,2033
12.07.2019 18:00,3339,40.3,1194,1179,2145
12.07.2019 19:00,3296,40.48,1145,1138,2151
12.07.2019 20:00,3273,39.01,1080,1086,2193
12.07.2019 21:00,3123,36.13,993,1028,2130
12.07.2019 22:00,2974,35.05,906,964,2068
12.07.2019 23:00,2836,34.56,849,868,1987
12.08.2019 00:00,2760,31.98,741,743,2019
12.08.2019 01:00,2652,25.65,613,647,2039
12.08.2019 02:00,2541,22.85,560,587,1981
12.08.2019 03:00,2493,22.25,524,558,1969
12.08.2019 04:00,2401,22.31,520,572,1881
12.08.2019 05:00,2388,22.68,617,689,1771
12.08.2019 06:00,2419,23.76,741,833,1678
12.08.2019 07:00,2527,28.48,880,976,1647
12.08.2019 08:00,2622,32.28,1015,1107,1607
12.08.2019 09:00,2748,34.14,1131,1226,1617
12.08.2019 10:00,2854,35.27,1213,1308,1641
12.08.2019 11:00,3069,35.97,1383,1381,1686
12.08.2019 12:00,3173,36.38,1409,1410,1764
12.08.2019 13:00,3178,35.75,1407,1417,1771
12.08.2019 14:00,3177,35.92,1421,1417,1756
12.08.2019 15:00,3129,35.52,1387,1378,1742
12.08.2019 16:00,3121,35.52,1354,1333,1767
12.08.2019 17:00,3224,37.45,1318,1292,1906
12.08.2019 18:00,3243,37.64,1290,1261,1953
12.08.2019 19:00,3262,36.95,1265,1232,1997
12.08.2019 20:00,3154,35.84,1245,1206,1909
12.08.2019 21:00,3043,34.89,1228,1210,1815
12.08.2019 22:00,2935,34.08,1228,1214,1707
12.08.2019 23:00,2749,32.6,1221,1205,1528
12.09.2019 00:00,2643,6.35,1207,1193,1436
12.09.2019 01:00,2626,4.32,1270,1279,1356
12.09.2019 02:00,2579,3.06,1244,1267,1335
12.09.2019 03:00,2591,1.72,1249,1259,1342
12.09.2019 04:00,2584,3.08,1244,1249,1340
12.09.2019 05:00,2656,15.82,1219,1235,1437
12.09.2019 06:00,2772,34.02,1217,1222,1555
12.09.2019 07:00,3130,36.37,1202,1206,1928
12.09.2019 08:00,3567,38.57,1195,1202,2372
12.09.2019 09:00,3692,39.99,1184,1194,2508
12.09.2019 10:00,3697,39.77,1195,1192,2502
12.09.2019 11:00,3740,39.58,1189,1191,2551
12.09.2019 12:00,3725,39.73,1186,1181,2539
12.09.2019 13:00,3671,39.91,1194,1167,2477
12.09.2019 14:00,3608,39.93,1122,1136,2486
12.09.2019 15:00,3622,39.97,1127,1085,2495
12.09.2019 16:00,3662,39.58,1056,1015,2606
12.09.2019 17:00,3687,40.17,985,944,2702
12.09.2019 18:00,3739,40.68,950,870,2789
12.09.2019 19:00,3566,39.22,929,803,2637
12.09.2019 20:00,3477,37.95,903,762,2574
12.09.2019 21:00,3269,36.94,919,729,2350
12.09.2019 22:00,3163,36.24,912,713,2251
12.09.2019 23:00,2998,35.04,962,750,2036
12.10.2019 00:00,2772,33.21,970,821,1802
12.10.2019 01:00,2763,30.39,1045,1033,1718
12.10.2019 02:00,2695,30.09,1077,1066,1618
12.10.2019 03:00,2749,30.56,1106,1100,1643
12.10.2019 04:00,2891,31.45,1070,1075,1821
12.10.2019 05:00,2981,33.95,965,960,2016
12.10.2019 06:00,3267,38.38,807,807,2460
12.10.2019 07:00,3677,43.24,643,647,3034
12.10.2019 08:00,4110,53.1,504,518,3606
12.10.2019 09:00,4089,56.38,401,412,3688
12.10.2019 10:00,4051,54.93,321,322,3730
12.10.2019 11:00,4107,51,253,238,3854
12.10.2019 12:00,3950,49.9,171,171,3779
12.10.2019 13:00,3886,47.34,112,128,3774
12.10.2019 14:00,3873,46.99,139,116,3734
12.10.2019 15:00,3824,46.87,139,134,3685
12.10.2019 16:00,3947,46.55,220,185,3727
12.10.2019 17:00,3997,45.41,295,256,3702
12.10.2019 18:00,4014,48.88,410,355,3604
12.10.2019 19:00,3892,39.92,566,481,3326
12.10.2019 20:00,3720,38.81,730,621,2990
12.10.2019 21:00,3537,37.7,871,768,2666
12.10.2019 22:00,3337,36.9,992,909,2345
12.10.2019 23:00,3169,35.28,1121,1026,2048
12.11.2019 00:00,2999,33,1198,1127,1801
12.11.2019 01:00,2892,23.55,1287,1286,1605
12.11.2019 02:00,2819,14.99,1336,1333,1483
12.11.2019 03:00,2791,4.33,1364,1361,1427
12.11.2019 04:00,2842,3.59,1381,1379,1461
12.11.2019 05:00,2889,20.57,1383,1384,1506
12.11.2019 06:00,3072,31.94,1372,1373,1700
12.11.2019 07:00,3451,35.68,1357,1356,2094
12.11.2019 08:00,3821,37.92,1319,1321,2502
12.11.2019 09:00,4003,39.97,1256,1253,2747
12.11.2019 10:00,4027,40.9,1140,1156,2887
12.11.2019 11:00,4162,39.56,968,1049,3194
12.11.2019 12:00,4150,43.02,821,924,3329
12.11.2019 13:00,4040,49.64,707,789,3333
12.11.2019 14:00,3999,51.82,586,666,3413
12.11.2019 15:00,3990,51.29,513,559,3477
12.11.2019 16:00,4012,51.79,458,470,3554
12.11.2019 17:00,4016,52.1,394,408,3622
12.11.2019 18:00,3996,58.28,341,363,3655
12.11.2019 19:00,3866,52.59,303,330,3563
12.11.2019 20:00,3766,39.21,279,299,3487
12.11.2019 21:00,3615,39,254,270,3361
12.11.2019 22:00,3415,38.63,236,245,3179
12.11.2019 23:00,3207,37.08,214,222,2993
12.12.2019 00:00,2992,35.72,197,200,2795
12.12.2019 01:00,2830,33.59,183,191,2647
12.12.2019 02:00,2775,34.97,165,174,2610
12.12.2019 03:00,2747,34.31,156,160,2591
12.12.2019 04:00,2741,34.65,150,146,2591
12.12.2019 05:00,2767,35.18,142,132,2625
12.12.2019 06:00,2955,36.98,143,127,2812
12.12.2019 07:00,3395,49,143,126,3252
12.12.2019 08:00,3746,56.33,138,129,3608
12.12.2019 09:00,3867,60.12,131,129,3736
12.12.2019 10:00,3845,58.65,130,132,3715
12.12.2019 11:00,3876,52.71,127,136,3749
12.12.2019 12:00,3866,49.69,140,138,3726
12.12.2019 13:00,3837,49,141,144,3696
12.12.2019 14:00,3833,47.01,166,152,3667
12.12.2019 15:00,3795,47.19,177,165,3618
12.12.2019 16:00,3858,48.88,225,189,3633
12.12.2019 17:00,3843,47.76,247,219,3596
12.12.2019 18:00,3906,52.13,293,252,3613
12.12.2019 19:00,3781,47.05,331,294,3450
12.12.2019 20:00,3653,40.18,391,335,3262
12.12.2019 21:00,3487,37.7,411,371,3076
12.12.2019 22:00,3366,36.91,401,404,2965
12.12.2019 23:00,3152,36.01,394,414,2758
13.12.2019 00:00,2941,34.61,398,411,2543
13.12.2019 01:00,2804,32.66,394,400,2410
13.12.2019 02:00,2767,31.48,423,431,2344
13.12.2019 03:00,2722,30.76,464,478,2258
13.12.2019 04:00,2751,30.69,505,533,2246
13.12.2019 05:00,2784,33.09,554,594,2230
13.12.2019 06:00,2972,35.49,612,651,2360
13.12.2019 07:00,3372,36.35,671,703,2701
13.12.2019 08:00,3784,37.95,727,742,3057
13.12.2019 09:00,3937,42.94,732,757,3205
13.12.2019 10:00,3898,39.71,719,765,3179
13.12.2019 11:00,3872,38.91,717,762,3155
13.12.2019 12:00,3843,38.51,655,748,3188
13.12.2019 13:00,3830,38.63,634,727,3196
13.12.2019 14:00,3842,38.55,636,700,3206
13.12.2019 15:00,3795,38.08,590,674,3205
13.12.2019 16:00,3873,38.64,566,651,3307
13.12.2019 17:00,3867,43.96,535,640,3332
13.12.2019 18:00,3801,49.66,549,633,3252
13.12.2019 19:00,3695,45.59,537,625,3158
13.12.2019 20:00,3532,38.51,511,592,3021
13.12.2019 21:00,3412,37.4,431,544,2981
13.12.2019 22:00,3281,36.51,371,492,2910
13.12.2019 23:00,3086,35.21,315,448,2771
14.12.2019 00:00,2874,33.96,304,411,2570
14.12.2019 01:00,2659,34.39,264,249,2395
14.12.2019 02:00,2577,32.62,251,243,2326
14.12.2019 03:00,2583,31.83,242,246,2341
14.12.2019 04:00,2614,31.05,254,264,2360
14.12.2019 05:00,2586,31.13,276,291,2310
14.12.2019 06:00,2597,31.77,325,311,2272
14.12.2019 07:00,2704,32.59,348,326,2356
14.12.2019 08:00,2862,33.31,355,331,2507
14.12.2019 09:00,3039,34.19,341,325,2698
14.12.2019 10:00,3170,35.26,337,322,2833
14.12.2019 11:00,3343,35.3,326,324,3017
14.12.2019 12:00,3408,35.06,339,334,3069
14.12.2019 13:00,3408,35.48,342,347,3066
14.12.2019 14:00,3397,35.49,333,368,3064
14.12.2019 15:00,3367,35.54,389,402,2978
14.12.2019 16:00,3381,36.02,458,455,2923
14.12.2019 17:00,3518,36.35,523,512,2995
14.12.2019 18:00,3522,36.65,586,568,2936
14.12.2019 19:00,3442,35.77,631,627,2811
14.12.2019 20:00,3295,34.93,690,684,2605
14.12.2019 21:00,3153,33.92,738,747,2415
14.12.2019 22:00,3018,33.14,778,815,2240
14.12.2019 23:00,2923,32.17,823,878,2100
15.12.2019 00:00,2798,29.61,883,926,1915
15.12.2019 01:00,2671,30.63,943,959,1728
15.12.2019 02:00,2602,30.16,983,1018,1619
15.12.2019 03:00,2557,30.04,1067,1078,1490
15.12.2019 04:00,2548,30.07,1096,1115,1452
15.12.2019 05:00,2548,30.38,1106,1117,1442
15.12.2019 06:00,2643,22.6,996,1087,1647
15.12.2019 07:00,2729,26.94,903,1023,1826
15.12.2019 08:00,2827,30.57,832,968,1995
15.12.2019 09:00,2995,31.68,890,923,2105
15.12.2019 10:00,3044,33.44,858,903,2186
15.12.2019 11:00,3158,34.28,868,934,2290
15.12.2019 12:00,3227,34.92,950,999,2277
15.12.2019 13:00,3282,34.88,1014,1067,2268
15.12.2019 14:00,3322,34.81,1082,1127,2240
15.12.2019 15:00,3373,34.71,1174,1200,2199
15.12.2019 16:00,3334,35.83,1243,1257,2091
15.12.2019 17:00,3474,36.71,1274,1290,2200
15.12.2019 18:00,3543,36.91,1291,1301,2252
15.12.2019 19:00,3529,36.26,1299,1307,2230
15.12.2019 20:00,3455,35.63,1318,1317,2137
15.12.2019 21:00,3347,34.79,1325,1308,2022
15.12.2019 22:00,3127,34.36,1308,1284,1819
15.12.2019 23:00,2919,34.04,1261,1241,1658
16.12.2019 00:00,2802,32.38,1237,1179,1565
16.12.2019 01:00,2702,32.87,1142,1258,1560
16.12.2019 02:00,2633,32.7,1151,1170,1482
16.12.2019 03:00,2610,32.75,1044,1071,1566
16.12.2019 04:00,2676,33.47,927,962,1749
16.12.2019 05:00,2718,35.13,836,862,1882
16.12.2019 06:00,2850,36.84,775,796,2075
16.12.2019 07:00,3252,38.87,729,757,2523
16.12.2019 08:00,3696,50.01,725,741,2971
16.12.2019 09:00,3764,44.43,744,732,3020
16.12.2019 10:00,3684,42,750,731,2934
16.12.2019 11:00,3710,41.2,783,743,2927
16.12.2019 12:00,3696,40.83,802,744,2894
16.12.2019 13:00,3637,41.1,801,735,2836
16.12.2019 14:00,3657,41.27,821,713,2836
16.12.2019 15:00,3616,41.41,820,683,2796
16.12.2019 16:00,3724,46.21,825,659,2899
16.12.2019 17:00,3767,48.8,807,641,2960
16.12.2019 18:00,3798,51.68,744,624,3054
16.12.2019 19:00,3690,50.71,681,615,3009
16.12.2019 20:00,3605,46.18,637,594,2968
16.12.2019 21:00,3447,40.17,605,563,2842
16.12.2019 22:00,3254,39.14,567,524,2687
16.12.2019 23:00,3014,37.86,508,468,2506
17.12.2019 00:00,2772,36.22,452,405,2320
17.12.2019 01:00,2597,35.68,405,400,2192
17.12.2019 02:00,2546,34.67,367,344,2179
17.12.2019 03:00,2545,34.66,311,289,2234
17.12.2019 04:00,2549,34.93,257,237,2292
17.12.2019 05:00,2596,36.06,201,194,2395
17.12.2019 06:00,2754,37.11,176,162,2578
17.12.2019 07:00,3158,37.94,137,141,3021
17.12.2019 08:00,3558,41.82,116,136,3442
17.12.2019 09:00,3727,48.31,131,139,3596
17.12.2019 10:00,3648,41.33,122,148,3526
17.12.2019 11:00,3651,40.15,135,151,3516
17.12.2019 12:00,3605,39.17,180,148,3425
17.12.2019 13:00,3527,38.88,187,149,3340
17.12.2019 14:00,3630,39.05,171,168,3459
17.12.2019 15:00,3602,39.6,196,203,3406
17.12.2019 16:00,3643,41.5,238,248,3405
17.12.2019 17:00,3688,41.55,290,303,3398
17.12.2019 18:00,3602,42.83,362,363,3240
17.12.2019 19:00,3492,38.79,462,435,3030
17.12.2019 20:00,3367,37.96,564,511,2803
17.12.2019 21:00,3194,37.21,678,591,2516
17.12.2019 22:00,2939,37.32,780,663,2159
17.12.2019 23:00,2819,36.93,779,712,2040
18.12.2019 00:00,2660,35.5,794,748,1866
18.12.2019 01:00,2610,33.93,938,957,1672
18.12.2019 02:00,2535,33.28,971,990,1564
18.12.2019 03:00,2409,32.94,1004,1057,1405
18.12.2019 04:00,2457,32.95,1053,1137,1404
18.12.2019 05:00,2418,34.16,1176,1208,1242
18.12.2019 06:00,2576,36.75,1253,1258,1323
18.12.2019 07:00,2936,37.61,1276,1273,1660
18.12.2019 08:00,3406,40.52,1252,1237,2154
18.12.2019 09:00,3602,46.32,1185,1124,2417
18.12.2019 10:00,3617,41.19,1037,987,2580
18.12.2019 11:00,3683,40.63,965,939,2718
18.12.2019 12:00,3600,40.18,967,952,2633
18.12.2019 13:00,3493,39.88,981,964,2512
18.12.2019 14:00,3457,39.8,952,952,2505
18.12.2019 15:00,3435,46.7,939,918,2496
18.12.2019 16:00,3582,46.75,878,872,2704
18.12.2019 17:00,3657,49.78,874,836,2783
18.12.2019 18:00,3600,52.89,845,809,2755
18.12.2019 19:00,3518,49.78,814,779,2704
18.12.2019 20:00,3534,43.04,780,730,2754
18.12.2019 21:00,3357,39.17,713,675,2644
18.12.2019 22:00,3237,38.05,644,620,2593
18.12.2019 23:00,3001,36.33,579,568,2422
19.12.2019 00:00,2726,33.78,526,513,2200
19.12.2019 01:00,2639,34.54,477,456,2162
19.12.2019 02:00,2639,34.3,395,380,2244
19.12.2019 03:00,2649,33.92,307,309,2342
19.12.2019 04:00,2701,34.37,252,252,2449
19.12.2019 05:00,2703,35.27,205,216,2498
19.12.2019 06:00,2905,36.39,172,197,2733
19.12.2019 07:00,3252,37.1,185,204,3067
19.12.2019 08:00,3641,40,228,249,3413
19.12.2019 09:00,3713,42.95,312,318,3401
19.12.2019 10:00,3636,39.62,417,392,3219
19.12.2019 11:00,3573,38.04,484,458,3089
19.12.2019 12:00,3461,37.69,559,520,2902
19.12.2019 13:00,3401,37.57,632,581,2769
19.12.2019 14:00,3359,37.67,702,639,2657
19.12.2019 15:00,3398,38.01,730,700,2668
19.12.2019 16:00,3521,38.72,797,761,2724
19.12.2019 17:00,3641,39.49,793,786,2848
19.12.2019 18:00,3609,39.36,790,783,2819
19.12.2019 19:00,3517,38.95,782,780,2735
19.12.2019 20:00,3498,37.96,779,769,2719
19.12.2019 21:00,3334,36.93,752,747,2582
19.12.2019 22:00,3139,35.95,722,717,2417
19.12.2019 23:00,2926,34.14,680,685,2246
20.12.2019 00:00,2778,32.83,651,659,2127
20.12.2019 01:00,2719,32.33,624,621,2095
20.12.2019 02:00,2618,32.25,589,583,2029
20.12.2019 03:00,2541,32.26,563,552,1978
20.12.2019 04:00,2526,31.94,509,516,2017
20.12.2019 05:00,2563,33.8,440,478,2123
20.12.2019 06:00,2680,35.99,429,437,2251
20.12.2019 07:00,2977,36.68,415,401,2562
20.12.2019 08:00,3379,37.56,390,375,2989
20.12.2019 09:00,3547,38.13,369,354,3178
20.12.2019 10:00,3491,38.05,368,336,3123
20.12.2019 11:00,3466,37.94,337,319,3129
20.12.2019 12:00,3493,37.94,300,300,3193
20.12.2019 13:00,3466,37.77,291,284,3175
20.12.2019 14:00,3398,37.59,294,291,3104
20.12.2019 15:00,3359,37.49,312,319,3047
20.12.2019 16:00,3435,37.42,334,368,3101
20.12.2019 17:00,3486,37.46,409,426,3077
20.12.2019 18:00,3428,37.45,484,483,2944
20.12.2019 19:00,3347,37.48,511,524,2836
20.12.2019 20:00,3235,37,501,525,2734
20.12.2019 21:00,2979,36.16,495,499,2484
20.12.2019 22:00,2818,35.78,458,466,2360
20.12.2019 23:00,2709,34.38,405,425,2304
21.12.2019 00:00,2596,32.69,357,384,2239
21.12.2019 01:00,2451,27.4,322,314,2129
21.12.2019 02:00,2350,29.08,272,266,2078
21.12.2019 03:00,2277,29.03,229,225,2048
21.12.2019 04:00,2282,30.83,189,191,2093
21.12.2019 05:00,2273,31.67,165,168,2108
21.12.2019 06:00,2279,31.26,144,158,2135
21.12.2019 07:00,2328,33.01,145,161,2183
21.12.2019 08:00,2472,33.93,167,173,2305
21.12.2019 09:00,2659,34.69,181,190,2478
21.12.2019 10:00,2784,35.9,197,206,2587
21.12.2019 11:00,2873,36,203,208,2670
21.12.2019 12:00,2888,36.32,193,202,2695
21.12.2019 13:00,2917,36.23,179,195,2738
21.12.2019 14:00,2902,36.16,185,188,2717
21.12.2019 15:00,2883,36.78,182,181,2701
21.12.2019 16:00,2944,37.43,168,176,2776
21.12.2019 17:00,3162,38.17,181,172,2981
21.12.2019 18:00,3222,38.29,158,169,3064
21.12.2019 19:00,3113,37.76,158,171,2955
21.12.2019 20:00,2929,36.92,155,172,2774
21.12.2019 21:00,2813,35.9,153,170,2660
21.12.2019 22:00,2721,35.66,142,168,2579
21.12.2019 23:00,2618,35.11,124,152,2494
22.12.2019 00:00,2520,34.2,122,131,2398
22.12.2019 01:00,2381,33.76,127,129,2254
22.12.2019 02:00,2261,33.61,133,140,2128
22.12.2019 03:00,2200,33.34,147,156,2053
22.12.2019 04:00,2209,33.18,172,175,2037
22.12.2019 05:00,2191,33.08,202,193,1989
22.12.2019 06:00,2208,32.61,198,207,2010
22.12.2019 07:00,2295,33.26,205,217,2090
22.12.2019 08:00,2422,33.77,213,224,2209
22.12.2019 09:00,2555,35.02,237,228,2318
22.12.2019 10:00,2726,36.22,249,234,2477
22.12.2019 11:00,2896,37.15,232,238,2664
22.12.2019 12:00,3001,37.6,235,242,2766
22.12.2019 13:00,3059,37.54,251,244,2808
22.12.2019 14:00,2996,37.08,283,250,2713
22.12.2019 15:00,2967,37.33,297,259,2670
22.12.2019 16:00,3062,37.65,286,273,2776
22.12.2019 17:00,3195,38.44,310,282,2885
22.12.2019 18:00,3229,38.8,342,287,2887
22.12.2019 19:00,3148,38.28,344,290,2804
22.12.2019 20:00,3006,37.4,348,284,2658
22.12.2019 21:00,2854,35.96,339,276,2515
22.12.2019 22:00,2757,35.44,314,265,2443
22.12.2019 23:00,2611,34.83,296,245,2315
23.12.2019 00:00,2443,33.79,288,223,2155
23.12.2019 01:00,2361,29.62,326,296,2035
23.12.2019 02:00,2327,30.81,295,286,2032
23.12.2019 03:00,2297,30,286,276,2011
23.12.2019 04:00,2220,31.04,284,268,1936
23.12.2019 05:00,2223,33.61,275,261,1948
23.12.2019 06:00,2319,35.8,292,252,2027
23.12.2019 07:00,2509,36.16,291,246,2218
23.12.2019 08:00,2757,36.63,276,237,2481
23.12.2019 09:00,2952,37.33,255,227,2697
23.12.2019 10:00,3026,37.56,241,214,2785
23.12.2019 11:00,3068,37.4,223,193,2845
23.12.2019 12:00,3113,37.3,189,168,2924
23.12.2019 13:00,3109,37.13,154,147,2955
23.12.2019 14:00,3119,37.04,138,134,2981
23.12.2019 15:00,3146,37.09,127,128,3019
23.12.2019 16:00,3188,37.51,127,125,3061
23.12.2019 17:00,3264,37.97,138,127,3126
23.12.2019 18:00,3292,39.21,151,133,3141
23.12.2019 19:00,3178,39.95,165,143,3013
23.12.2019 20:00,2994,37.96,167,144,2827
23.12.2019 21:00,2832,36.93,167,149,2665
23.12.2019 22:00,2668,36.36,162,160,2506
23.12.2019 23:00,2517,35.64,171,171,2346
24.12.2019 00:00,2412,33.91,199,184,2213
24.12.2019 01:00,2284,33.8,235,242,2049
24.12.2019 02:00,2214,33.36,228,241,1986
24.12.2019 03:00,2175,32.32,205,230,1970
24.12.2019 04:00,2139,31.68,171,218,1968
24.12.2019 05:00,2188,32.5,182,208,2006
24.12.2019 06:00,2218,34.27,174,200,2044
24.12.2019 07:00,2320,35.14,162,192,2158
24.12.2019 08:00,2458,35.24,166,188,2292
24.12.2019 09:00,2641,36.39,161,186,2480
24.12.2019 10:00,2756,37,176,190,2580
24.12.2019 11:00,2828,36.63,180,201,2648
24.12.2019 12:00,2889,37,198,213,2691
24.12.2019 13:00,2879,37.11,212,223,2667
24.12.2019 14:00,2822,37.18,195,207,2627
24.12.2019 15:00,2776,37.13,172,185,2604
24.12.2019 16:00,2811,37.51,147,167,2664
24.12.2019 17:00,2882,38.27,136,155,2746
24.12.2019 18:00,2839,39.04,126,144,2713
24.12.2019 19:00,2713,37.41,122,136,2591
24.12.2019 20:00,2597,36.04,114,127,2483
24.12.2019 21:00,2538,35.41,106,120,2432
24.12.2019 22:00,2492,35.54,96,116,2396
24.12.2019 23:00,2467,35.49,88,111,2379
25.12.2019 00:00,2393,34.55,84,111,2309
25.12.2019 01:00,2294,33.69,65,70,2229
25.12.2019 02:00,2238,33.07,65,69,2173
25.12.2019 03:00,2200,32.23,61,63,2139
25.12.2019 04:00,2196,32.02,59,62,2137
25.12.2019 05:00,2210,32.94,60,61,2150
25.12.2019 06:00,2261,34.5,59,62,2202
25.12.2019 07:00,2369,34.67,61,66,2308
25.12.2019 08:00,2476,34.85,63,70,2413
25.12.2019 09:00,2558,35.71,65,75,2493
25.12.2019 10:00,2633,36.02,78,81,2555
25.12.2019 11:00,2712,35.52,79,92,2633
25.12.2019 12:00,2786,35.69,88,107,2698
25.12.2019 13:00,2828,36.29,98,123,2730
25.12.2019 14:00,2837,36.19,112,138,2725
25.12.2019 15:00,2818,36.14,127,153,2691
25.12.2019 16:00,2863,36.44,151,170,2712
25.12.2019 17:00,2969,37.19,163,179,2806
25.12.2019 18:00,2987,37.37,164,179,2823
25.12.2019 19:00,2976,37.35,162,184,2814
25.12.2019 20:00,2850,36.33,152,185,2698
25.12.2019 21:00,2766,34.85,147,189,2619
25.12.2019 22:00,2696,34.63,163,196,2533
25.12.2019 23:00,2604,34.29,171,198,2433
26.12.2019 00:00,2498,32.75,178,198,2320
26.12.2019 01:00,2378,33.44,174,175,2204
26.12.2019 02:00,2324,32.93,175,168,2149
26.12.2019 03:00,2289,31.87,164,159,2125
26.12.2019 04:00,2295,31.56,151,149,2144
26.12.2019 05:00,2336,32.01,133,136,2203
26.12.2019 06:00,2396,33.87,122,125,2274
26.12.2019 07:00,2503,34.39,116,120,2387
26.12.2019 08:00,2634,35.32,115,119,2519
26.12.2019 09:00,2737,35.87,118,121,2619
26.12.2019 10:00,2891,36.34,132,127,2759
26.12.2019 11:00,2982,36.19,138,131,2844
26.12.2019 12:00,3040,36.59,129,129,2911
26.12.2019 13:00,3091,36.67,120,125,2971
26.12.2019 14:00,3086,36.68,119,119,2967
26.12.2019 15:00,3100,37.3,122,110,2978
26.12.2019 16:00,3181,38.53,125,108,3056
26.12.2019 17:00,3315,39.67,128,113,3187
26.12.2019 18:00,3352,41.53,122,114,3230
26.12.2019 19:00,3257,41.62,133,113,3124
26.12.2019 20:00,3192,38.9,140,112,3052
26.12.2019 21:00,3095,37.24,130,116,2965
26.12.2019 22:00,2979,36.78,126,121,2853
26.12.2019 23:00,2827,36.45,144,127,2683
27.12.2019 00:00,2674,34.75,166,134,2508
27.12.2019 01:00,2582,33.11,196,198,2386
27.12.2019 02:00,2503,32.93,200,204,2303
27.12.2019 03:00,2462,32,216,209,2246
27.12.2019 04:00,2466,32.19,225,219,2241
27.12.2019 05:00,2521,33.14,263,238,2258
27.12.2019 06:00,2618,35.58,281,260,2337
27.12.2019 07:00,2893,36.12,288,278,2605
27.12.2019 08:00,3211,37.58,316,297,2895
27.12.2019 09:00,3365,38.55,311,309,3054
27.12.2019 10:00,3392,39.3,312,317,3080
27.12.2019 11:00,3413,39.05,322,320,3091
27.12.2019 12:00,3412,39.59,329,316,3083
27.12.2019 13:00,3329,40.15,320,312,3009
27.12.2019 14:00,3308,40.41,300,310,3008
27.12.2019 15:00,3329,42.05,300,307,3029
27.12.2019 16:00,3418,45.13,302,312,3116
27.12.2019 17:00,3538,46.53,305,321,3233
27.12.2019 18:00,3585,49.38,321,325,3264
27.12.2019 19:00,3568,44.88,320,323,3248
27.12.2019 20:00,3491,40.55,302,318,3189
27.12.2019 21:00,3384,38.22,301,313,3083
27.12.2019 22:00,3191,36.67,305,304,2886
27.12.2019 23:00,3041,35.75,279,281,2762
28.12.2019 00:00,2945,34.49,252,253,2693
28.12.2019 01:00,2858,33.48,212,227,2646
28.12.2019 02:00,2802,32.32,194,203,2608
28.12.2019 03:00,2785,31.08,178,184,2607
28.12.2019 04:00,2817,30.82,171,162,2646
28.12.2019 05:00,2841,30.53,152,142,2689
28.12.2019 06:00,2885,30.46,140,128,2745
28.12.2019 07:00,2992,31.6,119,117,2873
28.12.2019 08:00,3167,32.99,99,100,3068
28.12.2019 09:00,3298,34.61,81,83,3217
28.12.2019 10:00,3445,35.45,74,73,3371
28.12.2019 11:00,3517,35.61,67,66,3450
28.12.2019 12:00,3485,35.05,51,56,3434
28.12.2019 13:00,3468,34.7,40,45,3428
28.12.2019 14:00,3419,34.61,33,43,3386
28.12.2019 15:00,3411,34.94,43,50,3368
28.12.2019 16:00,3536,35.83,58,69,3478
28.12.2019 17:00,3721,37.73,72,95,3649
28.12.2019 18:00,3771,36.71,93,127,3678
28.12.2019 19:00,3705,36.26,128,165,3577
28.12.2019 20:00,3549,35.55,150,198,3399
28.12.2019 21:00,3402,34.97,184,228,3218
28.12.2019 22:00,3228,34.54,231,261,2997
28.12.2019 23:00,3134,33.6,270,298,2864
29.12.2019 00:00,2957,31.32,316,341,2641
29.12.2019 01:00,2815,30.6,369,353,2446
29.12.2019 02:00,2738,28.1,406,399,2332
29.12.2019 03:00,2673,26.92,461,455,2212
29.12.2019 04:00,2607,22.85,517,512,2090
29.12.2019 05:00,2647,20.97,564,555,2083
29.12.2019 06:00,2697,21.31,611,587,2086
29.12.2019 07:00,2737,22.72,631,620,2106
29.12.2019 08:00,2848,25.1,670,655,2178
29.12.2019 09:00,2915,27.52,700,693,2215
29.12.2019 10:00,3075,30.04,738,724,2337
29.12.2019 11:00,3142,30.6,752,757,2390
29.12.2019 12:00,3213,30.93,796,785,2417
29.12.2019 13:00,3231,32.03,839,805,2392
29.12.2019 14:00,3210,30.61,835,810,2375
29.12.2019 15:00,3255,30.8,844,818,2411
29.12.2019 16:00,3357,32.86,853,833,2504
29.12.2019 17:00,3504,33.74,873,864,2631
29.12.2019 18:00,3533,33.99,901,909,2632
29.12.2019 19:00,3471,33.35,956,964,2515
29.12.2019 20:00,3371,32.54,1005,1019,2366
29.12.2019 21:00,3243,30.79,1035,1072,2208
29.12.2019 22:00,3127,30.02,1118,1116,2009
29.12.2019 23:00,3038,25.56,1129,1140,1909
30.12.2019 00:00,2905,20.86,1133,1143,1772
30.12.2019 01:00,2800,11.07,1162,1191,1638
30.12.2019 02:00,2715,11.84,1151,1186,1564
30.12.2019 03:00,2625,6.16,1136,1164,1489
30.12.2019 04:00,2582,1.4,1147,1140,1435
30.12.2019 05:00,2618,4.81,1124,1125,1494
30.12.2019 06:00,2710,16.43,1119,1117,1591
30.12.2019 07:00,2896,26.9,1105,1118,1791
30.12.2019 08:00,3139,30.38,1109,1138,2030
30.12.2019 09:00,3257,32.04,1124,1159,2133
30.12.2019 10:00,3319,31.9,1124,1174,2195
30.12.2019 11:00,3335,29.06,1144,1182,2191
30.12.2019 12:00,3389,29.55,1128,1180,2261
30.12.2019 13:00,3409,30.3,1107,1174,2302
30.12.2019 14:00,3346,30.61,1121,1164,2225
30.12.2019 15:00,3338,31.63,1115,1157,2223
30.12.2019 16:00,3411,33.52,1125,1156,2286
30.12.2019 17:00,3450,34.4,1156,1161,2294
30.12.2019 18:00,3495,34.6,1172,1170,2323
30.12.2019 19:00,3439,34.43,1175,1174,2264
30.12.2019 20:00,3192,31.58,1216,1189,1976
30.12.2019 21:00,3004,30.68,1240,1207,1764
30.12.2019 22:00,2870,29.67,1250,1221,1620
30.12.2019 23:00,2706,28.96,1270,1235,1436
31.12.2019 00:00,2576,24.33,1284,1253,1292
31.12.2019 01:00,2498,23.04,1292,1311,1206
31.12.2019 02:00,2436,21.59,1302,1326,1134
31.12.2019 03:00,2394,12.84,1329,1340,1065
31.12.2019 04:00,2361,4.97,1333,1349,1028
31.12.2019 05:00,2359,9.81,1349,1350,1010
31.12.2019 06:00,2425,18.37,1340,1345,1085
31.12.2019 07:00,2538,23.5,1327,1326,1211
31.12.2019 08:00,2639,27.17,1288,1293,1351
31.12.2019 09:00,2784,30.82,1225,1241,1559
31.12.2019 10:00,2976,32.28,1142,1179,1834
31.12.2019 11:00,2966,31.45,1066,1115,1900
31.12.2019 12:00,2907,31.95,922,1045,1985
31.12.2019 13:00,2894,33.14,854,963,2040
31.12.2019 14:00,2825,33.38,796,880,2029
31.12.2019 15:00,2936,33.74,711,788,2225
31.12.2019 16:00,3161,34.33,634,707,2527
31.12.2019 17:00,3364,35.01,570,635,2794
31.12.2019 18:00,3335,35.98,494,562,2841
31.12.2019 19:00,3228,35.48,435,497,2793
31.12.2019 20:00,3109,32.37,418,453,2691
31.12.2019 21:00,2899,31.23,406,424,2493
31.12.2019 22:00,2859,31.33,400,415,2459
31.12.2019 23:00,2863,31.46,453,441,2410
01.01.2020 00:00,2780,30.83,485,478,2295
