CET_TimeStamp,Actual_Total_Load,Day_Ahead_Price,Wind_Onshore_Gen_Actual,Wind_Onshore_generation_forecast,Residual_load
01.01.2016 01:00,2707,16.39,206,257,2501
01.01.2016 02:00,2624,16.04,185,241,2439
01.01.2016 03:00,2543,15.74,175,222,2368
01.01.2016 04:00,2480,15.57,171,201,2309
01.01.2016 05:00,2467,15.47,158,184,2309
01.01.2016 06:00,2517,15.75,124,172,2393
01.01.2016 07:00,2605,15.36,95,160,2510
01.01.2016 08:00,2636,15.37,99,149,2537
01.01.2016 09:00,2646,15.19,136,141,2510
01.01.2016 10:00,2657,15.39,161,138,2496
01.01.2016 11:00,2733,15.78,199,133,2534
01.01.2016 12:00,2825,16.15,181,124,2644
01.01.2016 13:00,2899,16.5,147,125,2752
01.01.2016 14:00,2944,16.72,135,129,2809
01.01.2016 15:00,2967,17.17,143,132,2824
01.01.2016 16:00,3059,18,173,135,2886
01.01.2016 17:00,3212,18.53,195,147,3017
01.01.2016 18:00,3256,19.11,225,163,3031
01.01.2016 19:00,3192,18.68,267,193,2925
01.01.2016 20:00,3034,17.93,375,230,2659
01.01.2016 21:00,2963,17.69,394,275,2569
01.01.2016 22:00,2874,17.33,424,337,2450
01.01.2016 23:00,2792,16.75,426,399,2366
01.02.2016 00:00,2684,16.25,495,440,2189
01.02.2016 01:00,2421,16.47,676,476,1745
01.02.2016 02:00,2356,15.89,742,523,1614
01.02.2016 03:00,2360,15.03,818,617,1542
01.02.2016 04:00,2369,13.19,892,693,1477
01.02.2016 05:00,2459,12.69,926,771,1533
01.02.2016 06:00,2580,12.94,954,838,1626
01.02.2016 07:00,2696,13.59,1023,903,1673
01.02.2016 08:00,2817,14.25,1077,949,1740
01.02.2016 09:00,3005,15.7,1090,999,1915
01.02.2016 10:00,3174,15.72,1102,1020,2072
01.02.2016 11:00,3435,15.97,1071,1031,2364
01.02.2016 12:00,3491,16.14,1060,1039,2431
01.02.2016 13:00,3589,15.87,1027,1053,2562
01.02.2016 14:00,3596,15.98,1015,1050,2581
01.02.2016 15:00,3611,16.12,1017,1056,2594
01.02.2016 16:00,3705,16.57,1009,1048,2696
01.02.2016 17:00,3853,17.29,1034,1036,2819
01.02.2016 18:00,3857,17.52,1076,1045,2781
01.02.2016 19:00,3825,17.37,1093,1051,2732
01.02.2016 20:00,3700,16.95,1074,1046,2626
01.02.2016 21:00,3613,16.56,1045,1033,2568
01.02.2016 22:00,3468,15.83,1030,1018,2438
01.02.2016 23:00,3355,15.82,1004,993,2351
01.03.2016 00:00,3213,15.31,1000,971,2213
01.03.2016 01:00,3088,15.99,993,944,2095
01.03.2016 02:00,3023,15.87,956,924,2067
01.03.2016 03:00,3011,15.76,931,910,2080
01.03.2016 04:00,2996,15.59,912,882,2084
01.03.2016 05:00,3015,15.69,876,839,2139
01.03.2016 06:00,3099,15.83,822,808,2277
01.03.2016 07:00,3174,14.98,783,777,2391
01.03.2016 08:00,3267,15.53,757,744,2510
01.03.2016 09:00,3323,15.79,754,712,2569
01.03.2016 10:00,3418,16.36,735,706,2683
01.03.2016 11:00,3543,17.15,735,704,2808
01.03.2016 12:00,3608,17.94,747,714,2861
01.03.2016 13:00,3604,17.94,762,720,2842
01.03.2016 14:00,3617,17.66,740,710,2877
01.03.2016 15:00,3636,17.66,711,691,2925
01.03.2016 16:00,3677,17.6,711,661,2966
01.03.2016 17:00,3865,18.61,697,631,3168
01.03.2016 18:00,3948,19.11,702,613,3246
01.03.2016 19:00,3926,18.86,667,601,3259
01.03.2016 20:00,3832,18.51,641,581,3191
01.03.2016 21:00,3716,18.08,612,562,3104
01.03.2016 22:00,3576,17.72,594,545,2982
01.03.2016 23:00,3403,17.03,595,536,2808
01.04.2016 00:00,3263,15.74,591,528,2672
01.04.2016 01:00,3215,15.96,587,567,2628
01.04.2016 02:00,3195,15.81,564,584,2631
01.04.2016 03:00,3168,15.56,606,607,2562
01.04.2016 04:00,3192,15.57,620,629,2572
01.04.2016 05:00,3257,15.92,621,634,2636
01.04.2016 06:00,3409,16.76,638,657,2771
01.04.2016 07:00,3769,18.01,623,682,3146
01.04.2016 08:00,4133,19.54,620,695,3513
01.04.2016 09:00,4227,20.49,643,703,3584
01.04.2016 10:00,4254,20.49,666,713,3588
01.04.2016 11:00,4287,20.47,695,735,3592
01.04.2016 12:00,4218,20.14,763,766,3455
01.04.2016 13:00,4108,19.85,793,801,3315
01.04.2016 14:00,4106,19.83,768,830,3338
01.04.2016 15:00,4142,19.88,732,835,3410
01.04.2016 16:00,4288,20.09,662,830,3626
01.04.2016 17:00,4426,22.06,615,762,3811
01.04.2016 18:00,4392,28.48,659,739,3733
01.04.2016 19:00,4292,20.54,674,754,3618
01.04.2016 20:00,4201,19.77,679,771,3522
01.04.2016 21:00,4012,19.05,695,764,3317
01.04.2016 22:00,3860,18.5,644,747,3216
01.04.2016 23:00,3638,17.71,660,737,2978
01.05.2016 00:00,3433,17.03,656,721,2777
01.05.2016 01:00,3252,17.68,612,612,2640
01.05.2016 02:00,3236,17.33,560,601,2676
01.05.2016 03:00,3220,17.24,555,596,2665
01.05.2016 04:00,3226,17.32,540,592,2686
01.05.2016 05:00,3254,17.66,518,559,2736
01.05.2016 06:00,3494,17.92,442,559,3052
01.05.2016 07:00,3810,18.8,464,565,3346
01.05.2016 08:00,4076,20.51,499,565,3577
01.05.2016 09:00,4246,22.58,481,549,3765
01.05.2016 10:00,4296,23.13,492,560,3804
01.05.2016 11:00,4396,23.21,417,563,3979
01.05.2016 12:00,4345,21.91,406,550,3939
01.05.2016 13:00,4242,21.29,401,508,3841
01.05.2016 14:00,4181,20.98,387,466,3794
01.05.2016 15:00,4183,21.03,387,476,3796
01.05.2016 16:00,4259,23.17,382,447,3877
01.05.2016 17:00,4369,30.98,469,468,3900
01.05.2016 18:00,4427,34.63,488,473,3939
01.05.2016 19:00,4330,24.18,535,504,3795
01.05.2016 20:00,4222,20.83,575,531,3647
01.05.2016 21:00,4176,19.89,494,532,3682
01.05.2016 22:00,4016,19.39,466,515,3550
01.05.2016 23:00,3868,18.73,483,526,3385
01.06.2016 00:00,3638,17.97,528,510,3110
01.06.2016 01:00,3461,20.02,567,480,2894
01.06.2016 02:00,3356,19.63,575,485,2781
01.06.2016 03:00,3388,19.33,550,492,2838
01.06.2016 04:00,3376,19.35,586,496,2790
01.06.2016 05:00,3389,19.51,588,501,2801
01.06.2016 06:00,3454,19.81,599,501,2855
01.06.2016 07:00,3579,20.5,588,508,2991
01.06.2016 08:00,3759,22.06,550,506,3209
01.06.2016 09:00,3880,25.19,548,487,3332
01.06.2016 10:00,3996,28.24,512,520,3484
01.06.2016 11:00,4040,34.97,491,493,3549
01.06.2016 12:00,4140,37.95,435,525,3705
01.06.2016 13:00,4103,37.37,430,516,3673
01.06.2016 14:00,4002,36.61,443,504,3559
01.06.2016 15:00,4039,29.75,477,506,3562
01.06.2016 16:00,4081,36.04,519,516,3562
01.06.2016 17:00,4208,41.28,589,533,3619
01.06.2016 18:00,4223,44.95,607,557,3616
01.06.2016 19:00,4171,46.46,577,577,3594
01.06.2016 20:00,4122,42.89,612,577,3510
01.06.2016 21:00,4009,24.87,602,559,3407
01.06.2016 22:00,3866,22.06,582,548,3284
01.06.2016 23:00,3761,20.47,551,528,3210
01.07.2016 00:00,3640,19.37,531,513,3109
01.07.2016 01:00,3558,22.61,530,507,3028
01.07.2016 02:00,3451,21.75,571,496,2880
01.07.2016 03:00,3422,21.5,585,477,2837
01.07.2016 04:00,3438,21.52,575,468,2863
01.07.2016 05:00,3493,21.83,560,464,2933
01.07.2016 06:00,3595,24.2,541,454,3054
01.07.2016 07:00,4040,27.07,472,454,3568
01.07.2016 08:00,4420,72.26,402,458,4018
01.07.2016 09:00,4631,99.93,321,498,4310
01.07.2016 10:00,4640,79.6,334,521,4306
01.07.2016 11:00,4649,74.91,364,544,4285
01.07.2016 12:00,4537,61.37,441,564,4096
01.07.2016 13:00,4514,59.91,497,623,4017
01.07.2016 14:00,4501,61.85,524,695,3977
01.07.2016 15:00,4442,59.69,542,728,3900
01.07.2016 16:00,4522,65.42,601,775,3921
01.07.2016 17:00,4510,99.94,677,820,3833
01.07.2016 18:00,4438,97.59,794,856,3644
01.07.2016 19:00,4293,69.93,888,878,3405
01.07.2016 20:00,4172,37.19,961,925,3211
01.07.2016 21:00,4045,31.94,998,956,3047
01.07.2016 22:00,3875,25.87,979,974,2896
01.07.2016 23:00,3671,21.55,997,977,2674
01.08.2016 00:00,3448,20.26,999,985,2449
01.08.2016 01:00,3324,21.06,994,1031,2330
01.08.2016 02:00,3249,20.16,982,1031,2267
01.08.2016 03:00,3314,19.78,1006,1061,2308
01.08.2016 04:00,3225,19.86,1017,1083,2208
01.08.2016 05:00,3257,20.17,1029,1083,2228
01.08.2016 06:00,3374,20.73,1056,1084,2318
01.08.2016 07:00,3754,22.02,1034,1066,2720
01.08.2016 08:00,4091,29.91,1040,1051,3051
01.08.2016 09:00,4149,43.16,1042,1007,3107
01.08.2016 10:00,4154,43.71,980,966,3174
01.08.2016 11:00,4281,43.43,913,908,3368
01.08.2016 12:00,4203,36.95,850,840,3353
01.08.2016 13:00,4175,32.27,792,798,3383
01.08.2016 14:00,4101,26.78,766,754,3335
01.08.2016 15:00,4027,27.6,686,670,3341
01.08.2016 16:00,4022,32.08,615,602,3407
01.08.2016 17:00,4100,38.07,561,540,3539
01.08.2016 18:00,4126,46.16,494,497,3632
01.08.2016 19:00,3922,46.97,450,427,3472
01.08.2016 20:00,3766,40.09,379,373,3387
01.08.2016 21:00,3608,28.57,338,350,3270
01.08.2016 22:00,3470,25.09,306,340,3164
01.08.2016 23:00,3342,24.32,257,292,3085
01.09.2016 00:00,3196,22.66,228,256,2968
01.09.2016 01:00,3116,24.51,213,220,2903
01.09.2016 02:00,3053,23.44,188,211,2865
01.09.2016 03:00,3032,22.79,162,208,2870
01.09.2016 04:00,3009,22.49,142,178,2867
01.09.2016 05:00,3029,21.96,109,169,2920
01.09.2016 06:00,3079,22.25,102,166,2977
01.09.2016 07:00,3188,22.39,105,167,3083
01.09.2016 08:00,3347,22.97,115,164,3232
01.09.2016 09:00,3435,23.95,118,151,3317
01.09.2016 10:00,3499,24.7,140,175,3359
01.09.2016 11:00,3555,26.49,165,188,3390
01.09.2016 12:00,3543,26.93,191,191,3352
01.09.2016 13:00,3491,26.32,235,207,3256
01.09.2016 14:00,3535,25.32,239,219,3296
01.09.2016 15:00,3556,24.85,258,245,3298
01.09.2016 16:00,3563,26.13,266,278,3297
01.09.2016 17:00,3722,29.77,325,305,3397
01.09.2016 18:00,3717,36.1,389,335,3328
01.09.2016 19:00,3629,27.87,462,378,3167
01.09.2016 20:00,3502,24.63,490,405,3012
01.09.2016 21:00,3372,23.13,522,447,2850
01.09.2016 22:00,3252,22.57,537,477,2715
01.09.2016 23:00,3225,22.07,500,515,2725
01.10.2016 00:00,3033,21.26,524,549,2509
01.10.2016 01:00,2946,21.32,598,645,2348
01.10.2016 02:00,2818,19.93,681,671,2137
01.10.2016 03:00,2743,19.65,721,697,2022
01.10.2016 04:00,2694,19.43,788,720,1906
01.10.2016 05:00,2660,19.25,837,741,1823
01.10.2016 06:00,2693,19.39,872,768,1821
01.10.2016 07:00,2778,19.33,892,791,1886
01.10.2016 08:00,2878,19.57,929,821,1949
01.10.2016 09:00,2974,19.49,964,837,2010
01.10.2016 10:00,3099,20.15,976,858,2123
01.10.2016 11:00,3245,20.95,973,877,2272
01.10.2016 12:00,3330,21.59,981,891,2349
01.10.2016 13:00,3475,21.83,933,914,2542
01.10.2016 14:00,3518,21.33,900,914,2618
01.10.2016 15:00,3482,21.22,905,912,2577
01.10.2016 16:00,3547,21.98,890,891,2657
01.10.2016 17:00,3705,23.92,874,841,2831
01.10.2016 18:00,3826,25.76,754,784,3072
01.10.2016 19:00,3853,24.92,614,722,3239
01.10.2016 20:00,3825,24.34,466,624,3359
01.10.2016 21:00,3676,23.79,408,540,3268
01.10.2016 22:00,3441,23.04,379,452,3062
01.10.2016 23:00,3184,22.34,386,398,2798
01.11.2016 00:00,3001,21.69,348,361,2653
01.11.2016 01:00,2886,21.37,324,343,2562
01.11.2016 02:00,2808,20.04,298,320,2510
01.11.2016 03:00,2797,19.78,245,288,2552
01.11.2016 04:00,2813,19.36,234,269,2579
01.11.2016 05:00,2790,19.68,288,253,2502
01.11.2016 06:00,2929,21.56,337,233,2592
01.11.2016 07:00,3363,24.24,324,221,3039
01.11.2016 08:00,3831,40.62,274,204,3557
01.11.2016 09:00,3978,45.93,241,210,3737
01.11.2016 10:00,3968,44,198,193,3770
01.11.2016 11:00,4038,41.94,147,169,3891
01.11.2016 12:00,4067,40.96,108,156,3959
01.11.2016 13:00,4064,41.31,76,142,3988
01.11.2016 14:00,4084,41.09,45,126,4039
01.11.2016 15:00,4030,38.92,35,109,3995
01.11.2016 16:00,4030,37.5,25,83,4005
01.11.2016 17:00,4091,37.95,37,111,4054
01.11.2016 18:00,4098,44.69,63,118,4035
01.11.2016 19:00,3999,42.88,73,113,3926
01.11.2016 20:00,3897,39.04,84,114,3813
01.11.2016 21:00,3698,32.3,112,116,3586
01.11.2016 22:00,3531,25.45,105,127,3426
01.11.2016 23:00,3327,23.05,98,123,3229
01.12.2016 00:00,3215,21.68,89,115,3126
01.12.2016 01:00,2961,21.11,67,111,2894
01.12.2016 02:00,2890,19.81,67,104,2823
01.12.2016 03:00,2846,19.1,74,102,2772
01.12.2016 04:00,2843,18.41,84,107,2759
01.12.2016 05:00,2886,19,80,116,2806
01.12.2016 06:00,3059,20.91,81,129,2978
01.12.2016 07:00,3474,22.93,81,141,3393
01.12.2016 08:00,3931,35.06,75,147,3856
01.12.2016 09:00,3937,39.53,96,142,3841
01.12.2016 10:00,3943,41,74,145,3869
01.12.2016 11:00,4044,38.66,53,136,3991
01.12.2016 12:00,4019,36.46,43,124,3976
01.12.2016 13:00,3912,35,72,93,3840
01.12.2016 14:00,3908,33.3,112,97,3796
01.12.2016 15:00,3868,32.21,115,109,3753
01.12.2016 16:00,3936,33,126,122,3810
01.12.2016 17:00,3989,47.26,141,133,3848
01.12.2016 18:00,4015,55.97,147,131,3868
01.12.2016 19:00,3974,40.33,163,158,3811
01.12.2016 20:00,3845,29.69,198,181,3647
01.12.2016 21:00,3672,26.05,231,199,3441
01.12.2016 22:00,3497,24.76,262,214,3235
01.12.2016 23:00,3363,23.3,304,259,3059
13.01.2016 00:00,3186,21.51,323,286,2863
13.01.2016 01:00,3013,21,330,293,2683
13.01.2016 02:00,2923,19.66,401,318,2522
13.01.2016 03:00,2867,18.72,469,353,2398
13.01.2016 04:00,2872,18.66,514,384,2358
13.01.2016 05:00,2967,19.31,515,404,2452
13.01.2016 06:00,3170,21.34,514,414,2656
13.01.2016 07:00,3709,23.52,527,424,3182
13.01.2016 08:00,4179,27.5,474,419,3705
13.01.2016 09:00,4335,30.35,435,415,3900
13.01.2016 10:00,4327,30.73,384,399,3943
13.01.2016 11:00,4372,31.45,336,377,4036
13.01.2016 12:00,4293,33.56,328,367,3965
13.01.2016 13:00,4253,33.99,285,339,3968
13.01.2016 14:00,4228,34.09,289,316,3939
13.01.2016 15:00,4151,34.02,321,298,3830
13.01.2016 16:00,4208,43.55,316,285,3892
13.01.2016 17:00,4316,82.2,317,290,3999
13.01.2016 18:00,4382,99.93,320,284,4062
13.01.2016 19:00,4333,59.92,295,279,4038
13.01.2016 20:00,4198,38.86,298,254,3900
13.01.2016 21:00,4088,29.62,274,225,3814
13.01.2016 22:00,3975,26.97,248,218,3727
13.01.2016 23:00,3801,25.42,229,207,3572
14.01.2016 00:00,3595,22.95,223,191,3372
14.01.2016 01:00,3460,23.51,227,157,3233
14.01.2016 02:00,3347,22.58,223,148,3124
14.01.2016 03:00,3312,22.22,220,144,3092
14.01.2016 04:00,3304,22.03,205,140,3099
14.01.2016 05:00,3365,22.53,210,143,3155
14.01.2016 06:00,3538,23.9,200,160,3338
14.01.2016 07:00,4014,29.27,204,167,3810
14.01.2016 08:00,4430,69.91,221,171,4209
14.01.2016 09:00,4479,88.61,232,168,4247
14.01.2016 10:00,4513,69.98,225,174,4288
14.01.2016 11:00,4454,49.6,202,171,4252
14.01.2016 12:00,4481,50.06,154,170,4327
14.01.2016 13:00,4394,59.08,158,159,4236
14.01.2016 14:00,4357,66.73,158,157,4199
14.01.2016 15:00,4329,60.81,163,169,4166
14.01.2016 16:00,4335,66.19,193,169,4142
14.01.2016 17:00,4384,132.45,232,206,4152
14.01.2016 18:00,4503,154.93,259,228,4244
14.01.2016 19:00,4376,120.76,275,250,4101
14.01.2016 20:00,4474,62.09,258,251,4216
14.01.2016 21:00,4216,39.28,262,274,3954
14.01.2016 22:00,4141,31.61,257,318,3884
14.01.2016 23:00,3893,27.49,269,325,3624
15.01.2016 00:00,3706,25.11,275,337,3431
15.01.2016 01:00,3545,24.58,277,361,3268
15.01.2016 02:00,3542,24.04,254,360,3288
15.01.2016 03:00,3558,23.28,254,368,3304
15.01.2016 04:00,3544,22.94,275,370,3269
15.01.2016 05:00,3553,22.94,316,374,3237
15.01.2016 06:00,3578,23.17,339,382,3239
15.01.2016 07:00,4089,26.35,351,386,3738
15.01.2016 08:00,4506,119.92,337,381,4169
15.01.2016 09:00,4558,134.43,324,368,4234
15.01.2016 10:00,4560,150.01,276,341,4284
15.01.2016 11:00,4579,58,204,296,4375
15.01.2016 12:00,4679,55.66,129,257,4550
15.01.2016 13:00,4454,57.67,86,228,4368
15.01.2016 14:00,4369,56.63,67,202,4302
15.01.2016 15:00,4312,47.56,47,185,4265
15.01.2016 16:00,4257,48.41,44,146,4213
15.01.2016 17:00,4386,101.57,61,137,4325
15.01.2016 18:00,4494,149.95,94,132,4400
15.01.2016 19:00,4416,90.08,110,132,4306
15.01.2016 20:00,4281,45.43,136,126,4145
15.01.2016 21:00,4210,33.69,107,121,4103
15.01.2016 22:00,4059,29.34,109,119,3950
15.01.2016 23:00,3910,27.17,100,114,3810
16.01.2016 00:00,3793,24.96,113,107,3680
16.01.2016 01:00,3622,26.49,147,77,3475
16.01.2016 02:00,3580,25.7,125,75,3455
16.01.2016 03:00,3621,24.84,92,75,3529
16.01.2016 04:00,3628,24.34,89,79,3539
16.01.2016 05:00,3672,24.03,90,90,3582
16.01.2016 06:00,3751,24.71,85,89,3666
16.01.2016 07:00,3845,24.18,66,88,3779
16.01.2016 08:00,3997,24.43,64,92,3933
16.01.2016 09:00,4157,26.58,62,108,4095
16.01.2016 10:00,4203,31.63,56,103,4147
16.01.2016 11:00,4277,33.39,46,97,4231
16.01.2016 12:00,4247,33.23,27,85,4220
16.01.2016 13:00,4158,29.16,6,76,4152
16.01.2016 14:00,4120,26.31,11,74,4109
16.01.2016 15:00,4002,25.47,22,72,3980
16.01.2016 16:00,3995,25.6,40,86,3955
16.01.2016 17:00,4170,30.15,74,103,4096
16.01.2016 18:00,4267,40.75,110,128,4157
16.01.2016 19:00,4235,40.73,147,155,4088
16.01.2016 20:00,4084,30.29,200,164,3884
16.01.2016 21:00,3936,26.18,238,173,3698
16.01.2016 22:00,3836,25.07,253,183,3583
16.01.2016 23:00,3783,24.72,204,185,3579
17.01.2016 00:00,3648,23.54,203,192,3445
17.01.2016 01:00,3490,21.88,220,206,3270
17.01.2016 02:00,3426,20.25,224,204,3202
17.01.2016 03:00,3422,20.76,235,204,3187
17.01.2016 04:00,3426,20.97,252,198,3174
17.01.2016 05:00,3455,20.89,259,210,3196
17.01.2016 06:00,3492,20.94,285,214,3207
17.01.2016 07:00,3547,20.12,332,221,3215
17.01.2016 08:00,3697,22.35,336,220,3361
17.01.2016 09:00,3875,23.52,295,214,3580
17.01.2016 10:00,4056,24.58,242,205,3814
17.01.2016 11:00,4114,26.44,178,186,3936
17.01.2016 12:00,4120,27.26,119,182,4001
17.01.2016 13:00,4022,25.96,83,164,3939
17.01.2016 14:00,3971,25.97,78,159,3893
17.01.2016 15:00,3897,25.56,83,157,3814
17.01.2016 16:00,3926,26.42,116,150,3810
17.01.2016 17:00,4088,31.94,195,159,3893
17.01.2016 18:00,4239,39.49,232,172,4007
17.01.2016 19:00,4253,42.8,277,181,3976
17.01.2016 20:00,4231,37.98,278,177,3953
17.01.2016 21:00,4118,32.5,297,171,3821
17.01.2016 22:00,4034,26.39,309,174,3725
17.01.2016 23:00,3860,25.6,300,184,3560
18.01.2016 00:00,3705,24.39,336,203,3369
18.01.2016 01:00,3594,23.96,379,205,3215
18.01.2016 02:00,3502,23.47,457,229,3045
18.01.2016 03:00,3445,23.56,540,263,2905
18.01.2016 04:00,3518,23.46,566,315,2952
18.01.2016 05:00,3591,23.51,568,340,3023
18.01.2016 06:00,3797,24.25,575,364,3222
18.01.2016 07:00,4317,26.95,597,380,3720
18.01.2016 08:00,4711,46.68,592,396,4119
18.01.2016 09:00,4727,82.14,593,420,4134
18.01.2016 10:00,4713,53.79,508,399,4205
18.01.2016 11:00,4746,51.25,409,391,4337
18.01.2016 12:00,4728,48.44,334,380,4394
18.01.2016 13:00,4600,46.93,318,381,4282
18.01.2016 14:00,4544,46.32,328,375,4216
18.01.2016 15:00,4539,45.76,289,373,4250
18.01.2016 16:00,4523,49.53,267,350,4256
18.01.2016 17:00,4597,81.31,255,348,4342
18.01.2016 18:00,4573,95.06,289,352,4284
18.01.2016 19:00,4464,63.39,341,366,4123
18.01.2016 20:00,4318,47.82,377,375,3941
18.01.2016 21:00,4154,34.24,362,394,3792
18.01.2016 22:00,4026,26.58,355,418,3671
18.01.2016 23:00,3781,24.82,380,447,3401
19.01.2016 00:00,3640,23.73,426,479,3214
19.01.2016 01:00,3412,24.53,485,503,2927
19.01.2016 02:00,3282,23.6,542,528,2740
19.01.2016 03:00,3293,23.32,548,557,2745
19.01.2016 04:00,3319,23.78,558,586,2761
19.01.2016 05:00,3354,24.41,622,635,2732
19.01.2016 06:00,3439,26.29,672,672,2767
19.01.2016 07:00,3859,31.9,764,737,3095
19.01.2016 08:00,4215,60.02,813,764,3402
19.01.2016 09:00,4254,74.06,830,763,3424
19.01.2016 10:00,4297,66.95,749,756,3548
19.01.2016 11:00,4369,61.31,730,751,3639
19.01.2016 12:00,4329,61.43,732,716,3597
19.01.2016 13:00,4288,58.98,683,674,3605
19.01.2016 14:00,4265,58.53,608,606,3657
19.01.2016 15:00,4210,55.81,525,528,3685
19.01.2016 16:00,4236,74.09,441,467,3795
19.01.2016 17:00,4307,133.67,369,417,3938
19.01.2016 18:00,4377,183.52,358,371,4019
19.01.2016 19:00,4356,100.08,285,348,4071
19.01.2016 20:00,4237,57.56,271,331,3966
19.01.2016 21:00,4044,48.24,285,304,3759
19.01.2016 22:00,3905,37.7,272,307,3633
19.01.2016 23:00,3721,32.86,248,298,3473
20.01.2016 00:00,3564,29.08,249,295,3315
20.01.2016 01:00,3483,26.05,243,300,3240
20.01.2016 02:00,3395,25.55,229,296,3166
20.01.2016 03:00,3422,25.79,211,302,3211
20.01.2016 04:00,3414,24.79,239,282,3175
20.01.2016 05:00,3448,25.76,270,279,3178
20.01.2016 06:00,3624,26.54,273,275,3351
20.01.2016 07:00,4077,32.7,257,271,3820
20.01.2016 08:00,4561,56.44,212,266,4349
20.01.2016 09:00,4607,70.09,174,253,4433
20.01.2016 10:00,4630,65.02,135,252,4495
20.01.2016 11:00,4683,60.42,123,247,4560
20.01.2016 12:00,4664,57.52,130,242,4534
20.01.2016 13:00,4563,58.6,160,242,4403
20.01.2016 14:00,4522,57.58,183,246,4339
20.01.2016 15:00,4468,54.95,221,257,4247
20.01.2016 16:00,4495,53.71,230,277,4265
20.01.2016 17:00,4578,85.9,233,295,4345
20.01.2016 18:00,4753,110.41,211,312,4542
20.01.2016 19:00,4698,81.03,211,328,4487
20.01.2016 20:00,4605,70.03,232,325,4373
20.01.2016 21:00,4481,50.1,226,319,4255
20.01.2016 22:00,4319,40.06,238,318,4081
20.01.2016 23:00,4150,33.52,250,316,3900
21.01.2016 00:00,3925,29.63,269,312,3656
21.01.2016 01:00,3760,29.65,293,260,3467
21.01.2016 02:00,3722,27.82,304,247,3418
21.01.2016 03:00,3664,26.65,291,223,3373
21.01.2016 04:00,3722,26.96,249,201,3473
21.01.2016 05:00,3727,27.47,269,186,3458
21.01.2016 06:00,3923,29.81,264,176,3659
21.01.2016 07:00,4327,41.78,261,167,4066
21.01.2016 08:00,4687,199.96,265,168,4422
21.01.2016 09:00,4736,214.25,278,162,4458
21.01.2016 10:00,4869,200,274,167,4595
21.01.2016 11:00,4724,130.06,226,169,4498
21.01.2016 12:00,4627,74.97,184,162,4443
21.01.2016 13:00,4537,61.39,142,144,4395
21.01.2016 14:00,4439,59.11,136,134,4303
21.01.2016 15:00,4357,60.01,120,128,4237
21.01.2016 16:00,4380,98.6,125,117,4255
21.01.2016 17:00,4459,199.97,144,121,4315
21.01.2016 18:00,4627,200.09,144,112,4483
21.01.2016 19:00,4555,199.87,141,108,4414
21.01.2016 20:00,4522,61.61,104,99,4418
21.01.2016 21:00,4424,50.09,65,84,4359
21.01.2016 22:00,4295,36.34,55,74,4240
21.01.2016 23:00,4141,30.36,50,65,4091
22.01.2016 00:00,3846,27.64,46,58,3800
22.01.2016 01:00,3728,27.37,71,57,3657
22.01.2016 02:00,3618,27.25,114,56,3504
22.01.2016 03:00,3585,26.14,123,56,3462
22.01.2016 04:00,3598,26.22,92,64,3506
22.01.2016 05:00,3661,26.94,67,67,3594
22.01.2016 06:00,3833,28.14,62,72,3771
22.01.2016 07:00,4261,30.82,50,79,4211
22.01.2016 08:00,4674,80.37,30,87,4644
22.01.2016 09:00,4654,120.03,24,97,4630
22.01.2016 10:00,4643,119.93,31,104,4612
22.01.2016 11:00,4623,56.04,39,89,4584
22.01.2016 12:00,4597,50.1,47,116,4550
22.01.2016 13:00,4458,43.09,53,131,4405
22.01.2016 14:00,4402,37.93,45,141,4357
22.01.2016 15:00,4323,32.63,52,165,4271
22.01.2016 16:00,4323,32.65,81,187,4242
22.01.2016 17:00,4383,37.28,137,211,4246
22.01.2016 18:00,4498,49.91,179,234,4319
22.01.2016 19:00,4421,30.99,239,293,4182
22.01.2016 20:00,4261,26.88,322,350,3939
22.01.2016 21:00,4040,24.85,448,400,3592
22.01.2016 22:00,3817,23.91,570,447,3247
22.01.2016 23:00,3713,22.65,597,508,3116
23.01.2016 00:00,3560,22.43,575,523,2985
23.01.2016 01:00,3386,21.94,641,542,2745
23.01.2016 02:00,3415,21.75,639,548,2776
23.01.2016 03:00,3331,21.64,563,538,2768
23.01.2016 04:00,3322,21.78,522,500,2800
23.01.2016 05:00,3295,21.95,476,435,2819
23.01.2016 06:00,3309,21.9,443,378,2866
23.01.2016 07:00,3385,21.46,396,321,2989
23.01.2016 08:00,3581,22.6,317,269,3264
23.01.2016 09:00,3737,23.42,238,232,3499
23.01.2016 10:00,3855,24.43,203,176,3652
23.01.2016 11:00,3927,25.63,144,159,3783
23.01.2016 12:00,3917,26.01,111,124,3806
23.01.2016 13:00,3853,25.88,92,97,3761
23.01.2016 14:00,3811,24.85,61,75,3750
23.01.2016 15:00,3778,24.51,34,62,3744
23.01.2016 16:00,3778,24.6,25,55,3753
23.01.2016 17:00,3922,26.12,14,54,3908
23.01.2016 18:00,4065,27.33,21,62,4044
23.01.2016 19:00,4008,26.5,25,75,3983
23.01.2016 20:00,3882,25.35,47,90,3835
23.01.2016 21:00,3725,24.53,78,105,3647
23.01.2016 22:00,3560,23.29,94,117,3466
23.01.2016 23:00,3436,22.54,100,131,3336
24.01.2016 00:00,3309,22.71,102,141,3207
24.01.2016 01:00,3099,21.78,150,154,2949
24.01.2016 02:00,3020,20.94,167,179,2853
24.01.2016 03:00,3040,20.71,132,209,2908
24.01.2016 04:00,3004,20.58,144,215,2860
24.01.2016 05:00,2994,20.68,139,219,2855
24.01.2016 06:00,2984,21.08,201,236,2783
24.01.2016 07:00,3047,20.9,240,272,2807
24.01.2016 08:00,3247,21.4,205,303,3042
24.01.2016 09:00,3373,22.02,213,304,3160
24.01.2016 10:00,3507,21.94,234,308,3273
24.01.2016 11:00,3654,22.43,238,317,3416
24.01.2016 12:00,3678,22.63,245,303,3433
24.01.2016 13:00,3671,22.47,215,286,3456
24.01.2016 14:00,3607,22.25,243,280,3364
24.01.2016 15:00,3583,22.2,244,281,3339
24.01.2016 16:00,3601,22.59,199,276,3402
24.01.2016 17:00,3757,23.93,224,280,3533
24.01.2016 18:00,3851,25.46,284,298,3567
24.01.2016 19:00,3770,25.35,326,284,3444
24.01.2016 20:00,3616,24.1,389,285,3227
24.01.2016 21:00,3421,22.99,392,272,3029
24.01.2016 22:00,3285,22.36,350,255,2935
24.01.2016 23:00,3163,21.97,277,235,2886
25.01.2016 00:00,3041,21.72,220,220,2821
25.01.2016 01:00,2959,20.07,180,220,2779
25.01.2016 02:00,2871,19.65,142,182,2729
25.01.2016 03:00,2847,19.68,120,144,2727
25.01.2016 04:00,2845,19.98,96,116,2749
25.01.2016 05:00,2901,20.33,85,104,2816
25.01.2016 06:00,3058,21.32,90,95,2968
25.01.2016 07:00,3552,23.77,96,94,3456
25.01.2016 08:00,3942,30.07,89,95,3853
25.01.2016 09:00,4015,33.88,91,98,3924
25.01.2016 10:00,3940,27.47,95,98,3845
25.01.2016 11:00,4029,33.53,85,100,3944
25.01.2016 12:00,4031,28.76,73,102,3958
25.01.2016 13:00,3936,24.93,73,110,3863
25.01.2016 14:00,3896,28.02,122,110,3774
25.01.2016 15:00,3889,25.08,117,104,3772
25.01.2016 16:00,3927,24.88,147,138,3780
25.01.2016 17:00,3974,25.36,173,164,3801
25.01.2016 18:00,4070,26.93,194,189,3876
25.01.2016 19:00,3996,24.42,236,232,3760
25.01.2016 20:00,3889,22.67,274,286,3615
25.01.2016 21:00,3727,21.95,330,339,3397
25.01.2016 22:00,3533,21.28,389,411,3144
25.01.2016 23:00,3163,19.3,505,469,2658
26.01.2016 00:00,2929,18.11,643,548,2286
26.01.2016 01:00,2748,16.96,759,641,1989
26.01.2016 02:00,2663,16.42,865,731,1798
26.01.2016 03:00,2668,15.9,903,801,1765
26.01.2016 04:00,2635,15.91,971,876,1664
26.01.2016 05:00,2711,16.42,975,928,1736
26.01.2016 06:00,2906,16.96,976,964,1930
26.01.2016 07:00,3304,18.04,1003,1001,2301
26.01.2016 08:00,3737,18.82,994,1026,2743
26.01.2016 09:00,3851,19.37,987,1023,2864
26.01.2016 10:00,3888,19.36,932,1014,2956
26.01.2016 11:00,3867,19.37,932,977,2935
26.01.2016 12:00,3789,19.31,988,940,2801
26.01.2016 13:00,3788,19.15,877,907,2911
26.01.2016 14:00,3946,19.11,696,840,3250
26.01.2016 15:00,3906,19.12,599,749,3307
26.01.2016 16:00,3850,19.17,609,676,3241
26.01.2016 17:00,3944,19.45,596,650,3348
26.01.2016 18:00,3997,19.67,700,668,3297
26.01.2016 19:00,3837,19.35,802,713,3035
26.01.2016 20:00,3687,18.76,864,772,2823
26.01.2016 21:00,3513,18.45,920,847,2593
26.01.2016 22:00,3367,18.18,977,931,2390
26.01.2016 23:00,3101,17.45,1064,1008,2037
27.01.2016 00:00,2926,16.06,1139,1074,1787
27.01.2016 01:00,2848,14.72,1191,1208,1657
27.01.2016 02:00,2777,14.38,1232,1255,1545
27.01.2016 03:00,2724,13.86,1238,1273,1486
27.01.2016 04:00,2756,14.12,1226,1274,1530
27.01.2016 05:00,2769,13.93,1212,1242,1557
27.01.2016 06:00,2897,15.24,1197,1214,1700
27.01.2016 07:00,3290,16.79,1166,1184,2124
27.01.2016 08:00,3751,17.72,1135,1164,2616
27.01.2016 09:00,3826,17.96,1129,1149,2697
27.01.2016 10:00,3812,17.85,1099,1131,2713
27.01.2016 11:00,3805,17.89,1085,1104,2720
27.01.2016 12:00,3769,17.71,1066,1094,2703
27.01.2016 13:00,3681,17.59,1078,1083,2603
27.01.2016 14:00,3708,17.66,1077,1080,2631
27.01.2016 15:00,3700,17.66,1057,1096,2643
27.01.2016 16:00,3698,17.62,1106,1125,2592
27.01.2016 17:00,3772,17.83,1129,1154,2643
27.01.2016 18:00,3820,18.1,1160,1149,2660
27.01.2016 19:00,3680,17.89,1200,1197,2480
27.01.2016 20:00,3652,17.59,1205,1230,2447
27.01.2016 21:00,3480,17.29,1238,1233,2242
27.01.2016 22:00,3310,17.12,1254,1263,2056
27.01.2016 23:00,3105,16.34,1252,1281,1853
28.01.2016 00:00,2845,15.07,1254,1294,1591
28.01.2016 01:00,2749,15.07,1258,1336,1491
28.01.2016 02:00,2744,14.6,1257,1334,1487
28.01.2016 03:00,2701,14.25,1244,1322,1457
28.01.2016 04:00,2731,14.22,1220,1305,1511
28.01.2016 05:00,2786,14.34,1197,1288,1589
28.01.2016 06:00,2959,16.25,1188,1284,1771
28.01.2016 07:00,3347,17.16,1216,1284,2131
28.01.2016 08:00,3830,17.57,1266,1301,2564
28.01.2016 09:00,3820,17.89,1281,1320,2539
28.01.2016 10:00,3784,17.8,1266,1338,2518
28.01.2016 11:00,3898,17.78,1256,1355,2642
28.01.2016 12:00,3884,17.66,1256,1362,2628
28.01.2016 13:00,3800,17.55,1256,1357,2544
28.01.2016 14:00,3780,17.57,1258,1343,2522
28.01.2016 15:00,3701,17.52,1245,1317,2456
28.01.2016 16:00,3695,17.59,1249,1274,2446
28.01.2016 17:00,3763,17.75,1195,1237,2568
28.01.2016 18:00,3969,18.18,1121,1185,2848
28.01.2016 19:00,3929,17.86,1055,1141,2874
28.01.2016 20:00,3830,17.54,1040,1112,2790
28.01.2016 21:00,3635,17.21,1057,1067,2578
28.01.2016 22:00,3435,17.07,1063,1067,2372
28.01.2016 23:00,3177,16.5,1078,1058,2099
29.01.2016 00:00,2946,16.02,1091,1061,1855
29.01.2016 01:00,2829,16.06,1054,1043,1775
29.01.2016 02:00,2806,15.61,1015,1034,1791
29.01.2016 03:00,2826,15.35,957,1011,1869
29.01.2016 04:00,2811,15.5,970,985,1841
29.01.2016 05:00,2829,15.62,1000,980,1829
29.01.2016 06:00,3009,16.31,1013,999,1996
29.01.2016 07:00,3389,16.98,1038,1041,2351
29.01.2016 08:00,3777,17.52,1097,1080,2680
29.01.2016 09:00,3894,17.79,1101,1120,2793
29.01.2016 10:00,3865,17.65,1098,1128,2767
29.01.2016 11:00,3940,17.5,1130,1147,2810
29.01.2016 12:00,3930,17.3,1171,1183,2759
29.01.2016 13:00,3839,17.04,1216,1227,2623
29.01.2016 14:00,3803,16.72,1266,1282,2537
29.01.2016 15:00,3724,16.51,1290,1309,2434
29.01.2016 16:00,3638,16.2,1300,1334,2338
29.01.2016 17:00,3682,16.36,1307,1363,2375
29.01.2016 18:00,3746,16.74,1303,1369,2443
29.01.2016 19:00,3645,16.62,1301,1361,2344
29.01.2016 20:00,3484,16.14,1288,1345,2196
29.01.2016 21:00,3305,15.4,1273,1321,2032
29.01.2016 22:00,3135,15.2,1249,1287,1886
29.01.2016 23:00,3007,14.6,1220,1258,1787
30.01.2016 00:00,2868,10.29,1172,1234,1696
30.01.2016 01:00,2709,14.08,1128,1175,1581
30.01.2016 02:00,2706,8.82,1056,1134,1650
30.01.2016 03:00,2645,4.9,1038,1110,1607
30.01.2016 04:00,2601,4.69,1046,1091,1555
30.01.2016 05:00,2618,4.92,1023,1080,1595
30.01.2016 06:00,2699,10.44,1011,1096,1688
30.01.2016 07:00,2803,13.63,1015,1093,1788
30.01.2016 08:00,2951,13.52,1099,1126,1852
30.01.2016 09:00,2940,14.29,1190,1144,1750
30.01.2016 10:00,3030,14.84,1202,1124,1828
30.01.2016 11:00,3139,15.19,1200,1100,1939
30.01.2016 12:00,3146,15.35,1167,1088,1979
30.01.2016 13:00,3161,15.21,1068,1027,2093
30.01.2016 14:00,3100,15.03,1019,957,2081
30.01.2016 15:00,3019,15.02,968,882,2051
30.01.2016 16:00,3058,15.37,906,836,2152
30.01.2016 17:00,3350,16.51,731,796,2619
30.01.2016 18:00,3586,17.72,691,768,2895
30.01.2016 19:00,3466,17.57,713,742,2753
30.01.2016 20:00,3285,17.19,773,740,2512
30.01.2016 21:00,3160,16.79,780,776,2380
30.01.2016 22:00,3075,16.21,771,813,2304
30.01.2016 23:00,2963,15.49,839,857,2124
31.01.2016 00:00,2901,14.78,849,912,2052
31.01.2016 01:00,2830,15.46,929,1007,1901
31.01.2016 02:00,2782,15.32,972,1061,1810
31.01.2016 03:00,2795,15.16,995,1107,1800
31.01.2016 04:00,2831,15.22,999,1153,1832
31.01.2016 05:00,2852,15.32,1018,1176,1834
31.01.2016 06:00,2903,15.42,1040,1196,1863
31.01.2016 07:00,2980,15.73,1082,1219,1898
31.01.2016 08:00,3120,15.76,1082,1238,2038
31.01.2016 09:00,3168,15.73,1125,1259,2043
31.01.2016 10:00,3258,16.02,1156,1273,2102
31.01.2016 11:00,3317,16.25,1145,1265,2172
31.01.2016 12:00,3320,16.45,1140,1231,2180
31.01.2016 13:00,3293,16.42,1136,1199,2157
31.01.2016 14:00,3241,16.27,1144,1167,2097
31.01.2016 15:00,3239,16.17,1124,1146,2115
31.01.2016 16:00,3265,16.41,1060,1079,2205
31.01.2016 17:00,3421,17.23,1022,1033,2399
31.01.2016 18:00,3620,18.21,990,994,2630
31.01.2016 19:00,3641,18.47,904,957,2737
31.01.2016 20:00,3615,18.35,830,939,2785
31.01.2016 21:00,3512,18.03,777,898,2735
31.01.2016 22:00,3302,17.61,777,857,2525
31.01.2016 23:00,3096,17.48,798,821,2298
02.01.2016 00:00,2875,16.45,816,798,2059
02.01.2016 01:00,2858,16.31,772,823,2086
02.01.2016 02:00,2827,15.43,724,797,2103
02.01.2016 03:00,2810,15.57,696,768,2114
02.01.2016 04:00,2842,15.74,686,723,2156
02.01.2016 05:00,2861,16.28,680,669,2181
02.01.2016 06:00,3052,17.48,614,596,2438
02.01.2016 07:00,3527,18.81,545,517,2982
02.01.2016 08:00,3944,25.64,459,438,3485
02.01.2016 09:00,4009,35.1,402,382,3607
02.01.2016 10:00,3984,21.24,347,343,3637
02.01.2016 11:00,4057,19.71,260,327,3797
02.01.2016 12:00,4051,18.9,273,352,3778
02.01.2016 13:00,3880,18.59,434,420,3446
02.01.2016 14:00,3858,18.39,609,553,3249
02.01.2016 15:00,3827,18.17,817,720,3010
02.01.2016 16:00,3869,17.97,1023,906,2846
02.01.2016 17:00,3938,18.09,1116,1052,2822
02.01.2016 18:00,3978,18.44,1206,1163,2772
02.01.2016 19:00,3857,18.12,1263,1242,2594
02.01.2016 20:00,3767,17.77,1255,1271,2512
02.01.2016 21:00,3566,17.35,1270,1286,2296
02.01.2016 22:00,3400,16.52,1284,1327,2116
02.01.2016 23:00,3168,16.01,1298,1338,1870
02.02.2016 00:00,2991,15.35,1297,1348,1694
02.02.2016 01:00,2876,15.23,1286,1359,1590
02.02.2016 02:00,2828,14.51,1284,1369,1544
02.02.2016 03:00,2829,14.03,1274,1369,1555
02.02.2016 04:00,2835,13.72,1289,1373,1546
02.02.2016 05:00,2881,14.51,1258,1360,1623
02.02.2016 06:00,3097,15.46,1244,1359,1853
02.02.2016 07:00,3478,16.54,1256,1354,2222
02.02.2016 08:00,3879,18.12,1267,1351,2612
02.02.2016 09:00,3891,18.33,1255,1339,2636
02.02.2016 10:00,3877,18.18,1241,1339,2636
02.02.2016 11:00,3911,18.09,1270,1343,2641
02.02.2016 12:00,3877,17.99,1282,1343,2595
02.02.2016 13:00,3875,17.82,1287,1343,2588
02.02.2016 14:00,3862,17.85,1291,1352,2571
02.02.2016 15:00,3847,17.79,1290,1355,2557
02.02.2016 16:00,3900,17.9,1284,1361,2616
02.02.2016 17:00,3897,18.26,1276,1367,2621
02.02.2016 18:00,4046,18.61,1279,1371,2767
02.02.2016 19:00,3977,18.47,1283,1369,2694
02.02.2016 20:00,3885,17.93,1288,1379,2597
02.02.2016 21:00,3736,17.53,1270,1380,2466
02.02.2016 22:00,3551,16.95,1274,1375,2277
02.02.2016 23:00,3320,16.09,1277,1376,2043
02.03.2016 00:00,3115,15.67,1276,1379,1839
02.03.2016 01:00,2980,16.07,1270,1376,1710
02.03.2016 02:00,2900,15.72,1278,1374,1622
02.03.2016 03:00,2865,15.66,1282,1372,1583
02.03.2016 04:00,2873,15.7,1281,1366,1592
02.03.2016 05:00,2930,15.58,1252,1357,1678
02.03.2016 06:00,3075,16.43,1250,1343,1825
02.03.2016 07:00,3493,17.42,1242,1325,2251
02.03.2016 08:00,3898,18.77,1195,1289,2703
02.03.2016 09:00,3928,19.3,1122,1218,2806
02.03.2016 10:00,3871,19.19,1083,1136,2788
02.03.2016 11:00,3840,19.07,1011,1055,2829
02.03.2016 12:00,3910,18.91,900,1001,3010
02.03.2016 13:00,3874,18.64,844,931,3030
02.03.2016 14:00,3775,18.6,844,867,2931
02.03.2016 15:00,3641,18.52,805,800,2836
02.03.2016 16:00,3644,18.36,699,720,2945
02.03.2016 17:00,3772,18.59,594,680,3178
02.03.2016 18:00,4014,19.02,584,666,3430
02.03.2016 19:00,3931,18.85,648,662,3283
02.03.2016 20:00,3824,18.46,694,676,3130
02.03.2016 21:00,3663,18,738,714,2925
02.03.2016 22:00,3440,17.51,826,764,2614
02.03.2016 23:00,3206,17.08,884,802,2322
02.04.2016 00:00,3041,16.61,908,828,2133
02.04.2016 01:00,2914,16.76,890,840,2024
02.04.2016 02:00,2872,16.38,919,853,1953
02.04.2016 03:00,2888,15.99,900,873,1988
02.04.2016 04:00,2928,15.29,902,905,2026
02.04.2016 05:00,2966,15.52,913,918,2053
02.04.2016 06:00,3108,16.8,923,943,2185
02.04.2016 07:00,3603,17.93,876,928,2727
02.04.2016 08:00,3993,19.11,815,908,3178
02.04.2016 09:00,4078,19.71,765,875,3313
02.04.2016 10:00,4105,19.55,683,823,3422
02.04.2016 11:00,4167,19.5,603,799,3564
02.04.2016 12:00,4071,19.04,604,758,3467
02.04.2016 13:00,3923,18.73,635,730,3288
02.04.2016 14:00,3818,18.59,684,693,3134
02.04.2016 15:00,3727,18.54,653,660,3074
02.04.2016 16:00,3726,18.62,596,627,3130
02.04.2016 17:00,3739,18.94,561,602,3178
02.04.2016 18:00,4023,19.99,566,578,3457
02.04.2016 19:00,4003,19.97,559,556,3444
02.04.2016 20:00,3876,19.4,554,522,3322
02.04.2016 21:00,3799,18.87,525,522,3274
02.04.2016 22:00,3648,18.46,493,505,3155
02.04.2016 23:00,3433,18.02,490,483,2943
02.05.2016 00:00,3179,17.54,530,472,2649
02.05.2016 01:00,2888,17.73,547,449,2341
02.05.2016 02:00,2634,17.6,549,442,2085
02.05.2016 03:00,3019,17.58,503,443,2516
02.05.2016 04:00,3007,17.84,509,435,2498
02.05.2016 05:00,3061,18.12,517,435,2544
02.05.2016 06:00,3210,18.43,551,459,2659
02.05.2016 07:00,3667,19.44,509,470,3158
02.05.2016 08:00,4074,25.31,505,476,3569
02.05.2016 09:00,4117,36.49,492,465,3625
02.05.2016 10:00,4092,30.2,462,439,3630
02.05.2016 11:00,4102,25.51,415,409,3687
02.05.2016 12:00,4080,20.9,359,387,3721
02.05.2016 13:00,3932,20.37,352,367,3580
02.05.2016 14:00,3846,19.88,326,344,3520
02.05.2016 15:00,3831,19.74,226,321,3605
02.05.2016 16:00,3806,19.7,184,304,3622
02.05.2016 17:00,3841,19.88,180,290,3661
02.05.2016 18:00,3955,21.05,228,298,3727
02.05.2016 19:00,3854,20.41,282,312,3572
02.05.2016 20:00,3611,19.71,366,334,3245
02.05.2016 21:00,3360,19.12,417,352,2943
02.05.2016 22:00,3220,18.41,407,359,2813
02.05.2016 23:00,3123,17.89,347,379,2776
02.06.2016 00:00,2990,17.35,335,392,2655
02.06.2016 01:00,2830,17.02,370,399,2460
02.06.2016 02:00,2745,16.19,393,425,2352
02.06.2016 03:00,2671,16.01,415,450,2256
02.06.2016 04:00,2655,14.9,462,491,2193
02.06.2016 05:00,2606,14.46,566,530,2040
02.06.2016 06:00,2604,14.53,640,588,1964
02.06.2016 07:00,2706,15.09,718,646,1988
02.06.2016 08:00,2844,16.08,753,706,2091
02.06.2016 09:00,3006,16.32,765,747,2241
02.06.2016 10:00,3180,16.58,788,804,2392
02.06.2016 11:00,3231,16.74,849,840,2382
02.06.2016 12:00,3208,16.5,887,848,2321
02.06.2016 13:00,3183,16.09,865,841,2318
02.06.2016 14:00,3154,15.48,815,820,2339
02.06.2016 15:00,3131,15.37,741,787,2390
02.06.2016 16:00,3180,15.54,637,736,2543
02.06.2016 17:00,3232,16.6,624,678,2608
02.06.2016 18:00,3424,17.93,614,657,2810
02.06.2016 19:00,3382,17.81,610,648,2772
02.06.2016 20:00,3190,17.19,666,637,2524
02.06.2016 21:00,2978,16.07,673,620,2305
02.06.2016 22:00,2818,15.54,668,597,2150
02.06.2016 23:00,2765,15.31,581,591,2184
02.07.2016 00:00,2650,14.81,531,569,2119
02.07.2016 01:00,2541,14.47,503,551,2038
02.07.2016 02:00,2485,13.86,509,553,1976
02.07.2016 03:00,2444,13.6,572,565,1872
02.07.2016 04:00,2435,13.29,590,574,1845
02.07.2016 05:00,2475,12.92,580,587,1895
02.07.2016 06:00,2555,13.26,584,615,1971
02.07.2016 07:00,2693,13.6,569,640,2124
02.07.2016 08:00,2792,14.48,620,675,2172
02.07.2016 09:00,2848,14.61,655,689,2193
02.07.2016 10:00,2950,15.22,673,714,2277
02.07.2016 11:00,3093,15.47,635,760,2458
02.07.2016 12:00,3139,15.47,609,764,2530
02.07.2016 13:00,3097,15.16,641,771,2456
02.07.2016 14:00,3009,14.92,685,774,2324
02.07.2016 15:00,2973,14.61,752,794,2221
02.07.2016 16:00,2993,14.65,794,803,2199
02.07.2016 17:00,3075,14.7,850,814,2225
02.07.2016 18:00,3275,16.43,881,829,2394
02.07.2016 19:00,3392,17.18,760,828,2632
02.07.2016 20:00,3361,16.8,692,804,2669
02.07.2016 21:00,3275,16.24,632,775,2643
02.07.2016 22:00,3075,15.43,661,757,2414
02.07.2016 23:00,2854,15.04,720,751,2134
02.08.2016 00:00,2706,11.4,739,772,1967
02.08.2016 01:00,2608,10.15,807,814,1801
02.08.2016 02:00,2555,7.99,837,856,1718
02.08.2016 03:00,2539,5.24,881,876,1658
02.08.2016 04:00,2549,6.7,911,898,1638
02.08.2016 05:00,2645,11.77,950,939,1695
02.08.2016 06:00,2812,13.24,1047,993,1765
02.08.2016 07:00,3264,14.77,1098,1054,2166
02.08.2016 08:00,3694,16.17,1113,1112,2581
02.08.2016 09:00,3728,16.55,1163,1166,2565
02.08.2016 10:00,3755,16.41,1182,1214,2573
02.08.2016 11:00,3793,16.56,1183,1235,2610
02.08.2016 12:00,3879,16.61,1203,1267,2676
02.08.2016 13:00,3830,16.35,1204,1277,2626
02.08.2016 14:00,3818,16.1,1180,1244,2638
02.08.2016 15:00,3774,16.15,1170,1217,2604
02.08.2016 16:00,3742,16.35,1136,1171,2606
02.08.2016 17:00,3727,16.3,1098,1126,2629
02.08.2016 18:00,3870,17.46,1054,1086,2816
02.08.2016 19:00,3864,17.3,972,1055,2892
02.08.2016 20:00,3782,17.04,898,1028,2884
02.08.2016 21:00,3683,16.15,808,994,2875
02.08.2016 22:00,3436,15.39,838,964,2598
02.08.2016 23:00,3159,14.94,873,937,2286
02.09.2016 00:00,2875,14,979,969,1896
02.09.2016 01:00,2765,14.48,1016,1013,1749
02.09.2016 02:00,2669,14.26,1085,1032,1584
02.09.2016 03:00,2608,13.55,1121,1052,1487
02.09.2016 04:00,2621,13.24,1132,1063,1489
02.09.2016 05:00,2612,14.27,1138,1065,1474
02.09.2016 06:00,2724,15.43,1127,1052,1597
02.09.2016 07:00,3079,16.66,1110,1024,1969
02.09.2016 08:00,3535,17.81,1073,1012,2462
02.09.2016 09:00,3638,17.97,1006,1003,2632
02.09.2016 10:00,3675,17.86,958,1002,2717
02.09.2016 11:00,3694,17.73,977,997,2717
02.09.2016 12:00,3642,17.61,1024,990,2618
02.09.2016 13:00,3537,17.55,1044,988,2493
02.09.2016 14:00,3518,17.68,1036,978,2482
02.09.2016 15:00,3539,17.74,973,935,2566
02.09.2016 16:00,3622,18.02,847,876,2775
02.09.2016 17:00,3706,18.29,691,770,3015
02.09.2016 18:00,3903,18.86,621,696,3282
02.09.2016 19:00,3887,18.8,543,598,3344
02.09.2016 20:00,3785,18.65,455,513,3330
02.09.2016 21:00,3625,18.48,397,442,3228
02.09.2016 22:00,3445,18.18,276,370,3169
02.09.2016 23:00,3193,17.82,251,338,2942
02.10.2016 00:00,2930,16.5,328,372,2602
02.10.2016 01:00,2805,16.39,531,520,2274
02.10.2016 02:00,2629,16.03,660,586,1969
02.10.2016 03:00,2662,16.03,663,635,1999
02.10.2016 04:00,2676,16.02,640,615,2036
02.10.2016 05:00,2598,16.15,755,615,1843
02.10.2016 06:00,2861,16.81,678,610,2183
02.10.2016 07:00,3268,18.25,713,582,2555
02.10.2016 08:00,3642,19.64,793,615,2849
02.10.2016 09:00,3765,19.99,835,667,2930
02.10.2016 10:00,3829,20.1,838,722,2991
02.10.2016 11:00,3896,21.75,786,731,3110
02.10.2016 12:00,3972,21.21,710,750,3262
02.10.2016 13:00,3891,19.85,697,722,3194
02.10.2016 14:00,3872,19.7,697,714,3175
02.10.2016 15:00,3916,19.98,646,687,3270
02.10.2016 16:00,3918,19.67,588,638,3330
02.10.2016 17:00,3928,20.83,494,580,3434
02.10.2016 18:00,4066,31.33,390,516,3676
02.10.2016 19:00,4023,35.72,339,444,3684
02.10.2016 20:00,3918,19.96,300,384,3618
02.10.2016 21:00,3756,19.42,255,333,3501
02.10.2016 22:00,3540,18.84,237,295,3303
02.10.2016 23:00,3302,17.94,217,261,3085
02.11.2016 00:00,3061,17.21,188,232,2873
02.11.2016 01:00,2848,17.72,145,148,2703
02.11.2016 02:00,2790,17.46,132,122,2658
02.11.2016 03:00,2743,16.91,124,103,2619
02.11.2016 04:00,2731,16.97,123,87,2608
02.11.2016 05:00,2786,17.66,111,80,2675
02.11.2016 06:00,2965,18.1,98,74,2867
02.11.2016 07:00,3467,19.53,63,72,3404
02.11.2016 08:00,3917,20.67,49,72,3868
02.11.2016 09:00,3947,24.73,40,80,3907
02.11.2016 10:00,3962,20.97,29,79,3933
02.11.2016 11:00,3953,20.61,20,79,3933
02.11.2016 12:00,3915,20.3,19,74,3896
02.11.2016 13:00,3857,20.08,21,80,3836
02.11.2016 14:00,3910,20.04,30,85,3880
02.11.2016 15:00,3867,19.93,41,92,3826
02.11.2016 16:00,3873,19.87,41,107,3832
02.11.2016 17:00,3883,20.1,30,111,3853
02.11.2016 18:00,4016,29.3,39,105,3977
02.11.2016 19:00,3960,35.98,53,106,3907
02.11.2016 20:00,3848,20.44,63,95,3785
02.11.2016 21:00,3710,19.93,64,101,3646
02.11.2016 22:00,3565,19.36,62,106,3503
02.11.2016 23:00,3322,18.5,60,99,3262
02.12.2016 00:00,3099,17.89,63,100,3036
02.12.2016 01:00,2943,17.93,65,92,2878
02.12.2016 02:00,2902,17.73,68,94,2834
02.12.2016 03:00,2866,17.63,73,94,2793
02.12.2016 04:00,2928,17.76,70,98,2858
02.12.2016 05:00,2909,18,76,96,2833
02.12.2016 06:00,3093,18.43,94,94,2999
02.12.2016 07:00,3561,19.69,104,90,3457
02.12.2016 08:00,3938,29.08,100,86,3838
02.12.2016 09:00,3987,36.4,100,86,3887
02.12.2016 10:00,4000,34.13,68,82,3932
02.12.2016 11:00,3923,33.86,84,79,3839
02.12.2016 12:00,3889,32.67,87,78,3802
02.12.2016 13:00,3836,28.46,83,81,3753
02.12.2016 14:00,3745,24.44,117,81,3628
02.12.2016 15:00,3607,20.08,164,83,3443
02.12.2016 16:00,3583,19.87,172,93,3411
02.12.2016 17:00,3635,20.3,146,103,3489
02.12.2016 18:00,3876,33.73,132,93,3744
02.12.2016 19:00,3922,39.39,104,94,3818
02.12.2016 20:00,3825,34.71,89,107,3736
02.12.2016 21:00,3650,19.6,84,98,3566
02.12.2016 22:00,3493,19.05,76,84,3417
02.12.2016 23:00,3334,18.5,82,80,3252
13.02.2016 00:00,3181,18,94,80,3087
13.02.2016 01:00,3053,18.42,126,78,2927
13.02.2016 02:00,2979,18.07,145,79,2834
13.02.2016 03:00,2934,17.79,123,78,2811
13.02.2016 04:00,2947,17.84,99,72,2848
13.02.2016 05:00,2980,17.92,96,67,2884
13.02.2016 06:00,3063,18.13,85,62,2978
13.02.2016 07:00,3153,17.91,95,59,3058
13.02.2016 08:00,3282,18.22,108,57,3174
13.02.2016 09:00,3451,18.34,103,55,3348
13.02.2016 10:00,3596,18.97,77,58,3519
13.02.2016 11:00,3635,19.15,47,53,3588
13.02.2016 12:00,3629,19.11,26,56,3603
13.02.2016 13:00,3565,18.87,26,58,3539
13.02.2016 14:00,3460,18.6,39,59,3421
13.02.2016 15:00,3406,18.55,37,65,3369
13.02.2016 16:00,3377,18.52,35,73,3342
13.02.2016 17:00,3498,19.21,31,72,3467
13.02.2016 18:00,3757,20.49,34,81,3723
13.02.2016 19:00,3790,20.52,42,97,3748
13.02.2016 20:00,3659,19.63,46,106,3613
13.02.2016 21:00,3496,19.11,66,114,3430
13.02.2016 22:00,3347,18.55,69,125,3278
13.02.2016 23:00,3245,18.06,70,129,3175
14.02.2016 00:00,3121,17.29,74,136,3047
14.02.2016 01:00,2949,17.14,79,116,2870
14.02.2016 02:00,2908,16.77,94,135,2814
14.02.2016 03:00,2865,16.55,116,154,2749
14.02.2016 04:00,2861,16.49,131,178,2730
14.02.2016 05:00,2887,16.62,165,210,2722
14.02.2016 06:00,2923,16.83,209,252,2714
14.02.2016 07:00,3003,16.94,238,286,2765
14.02.2016 08:00,3135,16.91,256,314,2879
14.02.2016 09:00,3216,17.13,243,328,2973
14.02.2016 10:00,3374,17.55,229,337,3145
14.02.2016 11:00,3511,17.69,200,352,3311
14.02.2016 12:00,3561,17.84,220,365,3341
14.02.2016 13:00,3541,17.69,234,378,3307
14.02.2016 14:00,3438,17.34,286,379,3152
14.02.2016 15:00,3386,17.43,311,387,3075
14.02.2016 16:00,3352,17.64,342,406,3010
14.02.2016 17:00,3454,17.91,357,424,3097
14.02.2016 18:00,3695,21.21,379,448,3316
14.02.2016 19:00,3779,19.06,378,466,3401
14.02.2016 20:00,3701,18.71,380,464,3321
14.02.2016 21:00,3535,18.28,404,471,3131
14.02.2016 22:00,3392,17.95,438,484,2954
14.02.2016 23:00,3196,17.79,463,500,2733
15.02.2016 00:00,3076,17.52,474,514,2602
15.02.2016 01:00,2958,17.13,472,497,2486
15.02.2016 02:00,2976,16.53,439,509,2537
15.02.2016 03:00,2999,15.97,409,497,2590
15.02.2016 04:00,2985,16.23,411,472,2574
15.02.2016 05:00,3034,16.8,440,488,2594
15.02.2016 06:00,3227,17.34,458,492,2769
15.02.2016 07:00,3771,18.56,399,481,3372
15.02.2016 08:00,4199,29.93,351,475,3848
15.02.2016 09:00,4282,29.47,360,470,3922
15.02.2016 10:00,4287,31.67,332,448,3955
15.02.2016 11:00,4316,30.16,316,417,4000
15.02.2016 12:00,4289,21.92,290,394,3999
15.02.2016 13:00,4179,20.61,295,371,3884
15.02.2016 14:00,4080,20.13,319,363,3761
15.02.2016 15:00,4062,19.6,313,371,3749
15.02.2016 16:00,4031,19.39,308,373,3723
15.02.2016 17:00,3987,20.25,298,352,3689
15.02.2016 18:00,4099,27.77,337,352,3762
15.02.2016 19:00,4173,29.44,381,351,3792
15.02.2016 20:00,4119,22.19,379,370,3740
15.02.2016 21:00,3970,19.74,380,355,3590
15.02.2016 22:00,3822,18.91,351,340,3471
15.02.2016 23:00,3593,18.47,355,322,3238
16.02.2016 00:00,3420,17.84,346,295,3074
16.02.2016 01:00,3268,18.22,364,283,2904
16.02.2016 02:00,3274,18.14,327,252,2947
16.02.2016 03:00,3267,18.09,291,222,2976
16.02.2016 04:00,3280,18.26,280,200,3000
16.02.2016 05:00,3382,18.65,241,189,3141
16.02.2016 06:00,3598,18.93,237,179,3361
16.02.2016 07:00,4088,23.86,206,168,3882
16.02.2016 08:00,4422,39.46,164,151,4258
16.02.2016 09:00,4438,42.08,117,116,4321
16.02.2016 10:00,4320,42.42,61,90,4259
16.02.2016 11:00,4261,37.23,20,60,4241
16.02.2016 12:00,4161,34.86,15,47,4146
16.02.2016 13:00,4041,31.04,11,40,4030
16.02.2016 14:00,3977,28.59,8,37,3969
16.02.2016 15:00,3883,26.21,11,36,3872
16.02.2016 16:00,3811,23.9,22,24,3789
16.02.2016 17:00,3807,25.39,32,30,3775
16.02.2016 18:00,4037,39.46,66,63,3971
16.02.2016 19:00,4128,42.81,126,84,4002
16.02.2016 20:00,4032,30.35,183,98,3849
16.02.2016 21:00,3877,19.67,249,119,3628
16.02.2016 22:00,3648,18.78,336,146,3312
16.02.2016 23:00,3367,18.25,441,183,2926
17.02.2016 00:00,3133,17.54,495,199,2638
17.02.2016 01:00,3092,17.42,510,273,2582
17.02.2016 02:00,3122,17.19,471,301,2651
17.02.2016 03:00,3114,17,502,305,2612
17.02.2016 04:00,3111,17.15,524,304,2587
17.02.2016 05:00,3136,17.52,542,292,2594
17.02.2016 06:00,3309,17.85,556,296,2753
17.02.2016 07:00,3788,18.39,563,324,3225
17.02.2016 08:00,4167,19.56,560,343,3607
17.02.2016 09:00,4274,25.08,495,344,3779
17.02.2016 10:00,4258,25.01,393,340,3865
17.02.2016 11:00,4276,19.81,309,345,3967
17.02.2016 12:00,4111,19.2,339,325,3772
17.02.2016 13:00,4028,18.9,290,293,3738
17.02.2016 14:00,3987,18.82,271,286,3716
17.02.2016 15:00,3900,18.69,263,291,3637
17.02.2016 16:00,3805,18.68,348,316,3457
17.02.2016 17:00,3772,18.75,472,385,3300
17.02.2016 18:00,3948,19.5,639,489,3309
17.02.2016 19:00,3983,19.76,753,595,3230
17.02.2016 20:00,3955,18.94,769,671,3186
17.02.2016 21:00,3806,18.49,767,687,3039
17.02.2016 22:00,3714,18.22,658,697,3056
17.02.2016 23:00,3553,17.84,551,660,3002
18.02.2016 00:00,3431,17.45,500,611,2931
18.02.2016 01:00,3238,17.94,420,569,2818
18.02.2016 02:00,3254,18.09,343,516,2911
18.02.2016 03:00,3189,18.1,297,434,2892
18.02.2016 04:00,3189,18.37,229,352,2960
18.02.2016 05:00,3188,19.02,177,283,3011
18.02.2016 06:00,3337,19.61,163,222,3174
18.02.2016 07:00,3761,20.61,107,176,3654
18.02.2016 08:00,4025,34.67,83,140,3942
18.02.2016 09:00,4065,38.6,67,118,3998
18.02.2016 10:00,4056,34.49,70,103,3986
18.02.2016 11:00,4033,29.2,90,102,3943
18.02.2016 12:00,4005,25.36,127,111,3878
18.02.2016 13:00,3885,23.77,143,128,3742
18.02.2016 14:00,3905,24.53,147,138,3758
18.02.2016 15:00,3917,25.01,134,140,3783
18.02.2016 16:00,3895,28.34,131,134,3764
18.02.2016 17:00,3910,31.23,122,124,3788
18.02.2016 18:00,4064,37.81,109,122,3955
18.02.2016 19:00,4060,44,97,116,3963
18.02.2016 20:00,3961,34.68,92,107,3869
18.02.2016 21:00,3804,31.47,101,98,3703
18.02.2016 22:00,3621,23.17,105,87,3516
18.02.2016 23:00,3388,19.11,97,80,3291
19.02.2016 00:00,3165,18.16,75,78,3090
19.02.2016 01:00,3071,18.49,62,71,3009
19.02.2016 02:00,3010,18.16,53,66,2957
19.02.2016 03:00,3015,18.13,46,59,2969
19.02.2016 04:00,3073,18.56,35,58,3038
19.02.2016 05:00,3119,19.07,31,54,3088
19.02.2016 06:00,3308,18.99,34,53,3274
19.02.2016 07:00,3751,20.33,38,55,3713
19.02.2016 08:00,4051,30.79,55,57,3996
19.02.2016 09:00,4067,37.56,75,58,3992
19.02.2016 10:00,4027,34.11,65,55,3962
19.02.2016 11:00,3979,33.04,48,57,3931
19.02.2016 12:00,3909,33,38,53,3871
19.02.2016 13:00,3773,30.76,25,54,3748
19.02.2016 14:00,3696,25.07,26,54,3670
19.02.2016 15:00,3612,23.94,36,55,3576
19.02.2016 16:00,3584,19.9,40,58,3544
19.02.2016 17:00,3575,19.82,67,67,3508
19.02.2016 18:00,3734,29.32,119,81,3615
19.02.2016 19:00,3760,34.1,173,107,3587
19.02.2016 20:00,3609,23.88,212,126,3397
19.02.2016 21:00,3427,19.04,235,148,3192
19.02.2016 22:00,3239,18.25,249,168,2990
19.02.2016 23:00,3071,17.68,257,190,2814
20.02.2016 00:00,2928,17.05,251,206,2677
20.02.2016 01:00,2821,17.71,271,239,2550
20.02.2016 02:00,2773,16.82,311,269,2462
20.02.2016 03:00,2739,15.5,390,318,2349
20.02.2016 04:00,2705,15.53,509,389,2196
20.02.2016 05:00,2669,15.72,649,508,2020
20.02.2016 06:00,2736,15.97,794,639,1942
20.02.2016 07:00,2844,16.35,926,772,1918
20.02.2016 08:00,3036,15.07,983,902,2053
20.02.2016 09:00,3198,15.47,1079,1013,2119
20.02.2016 10:00,3346,16.05,1175,1103,2171
20.02.2016 11:00,3505,16.36,1223,1175,2282
20.02.2016 12:00,3587,17,1245,1210,2342
20.02.2016 13:00,3628,16.96,1236,1233,2392
20.02.2016 14:00,3549,15.94,1204,1195,2345
20.02.2016 15:00,3467,15.77,1096,1119,2371
20.02.2016 16:00,3383,16.05,1019,1014,2364
20.02.2016 17:00,3421,16.75,906,927,2515
20.02.2016 18:00,3561,18.38,832,858,2729
20.02.2016 19:00,3625,18.56,725,790,2900
20.02.2016 20:00,3517,18.25,646,736,2871
20.02.2016 21:00,3324,17.11,653,720,2671
20.02.2016 22:00,3120,15.76,692,712,2428
20.02.2016 23:00,2978,15.1,676,683,2302
21.02.2016 00:00,2824,14.33,687,682,2137
21.02.2016 01:00,2825,15.38,658,746,2167
21.02.2016 02:00,2731,14.93,718,738,2013
21.02.2016 03:00,2657,14.76,768,748,1889
21.02.2016 04:00,2700,14.91,739,771,1961
21.02.2016 05:00,2817,14.86,691,813,2126
21.02.2016 06:00,2782,14.94,749,820,2033
21.02.2016 07:00,2864,15.34,758,828,2106
21.02.2016 08:00,2886,15.61,822,841,2064
21.02.2016 09:00,3018,15.91,811,845,2207
21.02.2016 10:00,3046,16.64,878,864,2168
21.02.2016 11:00,3122,16.82,920,880,2202
21.02.2016 12:00,3127,16.66,906,902,2221
21.02.2016 13:00,3125,16.53,885,917,2240
21.02.2016 14:00,3175,15.96,790,893,2385
21.02.2016 15:00,3199,15.77,675,836,2524
21.02.2016 16:00,3238,15.67,630,799,2608
21.02.2016 17:00,3317,15.85,601,762,2716
21.02.2016 18:00,3505,17.31,581,731,2924
21.02.2016 19:00,3481,18.61,639,710,2842
21.02.2016 20:00,3364,18.2,673,709,2691
21.02.2016 21:00,3298,17.46,614,695,2684
21.02.2016 22:00,3242,16.82,509,682,2733
21.02.2016 23:00,3141,16.05,455,658,2686
22.02.2016 00:00,3051,15.33,395,643,2656
22.02.2016 01:00,2938,16.46,350,574,2588
22.02.2016 02:00,2848,15.69,392,585,2456
22.02.2016 03:00,2754,15.55,471,593,2283
22.02.2016 04:00,2804,15.73,525,642,2279
22.02.2016 05:00,2867,16.3,611,713,2256
22.02.2016 06:00,2992,17.44,694,744,2298
22.02.2016 07:00,3399,18.05,725,799,2674
22.02.2016 08:00,3817,20.16,734,851,3083
22.02.2016 09:00,3866,20.53,827,890,3039
22.02.2016 10:00,3742,20.4,946,916,2796
22.02.2016 11:00,3674,20.17,1057,957,2617
22.02.2016 12:00,3624,19.91,1109,998,2515
22.02.2016 13:00,3562,19.58,1106,1017,2456
22.02.2016 14:00,3637,19.28,1030,1007,2607
22.02.2016 15:00,3632,19.07,991,995,2641
22.02.2016 16:00,3660,19.23,938,955,2722
22.02.2016 17:00,3628,19.57,919,918,2709
22.02.2016 18:00,3826,20.27,906,940,2920
22.02.2016 19:00,3841,20.42,953,953,2888
22.02.2016 20:00,3713,20.11,1013,974,2700
22.02.2016 21:00,3508,19.34,1045,992,2463
22.02.2016 22:00,3380,18.75,1010,1019,2370
22.02.2016 23:00,3208,18.2,972,1022,2236
23.02.2016 00:00,3015,17.68,963,1000,2052
23.02.2016 01:00,2837,18.09,923,891,1914
23.02.2016 02:00,2790,17.35,884,871,1906
23.02.2016 03:00,2727,17.23,922,856,1805
23.02.2016 04:00,2756,17.47,907,848,1849
23.02.2016 05:00,2837,17.83,882,840,1955
23.02.2016 06:00,3008,19.09,846,817,2162
23.02.2016 07:00,3434,19.9,811,796,2623
23.02.2016 08:00,3801,21.06,758,796,3043
23.02.2016 09:00,3923,21.82,721,777,3202
23.02.2016 10:00,3895,21.21,697,752,3198
23.02.2016 11:00,3858,20.93,719,729,3139
23.02.2016 12:00,3801,20.74,697,664,3104
23.02.2016 13:00,3759,20.7,642,631,3117
23.02.2016 14:00,3769,20.63,608,608,3161
23.02.2016 15:00,3753,20.43,529,544,3224
23.02.2016 16:00,3745,20.24,431,473,3314
23.02.2016 17:00,3734,20.37,357,415,3377
23.02.2016 18:00,3862,20.96,339,374,3523
23.02.2016 19:00,3872,21.34,352,337,3520
23.02.2016 20:00,3787,20.79,354,306,3433
23.02.2016 21:00,3657,20.23,332,294,3325
23.02.2016 22:00,3470,19.5,286,287,3184
23.02.2016 23:00,3308,18.9,245,284,3063
24.02.2016 00:00,3114,17.9,246,269,2868
24.02.2016 01:00,2972,18.04,248,209,2724
24.02.2016 02:00,2932,17.06,246,228,2686
24.02.2016 03:00,2863,16.99,284,235,2579
24.02.2016 04:00,2847,17.09,340,255,2507
24.02.2016 05:00,2845,17.86,429,297,2416
24.02.2016 06:00,2991,18.92,483,329,2508
24.02.2016 07:00,3388,20,528,375,2860
24.02.2016 08:00,3766,21.29,515,428,3251
24.02.2016 09:00,3899,21.62,488,441,3411
24.02.2016 10:00,3910,21.44,486,469,3424
24.02.2016 11:00,3883,21.27,533,494,3350
24.02.2016 12:00,3820,21.04,549,504,3271
24.02.2016 13:00,3745,20.85,563,519,3182
24.02.2016 14:00,3560,20.61,632,502,2928
24.02.2016 15:00,3621,20.52,630,517,2991
24.02.2016 16:00,3613,20.52,547,492,3066
24.02.2016 17:00,3704,20.68,473,497,3231
24.02.2016 18:00,3934,21.34,413,481,3521
24.02.2016 19:00,4055,22.03,402,472,3653
24.02.2016 20:00,3895,21.41,473,466,3422
24.02.2016 21:00,3674,21.1,561,470,3113
24.02.2016 22:00,3447,20.46,605,474,2842
24.02.2016 23:00,3275,19.53,587,467,2688
25.02.2016 00:00,3113,18.83,532,473,2581
25.02.2016 01:00,3045,19.09,490,468,2555
25.02.2016 02:00,3145,18.86,505,451,2640
25.02.2016 03:00,3151,18.82,476,433,2675
25.02.2016 04:00,3165,19.03,445,422,2720
25.02.2016 05:00,3248,19.46,392,413,2856
25.02.2016 06:00,3432,20.82,375,396,3057
25.02.2016 07:00,3771,21.56,377,378,3394
25.02.2016 08:00,4080,35.18,359,360,3721
25.02.2016 09:00,4163,38.25,311,345,3852
25.02.2016 10:00,4159,34.44,262,334,3897
25.02.2016 11:00,4201,31.35,247,331,3954
25.02.2016 12:00,4130,29.71,256,307,3874
25.02.2016 13:00,4001,25.92,262,287,3739
25.02.2016 14:00,4005,25.39,265,272,3740
25.02.2016 15:00,3950,24.4,243,251,3707
25.02.2016 16:00,3917,24.19,222,233,3695
25.02.2016 17:00,3869,24.78,218,207,3651
25.02.2016 18:00,3963,31.16,248,211,3715
25.02.2016 19:00,4010,38.95,291,218,3719
25.02.2016 20:00,3921,35.08,336,234,3585
25.02.2016 21:00,3786,25.91,380,245,3406
25.02.2016 22:00,3615,21.2,391,248,3224
25.02.2016 23:00,3397,20.26,377,244,3020
26.02.2016 00:00,3278,19.15,331,244,2947
26.02.2016 01:00,3010,18.9,337,263,2673
26.02.2016 02:00,3111,18.46,338,263,2773
26.02.2016 03:00,3082,18.43,324,256,2758
26.02.2016 04:00,3159,18.6,262,276,2897
26.02.2016 05:00,3215,19.34,234,262,2981
26.02.2016 06:00,3360,20.29,258,270,3102
26.02.2016 07:00,3688,20.97,292,287,3396
26.02.2016 08:00,3948,26.61,318,296,3630
26.02.2016 09:00,4117,35.21,303,302,3814
26.02.2016 10:00,4096,32.68,291,310,3805
26.02.2016 11:00,4063,30.92,310,320,3753
26.02.2016 12:00,3926,25.92,317,310,3609
26.02.2016 13:00,3808,24.56,328,301,3480
26.02.2016 14:00,3675,21.03,385,312,3290
26.02.2016 15:00,3370,20.77,459,352,2911
26.02.2016 16:00,3297,20.56,457,358,2840
26.02.2016 17:00,3339,20.76,414,357,2925
26.02.2016 18:00,3544,25.96,400,369,3144
26.02.2016 19:00,3638,38.64,459,373,3179
26.02.2016 20:00,3536,25.92,492,377,3044
26.02.2016 21:00,3373,20.83,537,369,2836
26.02.2016 22:00,3222,20.26,516,361,2706
26.02.2016 23:00,3071,19.69,461,347,2610
27.02.2016 00:00,2922,19.07,456,334,2466
27.02.2016 01:00,2870,19.68,460,344,2410
27.02.2016 02:00,2809,19.42,448,327,2361
27.02.2016 03:00,2792,19.24,424,305,2368
27.02.2016 04:00,2796,19.13,436,292,2360
27.02.2016 05:00,2803,19.19,422,283,2381
27.02.2016 06:00,2884,19.52,385,268,2499
27.02.2016 07:00,2998,19.61,374,266,2624
27.02.2016 08:00,3085,19.7,338,251,2747
27.02.2016 09:00,3291,19.91,273,234,3018
27.02.2016 10:00,3428,19.94,221,230,3207
27.02.2016 11:00,3453,20.02,224,233,3229
27.02.2016 12:00,3349,19.84,292,225,3057
27.02.2016 13:00,3290,19.49,297,238,2993
27.02.2016 14:00,3227,19.18,285,243,2942
27.02.2016 15:00,3208,19.05,258,233,2950
27.02.2016 16:00,3226,19.09,234,222,2992
27.02.2016 17:00,3361,19.4,176,202,3185
27.02.2016 18:00,3517,19.86,172,186,3345
27.02.2016 19:00,3595,25.16,217,182,3378
27.02.2016 20:00,3479,19.98,246,180,3233
27.02.2016 21:00,3356,19.68,228,172,3128
27.02.2016 22:00,3246,19.32,178,163,3068
27.02.2016 23:00,3141,19.2,160,140,2981
28.02.2016 00:00,3034,18.79,131,122,2903
28.02.2016 01:00,2943,19.42,109,117,2834
28.02.2016 02:00,2868,18.39,74,101,2794
28.02.2016 03:00,2837,18.01,50,86,2787
28.02.2016 04:00,2831,17.96,38,74,2793
28.02.2016 05:00,2837,17.88,26,66,2811
28.02.2016 06:00,2846,18.03,43,60,2803
28.02.2016 07:00,2938,18.09,48,57,2890
28.02.2016 08:00,2994,18.16,42,54,2952
28.02.2016 09:00,3101,18.4,36,48,3065
28.02.2016 10:00,3246,19.02,22,42,3224
28.02.2016 11:00,3335,19.04,15,46,3320
28.02.2016 12:00,3354,19.02,20,43,3334
28.02.2016 13:00,3307,18.32,26,46,3281
28.02.2016 14:00,3249,18.19,32,51,3217
28.02.2016 15:00,3218,18.04,36,55,3182
28.02.2016 16:00,3202,17.94,36,59,3166
28.02.2016 17:00,3278,18.16,37,61,3241
28.02.2016 18:00,3480,19.48,62,64,3418
28.02.2016 19:00,3614,24,107,74,3507
28.02.2016 20:00,3599,24.49,139,82,3460
28.02.2016 21:00,3532,20.67,146,81,3386
28.02.2016 22:00,3374,19.72,123,83,3251
28.02.2016 23:00,3242,19.79,107,82,3135
29.02.2016 00:00,3110,19.54,106,77,3004
29.02.2016 01:00,2999,19.25,97,86,2902
29.02.2016 02:00,2972,18.21,69,75,2903
29.02.2016 03:00,2971,18.03,50,68,2921
29.02.2016 04:00,3011,18.01,49,64,2962
29.02.2016 05:00,3076,18.4,54,62,3022
29.02.2016 06:00,3290,19.76,51,63,3239
29.02.2016 07:00,3813,24.28,43,64,3770
29.02.2016 08:00,4131,34.56,35,61,4096
29.02.2016 09:00,4184,32.96,20,56,4164
29.02.2016 10:00,4134,27.99,8,56,4126
29.02.2016 11:00,4109,24.92,9,55,4100
29.02.2016 12:00,4092,23.48,15,58,4077
29.02.2016 13:00,3955,22.22,26,64,3929
29.02.2016 14:00,3853,21.67,31,66,3822
29.02.2016 15:00,3735,21.47,36,69,3699
29.02.2016 16:00,3694,21.71,39,72,3655
29.02.2016 17:00,3682,22.03,29,79,3653
29.02.2016 18:00,3833,25.94,34,88,3799
29.02.2016 19:00,4027,33.22,58,99,3969
29.02.2016 20:00,3972,30.46,73,109,3899
29.02.2016 21:00,3857,21.21,70,121,3787
29.02.2016 22:00,3712,20.01,71,132,3641
29.02.2016 23:00,3493,19.65,105,142,3388
03.01.2016 00:00,3316,18.83,126,150,3190
03.01.2016 01:00,3126,19.27,126,123,3000
03.01.2016 02:00,3106,19.05,96,115,3010
03.01.2016 03:00,3097,18.97,81,111,3016
03.01.2016 04:00,3087,19.03,108,110,2979
03.01.2016 05:00,3096,19.32,132,116,2964
03.01.2016 06:00,3226,19.77,175,123,3051
03.01.2016 07:00,3552,19.99,234,137,3318
03.01.2016 08:00,3919,24.08,230,152,3689
03.01.2016 09:00,4111,30,159,160,3952
03.01.2016 10:00,4059,24.07,133,182,3926
03.01.2016 11:00,4015,24.07,149,185,3866
03.01.2016 12:00,3883,24.02,213,186,3670
03.01.2016 13:00,3763,19.98,225,185,3538
03.01.2016 14:00,3765,19.86,237,194,3528
03.01.2016 15:00,3694,19.76,258,197,3436
03.01.2016 16:00,3713,19.65,294,212,3419
03.01.2016 17:00,3687,19.65,339,231,3348
03.01.2016 18:00,3806,19.86,383,275,3423
03.01.2016 19:00,3939,24.03,375,332,3564
03.01.2016 20:00,3871,19.78,374,348,3497
03.01.2016 21:00,3708,19.48,415,367,3293
03.01.2016 22:00,3480,19.09,451,374,3029
03.01.2016 23:00,3306,18.29,394,373,2912
03.02.2016 00:00,3091,17.16,415,395,2676
03.02.2016 01:00,2917,16.99,434,398,2483
03.02.2016 02:00,2938,16.97,388,411,2550
03.02.2016 03:00,2928,17,392,428,2536
03.02.2016 04:00,2949,17.04,430,460,2519
03.02.2016 05:00,2963,17.38,469,492,2494
03.02.2016 06:00,3144,18.1,484,537,2660
03.02.2016 07:00,3633,19.2,484,565,3149
03.02.2016 08:00,3980,22.53,487,580,3493
03.02.2016 09:00,4073,24.65,490,589,3583
03.02.2016 10:00,4098,24.09,507,589,3591
03.02.2016 11:00,4268,25.01,529,582,3739
03.02.2016 12:00,4072,25.03,577,589,3495
03.02.2016 13:00,4003,25.04,547,557,3456
03.02.2016 14:00,3996,25.17,549,546,3447
03.02.2016 15:00,3953,25.09,543,525,3410
03.02.2016 16:00,3932,25.07,541,528,3391
03.02.2016 17:00,3837,25.09,551,493,3286
03.02.2016 18:00,3851,31.23,542,437,3309
03.02.2016 19:00,3828,39.04,553,408,3275
03.02.2016 20:00,3643,35.98,596,386,3047
03.02.2016 21:00,3372,25.21,628,332,2744
03.02.2016 22:00,3139,20.59,655,301,2484
03.02.2016 23:00,2799,19.87,702,269,2097
03.03.2016 00:00,2667,19.32,656,239,2011
03.03.2016 01:00,2618,19.54,491,194,2127
03.03.2016 02:00,2674,19.1,385,191,2289
03.03.2016 03:00,2762,18.54,258,139,2504
03.03.2016 04:00,2795,18.08,191,109,2604
03.03.2016 05:00,2881,18.7,122,92,2759
03.03.2016 06:00,3039,19.96,117,72,2922
03.03.2016 07:00,3533,23.88,86,66,3447
03.03.2016 08:00,3877,30.19,70,73,3807
03.03.2016 09:00,3980,31.04,43,58,3937
03.03.2016 10:00,3954,30.94,37,61,3917
03.03.2016 11:00,3971,30.57,29,61,3942
03.03.2016 12:00,3929,31.17,22,56,3907
03.03.2016 13:00,3821,29.35,38,57,3783
03.03.2016 14:00,3770,29.79,62,59,3708
03.03.2016 15:00,3750,29.34,78,68,3672
03.03.2016 16:00,3772,30.23,101,82,3671
03.03.2016 17:00,3716,30.22,122,89,3594
03.03.2016 18:00,3831,32.06,111,102,3720
03.03.2016 19:00,3916,41.69,112,106,3804
03.03.2016 20:00,3860,32.47,97,106,3763
03.03.2016 21:00,3729,25.44,84,104,3645
03.03.2016 22:00,3557,25.01,79,105,3478
03.03.2016 23:00,3333,20.53,97,104,3236
03.04.2016 00:00,3139,19.78,93,101,3046
03.04.2016 01:00,2967,19.91,91,102,2876
03.04.2016 02:00,2916,19.55,78,103,2838
03.04.2016 03:00,2885,19.28,64,93,2821
03.04.2016 04:00,2888,19.1,58,92,2830
03.04.2016 05:00,2913,19.08,62,92,2851
03.04.2016 06:00,3074,20.18,70,87,3004
03.04.2016 07:00,3525,21.44,61,86,3464
03.04.2016 08:00,3820,30.97,74,85,3746
03.04.2016 09:00,3938,33.16,56,86,3882
03.04.2016 10:00,3940,29.32,50,83,3890
03.04.2016 11:00,3942,26.69,53,76,3889
03.04.2016 12:00,3900,23.78,50,76,3850
03.04.2016 13:00,3818,22.48,45,72,3773
03.04.2016 14:00,3724,21.78,40,72,3684
03.04.2016 15:00,3663,21.39,45,73,3618
03.04.2016 16:00,3634,21.36,58,76,3576
03.04.2016 17:00,3618,21.28,67,85,3551
03.04.2016 18:00,3743,25.05,83,102,3660
03.04.2016 19:00,3779,25.28,118,125,3661
03.04.2016 20:00,3614,21.34,163,144,3451
03.04.2016 21:00,3396,21.04,229,164,3167
03.04.2016 22:00,3212,20.67,252,184,2960
03.04.2016 23:00,3072,20.14,255,207,2817
03.05.2016 00:00,2949,19.73,256,229,2693
03.05.2016 01:00,2824,19.66,259,265,2565
03.05.2016 02:00,2716,19.17,310,270,2406
03.05.2016 03:00,2626,19.04,381,282,2245
03.05.2016 04:00,2586,18.96,393,270,2193
03.05.2016 05:00,2635,18.88,429,335,2206
03.05.2016 06:00,2629,19.01,538,373,2091
03.05.2016 07:00,2681,19.12,603,403,2078
03.05.2016 08:00,2839,19.83,583,427,2256
03.05.2016 09:00,3097,20.32,550,460,2547
03.05.2016 10:00,3314,20.88,526,498,2788
03.05.2016 11:00,3356,21.07,558,488,2798
03.05.2016 12:00,3320,20.99,623,548,2697
03.05.2016 13:00,3300,20.78,616,558,2684
03.05.2016 14:00,3270,20.23,634,579,2636
03.05.2016 15:00,3134,19.93,745,620,2389
03.05.2016 16:00,3066,19.91,807,636,2259
03.05.2016 17:00,3168,20.52,815,682,2353
03.05.2016 18:00,3392,20.96,806,727,2586
03.05.2016 19:00,3452,21.36,844,747,2608
03.05.2016 20:00,3349,21.11,856,764,2493
03.05.2016 21:00,3183,20.61,848,772,2335
03.05.2016 22:00,3109,20.41,810,774,2299
03.05.2016 23:00,3022,19.93,784,776,2238
03.06.2016 00:00,2907,19.52,776,770,2131
03.06.2016 01:00,2708,20.03,756,696,1952
03.06.2016 02:00,2677,19.46,751,742,1926
03.06.2016 03:00,2650,19.13,755,749,1895
03.06.2016 04:00,2705,18.69,711,757,1994
03.06.2016 05:00,2815,18.58,625,778,2190
03.06.2016 06:00,2933,18.83,559,802,2374
03.06.2016 07:00,3031,18.65,557,820,2474
03.06.2016 08:00,3110,18.78,558,811,2552
03.06.2016 09:00,3263,19.28,558,793,2705
03.06.2016 10:00,3437,19.99,549,779,2888
03.06.2016 11:00,3542,20.26,541,747,3001
03.06.2016 12:00,3617,20.51,528,720,3089
03.06.2016 13:00,3660,20.01,488,706,3172
03.06.2016 14:00,3663,19.15,430,686,3233
03.06.2016 15:00,3647,18.84,374,643,3273
03.06.2016 16:00,3662,18.83,313,600,3349
03.06.2016 17:00,3695,19.19,277,544,3418
03.06.2016 18:00,3653,20.57,259,501,3394
03.06.2016 19:00,3883,22.83,252,415,3631
03.06.2016 20:00,3814,21.87,231,364,3583
03.06.2016 21:00,3644,21.13,175,310,3469
03.06.2016 22:00,3442,20.94,123,265,3319
03.06.2016 23:00,3269,20.3,82,231,3187
03.07.2016 00:00,3129,19.59,90,230,3039
03.07.2016 01:00,2928,19.93,127,175,2801
03.07.2016 02:00,2879,19.74,160,190,2719
03.07.2016 03:00,2841,19.63,193,214,2648
03.07.2016 04:00,2872,19.51,216,245,2656
03.07.2016 05:00,2926,19.79,242,275,2684
03.07.2016 06:00,3126,21.01,268,309,2858
03.07.2016 07:00,3572,21.49,274,346,3298
03.07.2016 08:00,3927,24.18,270,385,3657
03.07.2016 09:00,4028,25.71,311,431,3717
03.07.2016 10:00,4005,28.65,344,459,3661
03.07.2016 11:00,3991,27.57,372,462,3619
03.07.2016 12:00,3918,25.68,430,475,3488
03.07.2016 13:00,3769,25.18,485,471,3284
03.07.2016 14:00,3722,24.91,457,448,3265
03.07.2016 15:00,3641,24.22,487,432,3154
03.07.2016 16:00,3660,22.9,464,393,3196
03.07.2016 17:00,3668,23.34,435,401,3233
03.07.2016 18:00,3741,29.91,437,361,3304
03.07.2016 19:00,3858,32.95,405,335,3453
03.07.2016 20:00,3779,28.55,413,319,3366
03.07.2016 21:00,3609,25.06,406,294,3203
03.07.2016 22:00,3433,21.78,401,287,3032
03.07.2016 23:00,3174,21.22,356,264,2818
03.08.2016 00:00,3046,20.82,299,227,2747
03.08.2016 01:00,2906,21.01,268,198,2638
03.08.2016 02:00,2895,20.62,224,178,2671
03.08.2016 03:00,2866,20.58,191,152,2675
03.08.2016 04:00,2900,20.66,175,133,2725
03.08.2016 05:00,2952,20.98,159,125,2793
03.08.2016 06:00,3138,21.55,141,117,2997
03.08.2016 07:00,3595,23.64,112,113,3483
03.08.2016 08:00,3899,32.96,85,109,3814
03.08.2016 09:00,3935,37.75,72,102,3863
03.08.2016 10:00,3884,34.14,66,101,3818
03.08.2016 11:00,3825,28.61,101,105,3724
03.08.2016 12:00,3722,25.42,137,111,3585
03.08.2016 13:00,3658,25,150,129,3508
03.08.2016 14:00,3682,24.64,145,137,3537
03.08.2016 15:00,3679,24.21,143,138,3536
03.08.2016 16:00,3697,24.49,125,129,3572
03.08.2016 17:00,3660,25.05,109,132,3551
03.08.2016 18:00,3744,32.31,101,122,3643
03.08.2016 19:00,3849,35.03,127,125,3722
03.08.2016 20:00,3766,32.54,178,127,3588
03.08.2016 21:00,3634,25.03,187,143,3447
03.08.2016 22:00,3491,22.97,176,159,3315
03.08.2016 23:00,3260,21.38,176,168,3084
03.09.2016 00:00,3015,20.7,200,175,2815
03.09.2016 01:00,2859,21.04,201,200,2658
03.09.2016 02:00,2790,20.59,205,192,2585
03.09.2016 03:00,2824,20.27,184,175,2640
03.09.2016 04:00,2839,20.08,159,163,2680
03.09.2016 05:00,2902,20.01,139,155,2763
03.09.2016 06:00,3104,21.14,130,148,2974
03.09.2016 07:00,3496,22.27,134,145,3362
03.09.2016 08:00,3830,25.09,121,140,3709
03.09.2016 09:00,3883,29.2,94,128,3789
03.09.2016 10:00,3879,25.03,66,121,3813
03.09.2016 11:00,3876,23.43,76,121,3800
03.09.2016 12:00,3788,23.85,99,125,3689
03.09.2016 13:00,3622,22.28,112,129,3510
03.09.2016 14:00,3555,21.96,114,126,3441
03.09.2016 15:00,3484,22.16,96,121,3388
03.09.2016 16:00,3473,22.5,91,119,3382
03.09.2016 17:00,3468,24.23,105,120,3363
03.09.2016 18:00,3602,26.05,118,124,3484
03.09.2016 19:00,3666,37.84,159,111,3507
03.09.2016 20:00,3716,26.08,186,140,3530
03.09.2016 21:00,3601,23.37,203,145,3398
03.09.2016 22:00,3502,22.27,146,143,3356
03.09.2016 23:00,3325,21.58,124,150,3201
03.10.2016 00:00,3113,21.01,126,142,2987
03.10.2016 01:00,2915,20.73,152,147,2763
03.10.2016 02:00,2857,20.17,170,158,2687
03.10.2016 03:00,2814,20.04,187,171,2627
03.10.2016 04:00,2814,20.16,211,191,2603
03.10.2016 05:00,2890,20.94,225,209,2665
03.10.2016 06:00,3075,21.73,240,219,2835
03.10.2016 07:00,3456,23.48,250,221,3206
03.10.2016 08:00,3792,25.56,254,223,3538
03.10.2016 09:00,3889,31.23,252,221,3637
03.10.2016 10:00,3872,29.33,207,218,3665
03.10.2016 11:00,3857,24.95,170,210,3687
03.10.2016 12:00,3832,24.38,162,209,3670
03.10.2016 13:00,3773,24.67,165,191,3608
03.10.2016 14:00,3710,24.38,163,180,3547
03.10.2016 15:00,3630,24.06,148,166,3482
03.10.2016 16:00,3639,24.03,143,167,3496
03.10.2016 17:00,3564,24.03,144,180,3420
03.10.2016 18:00,3675,24.98,141,197,3534
03.10.2016 19:00,3856,26.78,173,208,3683
03.10.2016 20:00,3814,25.47,227,214,3587
03.10.2016 21:00,3661,24.23,234,211,3427
03.10.2016 22:00,3531,23.36,227,203,3304
03.10.2016 23:00,3369,22.17,155,197,3214
03.11.2016 00:00,3145,21.23,133,183,3012
03.11.2016 01:00,2961,21.5,123,171,2838
03.11.2016 02:00,2900,20.85,116,159,2784
03.11.2016 03:00,2897,21.03,101,141,2796
03.11.2016 04:00,2931,21.06,86,141,2845
03.11.2016 05:00,2995,21.75,83,151,2912
03.11.2016 06:00,3201,22.39,85,157,3116
03.11.2016 07:00,3594,24.48,88,166,3506
03.11.2016 08:00,3932,34.47,89,161,3843
03.11.2016 09:00,4029,38.34,77,144,3952
03.11.2016 10:00,4006,36.69,47,122,3959
03.11.2016 11:00,3949,32.91,32,101,3917
03.11.2016 12:00,3824,31.98,21,86,3803
03.11.2016 13:00,3729,29.81,20,75,3709
03.11.2016 14:00,3580,26.38,19,70,3561
03.11.2016 15:00,3427,24.74,27,52,3400
03.11.2016 16:00,3366,24.32,30,65,3336
03.11.2016 17:00,3410,24.28,26,61,3384
03.11.2016 18:00,3505,27.23,19,58,3486
03.11.2016 19:00,3693,32.55,27,58,3666
03.11.2016 20:00,3626,32.43,43,58,3583
03.11.2016 21:00,3467,24.34,46,56,3421
03.11.2016 22:00,3330,24.42,34,54,3296
03.11.2016 23:00,3165,23.23,33,47,3132
03.12.2016 00:00,2991,22.07,44,45,2947
03.12.2016 01:00,2838,22.47,53,39,2785
03.12.2016 02:00,2780,22.33,46,38,2734
03.12.2016 03:00,2778,22.28,56,36,2722
03.12.2016 04:00,2776,22.28,69,36,2707
03.12.2016 05:00,2787,22.4,81,38,2706
03.12.2016 06:00,2867,22.67,80,41,2787
03.12.2016 07:00,2968,22.72,92,43,2876
03.12.2016 08:00,3084,22.86,88,43,2996
03.12.2016 09:00,3247,23.47,58,39,3189
03.12.2016 10:00,3419,24.79,27,41,3392
03.12.2016 11:00,3374,24.79,33,45,3341
03.12.2016 12:00,3333,24.29,38,43,3295
03.12.2016 13:00,3191,23.03,42,41,3149
03.12.2016 14:00,3058,22.48,50,40,3008
03.12.2016 15:00,2980,22.28,51,38,2929
03.12.2016 16:00,2928,22.23,50,39,2878
03.12.2016 17:00,3006,22.38,48,44,2958
03.12.2016 18:00,3228,23.95,44,52,3184
03.12.2016 19:00,3451,25.94,40,57,3411
03.12.2016 20:00,3416,24.36,46,59,3370
03.12.2016 21:00,3266,22.73,45,56,3221
03.12.2016 22:00,3131,22.67,42,56,3089
03.12.2016 23:00,3045,22.62,33,59,3012
13.03.2016 00:00,2972,22.39,28,50,2944
13.03.2016 01:00,2809,22.46,19,37,2790
13.03.2016 02:00,2744,22.11,11,33,2733
13.03.2016 03:00,2701,21.67,6,29,2695
13.03.2016 04:00,2702,21.05,4,27,2698
13.03.2016 05:00,2708,21.12,5,24,2703
13.03.2016 06:00,2750,21.47,11,26,2739
13.03.2016 07:00,2771,21.33,14,29,2757
13.03.2016 08:00,2865,21.6,14,31,2851
13.03.2016 09:00,3031,21.84,5,34,3026
13.03.2016 10:00,3229,22.08,3,34,3226
13.03.2016 11:00,3321,22.17,5,40,3316
13.03.2016 12:00,3358,22.09,8,47,3350
13.03.2016 13:00,3353,21.59,11,57,3342
13.03.2016 14:00,3295,20.91,16,67,3279
13.03.2016 15:00,3224,20.75,31,80,3193
13.03.2016 16:00,3209,20.74,42,90,3167
13.03.2016 17:00,3232,21.23,54,104,3178
13.03.2016 18:00,3356,22.01,75,116,3281
13.03.2016 19:00,3571,24.16,86,122,3485
13.03.2016 20:00,3568,23.88,100,119,3468
13.03.2016 21:00,3469,22.8,87,118,3382
13.03.2016 22:00,3299,22.44,87,115,3212
13.03.2016 23:00,3078,22.36,81,110,2997
14.03.2016 00:00,2927,22.08,91,107,2836
14.03.2016 01:00,2836,21.17,87,130,2749
14.03.2016 02:00,2772,20.59,75,122,2697
14.03.2016 03:00,2728,20.22,68,113,2660
14.03.2016 04:00,2771,20.25,53,107,2718
14.03.2016 05:00,2814,20.83,49,102,2765
14.03.2016 06:00,2978,21.92,53,100,2925
14.03.2016 07:00,3404,23.18,69,98,3335
14.03.2016 08:00,3747,34.58,76,95,3671
14.03.2016 09:00,3812,34.95,63,86,3749
14.03.2016 10:00,3837,30.99,44,78,3793
14.03.2016 11:00,3786,28.82,46,64,3740
14.03.2016 12:00,3806,23.97,56,76,3750
14.03.2016 13:00,3742,23.26,52,83,3690
14.03.2016 14:00,3690,22.84,58,90,3632
14.03.2016 15:00,3654,22.55,65,106,3589
14.03.2016 16:00,3689,22.49,68,128,3621
14.03.2016 17:00,3634,24.2,102,171,3532
14.03.2016 18:00,3658,29.98,201,230,3457
14.03.2016 19:00,3759,38.53,257,275,3502
14.03.2016 20:00,3732,29.42,297,317,3435
14.03.2016 21:00,3602,23.95,319,347,3283
14.03.2016 22:00,3443,22.25,330,368,3113
14.03.2016 23:00,3172,22.02,361,384,2811
15.03.2016 00:00,2946,21.1,367,377,2579
15.03.2016 01:00,2772,20.6,380,390,2392
15.03.2016 02:00,2665,20.26,378,359,2287
15.03.2016 03:00,2700,20.33,302,335,2398
15.03.2016 04:00,2664,20.24,303,314,2361
15.03.2016 05:00,2679,20.86,317,294,2362
15.03.2016 06:00,2818,21.86,321,272,2497
15.03.2016 07:00,3210,22.4,308,272,2902
15.03.2016 08:00,3588,24.88,282,267,3306
15.03.2016 09:00,3665,35.52,248,266,3417
15.03.2016 10:00,3626,35.09,225,253,3401
15.03.2016 11:00,3632,35.23,204,243,3428
15.03.2016 12:00,3624,25.6,191,233,3433
15.03.2016 13:00,3549,24.9,168,223,3381
15.03.2016 14:00,3547,22.95,148,213,3399
15.03.2016 15:00,3430,22.56,154,182,3276
15.03.2016 16:00,3401,22.33,138,179,3263
15.03.2016 17:00,3347,22.25,141,156,3206
15.03.2016 18:00,3360,24.84,143,146,3217
15.03.2016 19:00,3512,31.14,168,141,3344
15.03.2016 20:00,3550,33.31,173,131,3377
15.03.2016 21:00,3483,25.51,148,122,3335
15.03.2016 22:00,3329,22.29,110,108,3219
15.03.2016 23:00,3114,21.92,89,85,3025
16.03.2016 00:00,2918,20.95,96,72,2822
16.03.2016 01:00,2788,20.71,104,59,2684
16.03.2016 02:00,2712,20.42,132,58,2580
16.03.2016 03:00,2725,20.27,144,52,2581
16.03.2016 04:00,2755,20.06,139,59,2616
16.03.2016 05:00,2825,20.49,130,67,2695
16.03.2016 06:00,3034,21.59,120,70,2914
16.03.2016 07:00,3470,22.38,108,79,3362
16.03.2016 08:00,3798,33.13,74,77,3724
16.03.2016 09:00,3798,32.2,39,67,3759
16.03.2016 10:00,3702,24.42,17,58,3685
16.03.2016 11:00,3654,22.48,13,54,3641
16.03.2016 12:00,3585,22.43,23,58,3562
16.03.2016 13:00,3467,22.16,39,62,3428
16.03.2016 14:00,3411,21.85,60,81,3351
16.03.2016 15:00,3332,21.9,88,97,3244
16.03.2016 16:00,3299,21.79,103,111,3196
16.03.2016 17:00,3229,23.1,110,128,3119
16.03.2016 18:00,3322,29.2,140,153,3182
16.03.2016 19:00,3364,34.74,247,174,3117
16.03.2016 20:00,3351,25.91,371,192,2980
16.03.2016 21:00,3202,31.08,393,206,2809
16.03.2016 22:00,3071,21.99,410,217,2661
16.03.2016 23:00,2821,21.37,450,227,2371
17.03.2016 00:00,2657,20.58,441,243,2216
17.03.2016 01:00,2570,20.69,425,271,2145
17.03.2016 02:00,2528,20.17,418,280,2110
17.03.2016 03:00,2502,20.28,443,291,2059
17.03.2016 04:00,2519,20.56,440,302,2079
17.03.2016 05:00,2620,21.09,427,312,2193
17.03.2016 06:00,2862,22.06,392,325,2470
17.03.2016 07:00,3233,22.4,365,339,2868
17.03.2016 08:00,3588,23.7,312,327,3276
17.03.2016 09:00,3661,34.13,246,306,3415
17.03.2016 10:00,3645,25.36,202,284,3443
17.03.2016 11:00,3649,23.11,187,273,3462
17.03.2016 12:00,3600,22.87,174,266,3426
17.03.2016 13:00,3460,22.38,182,260,3278
17.03.2016 14:00,3418,22.2,173,260,3245
17.03.2016 15:00,3348,22.15,196,263,3152
17.03.2016 16:00,3302,22.07,251,264,3051
17.03.2016 17:00,3302,22.16,292,284,3010
17.03.2016 18:00,3400,24.49,311,295,3089
17.03.2016 19:00,3465,37.88,347,298,3118
17.03.2016 20:00,3423,30.38,384,295,3039
17.03.2016 21:00,3313,22.29,374,294,2939
17.03.2016 22:00,3093,22.11,361,288,2732
17.03.2016 23:00,2913,21.62,350,290,2563
18.03.2016 00:00,2668,20.92,363,274,2305
18.03.2016 01:00,2541,20.31,389,283,2152
18.03.2016 02:00,2449,19.47,366,272,2083
18.03.2016 03:00,2438,19.49,374,276,2064
18.03.2016 04:00,2452,19.67,393,287,2059
18.03.2016 05:00,2539,20.14,389,308,2150
18.03.2016 06:00,2742,21.58,384,321,2358
18.03.2016 07:00,3124,22.16,395,328,2729
18.03.2016 08:00,3509,22.82,349,312,3160
18.03.2016 09:00,3635,29.22,308,304,3327
18.03.2016 10:00,3550,22.96,305,300,3245
18.03.2016 11:00,3506,22.43,304,308,3202
18.03.2016 12:00,3448,22.37,313,306,3135
18.03.2016 13:00,3349,22.18,302,296,3047
18.03.2016 14:00,3266,22.01,267,279,2999
18.03.2016 15:00,3215,22.02,234,273,2981
18.03.2016 16:00,3144,22.02,253,249,2891
18.03.2016 17:00,3126,22.07,229,235,2897
18.03.2016 18:00,3247,22.26,184,225,3063
18.03.2016 19:00,3406,25.46,144,204,3262
18.03.2016 20:00,3428,25.44,117,174,3311
18.03.2016 21:00,3310,22.38,69,141,3241
18.03.2016 22:00,3123,22.13,80,128,3043
18.03.2016 23:00,2890,21.75,141,112,2749
19.03.2016 00:00,2690,21.12,198,106,2492
19.03.2016 01:00,2615,21.31,190,107,2425
19.03.2016 02:00,2566,21.16,171,116,2395
19.03.2016 03:00,2580,21.14,135,130,2445
19.03.2016 04:00,2620,21.26,101,133,2519
19.03.2016 05:00,2650,21.3,92,132,2558
19.03.2016 06:00,2707,21.52,94,137,2613
19.03.2016 07:00,2817,21.59,82,130,2735
19.03.2016 08:00,2932,21.76,109,136,2823
19.03.2016 09:00,3039,21.84,105,144,2934
19.03.2016 10:00,3118,22.28,112,163,3006
19.03.2016 11:00,3084,22.13,143,185,2941
19.03.2016 12:00,2972,21.89,229,224,2743
19.03.2016 13:00,2833,21.45,329,267,2504
19.03.2016 14:00,2702,21.13,401,306,2301
19.03.2016 15:00,2564,20.65,518,365,2046
19.03.2016 16:00,2501,20.42,566,374,1935
19.03.2016 17:00,2711,20.79,451,388,2260
19.03.2016 18:00,2957,21.7,312,364,2645
19.03.2016 19:00,3194,22.2,243,351,2951
19.03.2016 20:00,3149,22.2,287,319,2862
19.03.2016 21:00,3017,21.72,293,312,2724
19.03.2016 22:00,2844,21.53,335,297,2509
19.03.2016 23:00,2732,21.31,334,276,2398
20.03.2016 00:00,2622,20.71,330,268,2292
20.03.2016 01:00,2524,20.17,311,271,2213
20.03.2016 02:00,2497,19.68,272,257,2225
20.03.2016 03:00,2430,19.37,269,235,2161
20.03.2016 04:00,2457,19.25,254,214,2203
20.03.2016 05:00,2484,19.36,205,204,2279
20.03.2016 06:00,2579,19.64,147,184,2432
20.03.2016 07:00,2596,19.74,129,166,2467
20.03.2016 08:00,2680,19.69,100,146,2580
20.03.2016 09:00,2826,19.92,66,123,2760
20.03.2016 10:00,2922,20.3,45,101,2877
20.03.2016 11:00,2925,20.59,35,75,2890
20.03.2016 12:00,2950,20.66,44,95,2906
20.03.2016 13:00,2851,20.52,54,91,2797
20.03.2016 14:00,2750,20.21,89,123,2661
20.03.2016 15:00,2642,20.15,155,143,2487
20.03.2016 16:00,2590,20.14,203,165,2387
20.03.2016 17:00,2623,20.05,245,181,2378
20.03.2016 18:00,2766,20.57,227,193,2539
20.03.2016 19:00,3016,21.99,257,210,2759
20.03.2016 20:00,3139,22.19,277,230,2862
20.03.2016 21:00,3017,21.86,292,246,2725
20.03.2016 22:00,2907,21.54,305,259,2602
20.03.2016 23:00,2699,21.27,385,265,2314
21.03.2016 00:00,2590,20.33,380,275,2210
21.03.2016 01:00,2491,20.29,388,325,2103
21.03.2016 02:00,2477,19.9,366,315,2111
21.03.2016 03:00,2458,19.79,379,313,2079
21.03.2016 04:00,2434,19.9,416,304,2018
21.03.2016 05:00,2490,20.4,399,296,2091
21.03.2016 06:00,2677,21.33,381,279,2296
21.03.2016 07:00,3040,21.68,344,267,2696
21.03.2016 08:00,3458,22.11,282,259,3176
21.03.2016 09:00,3657,22.32,183,264,3474
21.03.2016 10:00,3690,22.22,139,263,3551
21.03.2016 11:00,3678,22.16,134,253,3544
21.03.2016 12:00,3580,22,153,265,3427
21.03.2016 13:00,3398,21.84,216,283,3182
21.03.2016 14:00,3278,21.72,319,307,2959
21.03.2016 15:00,3172,21.57,381,326,2791
21.03.2016 16:00,3144,21.55,420,342,2724
21.03.2016 17:00,3145,21.56,376,318,2769
21.03.2016 18:00,3297,21.88,275,289,3022
21.03.2016 19:00,3481,22.19,207,257,3274
21.03.2016 20:00,3466,22.25,230,250,3236
21.03.2016 21:00,3303,22.07,240,222,3063
21.03.2016 22:00,3162,21.85,203,191,2959
21.03.2016 23:00,2996,21.58,173,170,2823
22.03.2016 00:00,2793,20.9,146,152,2647
22.03.2016 01:00,2633,20.33,121,132,2512
22.03.2016 02:00,2589,20.08,97,115,2492
22.03.2016 03:00,2582,20.05,74,98,2508
22.03.2016 04:00,2612,20.47,56,88,2556
22.03.2016 05:00,2659,21,49,74,2610
22.03.2016 06:00,2816,21.49,34,64,2782
22.03.2016 07:00,3161,21.71,24,59,3137
22.03.2016 08:00,3517,22.24,18,47,3499
22.03.2016 09:00,3575,26.79,10,37,3565
22.03.2016 10:00,3574,25.63,10,36,3564
22.03.2016 11:00,3562,24.47,8,36,3554
22.03.2016 12:00,3517,23.09,20,38,3497
22.03.2016 13:00,3452,22.53,37,37,3415
22.03.2016 14:00,3421,22.32,56,40,3365
22.03.2016 15:00,3349,22.08,83,56,3266
22.03.2016 16:00,3318,22.13,103,70,3215
22.03.2016 17:00,3347,21.76,112,91,3235
22.03.2016 18:00,3386,21.96,139,105,3247
22.03.2016 19:00,3522,22.17,193,158,3329
22.03.2016 20:00,3519,22.23,229,159,3290
22.03.2016 21:00,3370,22.12,263,183,3107
22.03.2016 22:00,3182,21.93,285,206,2897
22.03.2016 23:00,2926,21.41,314,221,2612
23.03.2016 00:00,2691,20.91,332,233,2359
23.03.2016 01:00,2563,20.89,317,267,2246
23.03.2016 02:00,2527,20.51,296,262,2231
23.03.2016 03:00,2527,20.26,266,246,2261
23.03.2016 04:00,2558,20.56,241,223,2317
23.03.2016 05:00,2627,20.87,219,199,2408
23.03.2016 06:00,2812,21.23,199,182,2613
23.03.2016 07:00,3180,21.6,140,170,3040
23.03.2016 08:00,3571,21.94,99,160,3472
23.03.2016 09:00,3683,25.25,100,123,3583
23.03.2016 10:00,3690,22.06,106,134,3584
23.03.2016 11:00,3713,21.98,103,145,3610
23.03.2016 12:00,3732,21.89,89,163,3643
23.03.2016 13:00,3591,21.72,107,159,3484
23.03.2016 14:00,3607,21.64,135,182,3472
23.03.2016 15:00,3547,21.57,170,212,3377
23.03.2016 16:00,3469,21.51,230,236,3239
23.03.2016 17:00,3421,21.55,231,256,3190
23.03.2016 18:00,3500,21.76,163,248,3337
23.03.2016 19:00,3626,22.28,149,242,3477
23.03.2016 20:00,3701,23.23,149,233,3552
23.03.2016 21:00,3529,22.31,121,176,3408
23.03.2016 22:00,3367,21.87,99,155,3268
23.03.2016 23:00,3203,21.59,73,140,3130
24.03.2016 00:00,3022,21.14,46,124,2976
24.03.2016 01:00,2913,21.35,28,107,2885
24.03.2016 02:00,2842,20.99,18,90,2824
24.03.2016 03:00,2820,20.7,19,69,2801
24.03.2016 04:00,2811,20.86,14,61,2797
24.03.2016 05:00,2851,21.23,13,57,2838
24.03.2016 06:00,3031,21.82,15,57,3016
24.03.2016 07:00,3333,21.67,22,55,3311
24.03.2016 08:00,3645,21.8,17,53,3628
24.03.2016 09:00,3735,25.06,11,63,3724
24.03.2016 10:00,3639,25.05,14,52,3625
24.03.2016 11:00,3577,25.01,36,58,3541
24.03.2016 12:00,3527,21.6,66,77,3461
24.03.2016 13:00,3418,21.3,112,102,3306
24.03.2016 14:00,3339,21.01,149,132,3190
24.03.2016 15:00,3226,20.8,180,162,3046
24.03.2016 16:00,3197,20.68,210,192,2987
24.03.2016 17:00,3202,20.69,254,226,2948
24.03.2016 18:00,3267,20.87,284,261,2983
24.03.2016 19:00,3334,21.05,355,282,2979
24.03.2016 20:00,3311,21.14,417,303,2894
24.03.2016 21:00,3165,21.08,406,335,2759
24.03.2016 22:00,2984,20.84,394,353,2590
24.03.2016 23:00,2797,20.53,377,354,2420
25.03.2016 00:00,2610,20.3,382,358,2228
25.03.2016 01:00,2454,20.7,371,319,2083
25.03.2016 02:00,2357,20.28,361,302,1996
25.03.2016 03:00,2341,20.25,332,295,2009
25.03.2016 04:00,2319,19.99,307,281,2012
25.03.2016 05:00,2350,20.01,270,273,2080
25.03.2016 06:00,2383,20.3,251,260,2132
25.03.2016 07:00,2463,20.26,228,251,2235
25.03.2016 08:00,2620,20.39,229,240,2391
25.03.2016 09:00,2836,20.82,199,245,2637
25.03.2016 10:00,3011,21.05,170,253,2841
25.03.2016 11:00,3072,21.05,179,261,2893
25.03.2016 12:00,3068,20.9,200,272,2868
25.03.2016 13:00,3032,20.75,200,281,2832
25.03.2016 14:00,2980,20.42,215,286,2765
25.03.2016 15:00,2924,20.31,217,274,2707
25.03.2016 16:00,2914,20.28,238,277,2676
25.03.2016 17:00,2889,20.36,271,276,2618
25.03.2016 18:00,2917,20.47,300,266,2617
25.03.2016 19:00,2946,20.83,342,269,2604
25.03.2016 20:00,2906,21.01,379,272,2527
25.03.2016 21:00,2753,20.8,413,282,2340
25.03.2016 22:00,2660,20.54,394,300,2266
25.03.2016 23:00,2526,20.45,445,335,2081
26.03.2016 00:00,2410,20.15,453,350,1957
26.03.2016 01:00,2322,20.82,424,366,1898
26.03.2016 02:00,2311,20.54,386,359,1925
26.03.2016 03:00,2246,20.43,405,322,1841
26.03.2016 04:00,2240,20,342,287,1898
26.03.2016 05:00,2258,20,301,249,1957
26.03.2016 06:00,2283,20.01,268,217,2015
26.03.2016 07:00,2355,20.01,198,180,2157
26.03.2016 08:00,2526,20.47,82,145,2444
26.03.2016 09:00,2696,20.88,40,112,2656
26.03.2016 10:00,2762,21.11,27,78,2735
26.03.2016 11:00,2759,20.91,36,57,2723
26.03.2016 12:00,2660,19.97,46,70,2614
26.03.2016 13:00,2556,19.06,62,83,2494
26.03.2016 14:00,2449,18.26,117,107,2332
26.03.2016 15:00,2357,17.54,161,134,2196
26.03.2016 16:00,2335,17.73,196,158,2139
26.03.2016 17:00,2383,17.87,226,203,2157
26.03.2016 18:00,2512,19.2,238,271,2274
26.03.2016 19:00,2613,20.12,390,362,2223
26.03.2016 20:00,2565,20.09,636,446,1929
26.03.2016 21:00,2468,19.94,787,537,1681
26.03.2016 22:00,2383,18.72,873,623,1510
26.03.2016 23:00,2304,17.91,956,730,1348
27.03.2016 00:00,2222,17.26,1008,794,1214
27.03.2016 01:00,2187,16.27,1019,858,1168
27.03.2016 02:00,2122,15.11,1025,881,1097
27.03.2016 03:00,2761.949947,36.96376226,446.1037531,443.144979,2315.846194
27.03.2016 04:00,2071,15.42,1038,851,1033
27.03.2016 05:00,2060,14.02,1093,905,967
27.03.2016 06:00,2117,15.43,1101,937,1016
27.03.2016 07:00,2181,11.18,1114,979,1067
27.03.2016 08:00,2204,16.33,1121,1020,1083
27.03.2016 09:00,2287,16.28,1140,1060,1147
27.03.2016 10:00,2414,17.07,1155,1100,1259
27.03.2016 11:00,2473,17.31,1185,1144,1288
27.03.2016 12:00,2469,17.36,1199,1172,1270
27.03.2016 13:00,2448,16.81,1211,1173,1237
27.03.2016 14:00,2389,16.02,1208,1151,1181
27.03.2016 15:00,2342,15.43,1163,1115,1179
27.03.2016 16:00,2347,15.52,1082,1052,1265
27.03.2016 17:00,2476,15.98,958,969,1518
27.03.2016 18:00,2652,17.03,726,844,1926
27.03.2016 19:00,2806,17.54,502,700,2304
27.03.2016 20:00,2877,19.6,393,563,2484
27.03.2016 21:00,2888,20.43,299,463,2589
27.03.2016 22:00,2715,19.87,283,375,2432
27.03.2016 23:00,2567,19.5,268,326,2299
28.03.2016 00:00,2412,18.5,277,278,2135
28.03.2016 01:00,2306,15.09,261,275,2045
28.03.2016 02:00,2244,14.05,245,266,1999
28.03.2016 03:00,2215,14.12,232,265,1983
28.03.2016 04:00,2223,14.71,249,285,1974
28.03.2016 05:00,2269,15.59,275,318,1994
28.03.2016 06:00,2291,16.7,322,333,1969
28.03.2016 07:00,2396,16.29,354,366,2042
28.03.2016 08:00,2453,16.43,428,403,2025
28.03.2016 09:00,2552,16.81,463,451,2089
28.03.2016 10:00,2681,17.68,446,500,2235
28.03.2016 11:00,2645,18.28,573,562,2072
28.03.2016 12:00,2575,18.53,716,635,1859
28.03.2016 13:00,2495,18.1,819,722,1676
28.03.2016 14:00,2446,17.82,883,804,1563
28.03.2016 15:00,2403,17.63,910,860,1493
28.03.2016 16:00,2405,17.55,910,879,1495
28.03.2016 17:00,2458,17.57,923,887,1535
28.03.2016 18:00,2577,17.5,916,905,1661
28.03.2016 19:00,2682,18.19,894,927,1788
28.03.2016 20:00,2801,18.49,876,944,1925
28.03.2016 21:00,2864,18.68,851,950,2013
28.03.2016 22:00,2805,18.22,803,953,2002
28.03.2016 23:00,2627,17.78,801,938,1826
29.03.2016 00:00,2572,16.81,690,881,1882
29.03.2016 01:00,2462,16.37,553,751,1909
29.03.2016 02:00,2409,16.34,409,647,2000
29.03.2016 03:00,2308,15.67,397,543,1911
29.03.2016 04:00,2235,15.79,407,447,1828
29.03.2016 05:00,2231,16.77,399,382,1832
29.03.2016 06:00,2448,18.5,350,354,2098
29.03.2016 07:00,2908,20.12,297,333,2611
29.03.2016 08:00,3264,21.08,275,319,2989
29.03.2016 09:00,3373,21.37,223,303,3150
29.03.2016 10:00,3368,21.37,172,287,3196
29.03.2016 11:00,3390,21.24,155,293,3235
29.03.2016 12:00,3328,21.06,218,329,3110
29.03.2016 13:00,3146,20.43,311,326,2835
29.03.2016 14:00,3044,19.99,416,365,2628
29.03.2016 15:00,2980,19.83,492,399,2488
29.03.2016 16:00,2897,19.72,526,429,2371
29.03.2016 17:00,2894,19.86,490,448,2404
29.03.2016 18:00,3006,20.76,439,449,2567
29.03.2016 19:00,3135,21.2,299,424,2836
29.03.2016 20:00,3178,21.34,269,385,2909
29.03.2016 21:00,3218,21.4,335,378,2883
29.03.2016 22:00,2956,21.14,442,365,2514
29.03.2016 23:00,2690,20.5,522,367,2168
30.03.2016 00:00,2484,20.08,570,385,1914
30.03.2016 01:00,2422,20.3,522,385,1900
30.03.2016 02:00,2382,20.13,514,381,1868
30.03.2016 03:00,2340,20.2,510,361,1830
30.03.2016 04:00,2375,19.92,447,327,1928
30.03.2016 05:00,2443,20.18,394,305,2049
30.03.2016 06:00,2649,21.08,353,288,2296
30.03.2016 07:00,3100,21.67,277,264,2823
30.03.2016 08:00,3481,22.21,199,250,3282
30.03.2016 09:00,3670,23.14,124,232,3546
30.03.2016 10:00,3616,22.53,124,223,3492
30.03.2016 11:00,3581,21.99,141,218,3440
30.03.2016 12:00,3542,21.83,197,240,3345
30.03.2016 13:00,3559,21.64,201,277,3358
30.03.2016 14:00,3574,21.58,196,309,3378
30.03.2016 15:00,3536,21.51,244,349,3292
30.03.2016 16:00,3485,21.39,293,377,3192
30.03.2016 17:00,3362,21.34,368,403,2994
30.03.2016 18:00,3434,21.51,343,400,3091
30.03.2016 19:00,3431,21.69,295,381,3136
30.03.2016 20:00,3473,21.88,269,372,3204
30.03.2016 21:00,3449,21.9,245,345,3204
30.03.2016 22:00,3341,21.69,194,337,3147
30.03.2016 23:00,3095,21.35,198,342,2897
31.03.2016 00:00,2851,21.04,237,337,2614
31.03.2016 01:00,2700,20.55,238,328,2462
31.03.2016 02:00,2636,20.24,248,345,2388
31.03.2016 03:00,2589,20.16,255,332,2334
31.03.2016 04:00,2551,20.22,259,316,2292
31.03.2016 05:00,2586,20.61,254,300,2332
31.03.2016 06:00,2751,21.54,248,274,2503
31.03.2016 07:00,3138,22.28,236,259,2902
31.03.2016 08:00,3383,35.22,243,247,3140
31.03.2016 09:00,3510,39.98,226,237,3284
31.03.2016 10:00,3489,35.58,223,238,3266
31.03.2016 11:00,3485,33.81,270,258,3215
31.03.2016 12:00,3479,33.14,283,274,3196
31.03.2016 13:00,3417,29.31,281,283,3136
31.03.2016 14:00,3330,29.3,333,297,2997
31.03.2016 15:00,3207,27.25,373,312,2834
31.03.2016 16:00,3161,24.52,412,320,2749
31.03.2016 17:00,3014,24.13,515,345,2499
31.03.2016 18:00,2920,24.33,601,368,2319
31.03.2016 19:00,2952,26.78,580,381,2372
31.03.2016 20:00,3023,30.33,564,391,2459
31.03.2016 21:00,3122,31.22,610,428,2512
31.03.2016 22:00,3084,21.69,584,456,2500
31.03.2016 23:00,2827,21.29,662,480,2165
04.01.2016 00:00,2666,20.43,683,517,1983
04.01.2016 01:00,2674,20.69,699,650,1975
04.01.2016 02:00,2619,20.31,715,658,1904
04.01.2016 03:00,2587,20.34,734,650,1853
04.01.2016 04:00,2616,20.14,725,642,1891
04.01.2016 05:00,2694,20.62,720,649,1974
04.01.2016 06:00,2893,21.26,709,654,2184
04.01.2016 07:00,3328,22.06,609,646,2719
04.01.2016 08:00,3713,33.29,521,649,3192
04.01.2016 09:00,3781,39.47,455,639,3326
04.01.2016 10:00,3602,37.47,552,646,3050
04.01.2016 11:00,3560,33.74,587,648,2973
04.01.2016 12:00,3492,29.82,600,653,2892
04.01.2016 13:00,3372,25.17,628,659,2744
04.01.2016 14:00,3285,21.93,637,649,2648
04.01.2016 15:00,3202,21.74,583,619,2619
04.01.2016 16:00,3159,21.62,496,586,2663
04.01.2016 17:00,3095,21.57,447,550,2648
04.01.2016 18:00,3117,21.69,358,483,2759
04.01.2016 19:00,3094,25.9,245,380,2849
04.01.2016 20:00,3099,21.89,182,293,2917
04.01.2016 21:00,3137,33.21,177,245,2960
04.01.2016 22:00,3010,21.76,162,219,2848
04.01.2016 23:00,2789,21.5,226,203,2563
04.02.2016 00:00,2581,21.06,291,187,2290
04.02.2016 01:00,2400,21.13,344,207,2056
04.02.2016 02:00,2313,20.8,361,240,1952
04.02.2016 03:00,2300,20.6,388,271,1912
04.02.2016 04:00,2295,19.84,340,273,1955
04.02.2016 05:00,2364,19.91,298,270,2066
04.02.2016 06:00,2379,20.09,352,284,2027
04.02.2016 07:00,2415,20.19,393,298,2022
04.02.2016 08:00,2540,20.79,422,326,2118
04.02.2016 09:00,2790,21.14,363,351,2427
04.02.2016 10:00,2923,21.33,258,329,2665
04.02.2016 11:00,2883,20.81,281,330,2602
04.02.2016 12:00,2655,20.08,409,323,2246
04.02.2016 13:00,2495,19.77,513,350,1982
04.02.2016 14:00,2418,19.76,560,396,1858
04.02.2016 15:00,2342,19.36,578,425,1764
04.02.2016 16:00,2347,19.28,538,434,1809
04.02.2016 17:00,2386,19.41,518,430,1868
04.02.2016 18:00,2556,20.45,448,420,2108
04.02.2016 19:00,2669,21.54,389,424,2280
04.02.2016 20:00,2727,21.72,391,439,2336
04.02.2016 21:00,2765,21.55,427,450,2338
04.02.2016 22:00,2632,21.38,471,460,2161
04.02.2016 23:00,2534,21.17,449,466,2085
04.03.2016 00:00,2419,20.92,457,469,1962
04.03.2016 01:00,2292,20.19,453,429,1839
04.03.2016 02:00,2187,18.9,438,402,1749
04.03.2016 03:00,2164,18.56,393,361,1771
04.03.2016 04:00,2191,18.52,321,316,1870
04.03.2016 05:00,2200,18.29,273,279,1927
04.03.2016 06:00,2303,18.4,195,248,2108
04.03.2016 07:00,2375,18.43,129,216,2246
04.03.2016 08:00,2418,18.57,120,181,2298
04.03.2016 09:00,2539,19.03,77,139,2462
04.03.2016 10:00,2640,19.41,47,108,2593
04.03.2016 11:00,2684,19.72,34,94,2650
04.03.2016 12:00,2706,19.83,41,86,2665
04.03.2016 13:00,2673,19.29,47,97,2626
04.03.2016 14:00,2625,19.18,52,104,2573
04.03.2016 15:00,2562,19.15,78,110,2484
04.03.2016 16:00,2542,19.58,136,139,2406
04.03.2016 17:00,2577,20.12,112,127,2465
04.03.2016 18:00,2730,20.45,70,142,2660
04.03.2016 19:00,2790,21.19,99,170,2691
04.03.2016 20:00,2811,22,219,190,2592
04.03.2016 21:00,2866,22.02,235,208,2631
04.03.2016 22:00,2728,21.68,238,208,2490
04.03.2016 23:00,2562,21.38,204,205,2358
04.04.2016 00:00,2390,20.71,215,210,2175
04.04.2016 01:00,2308,20.5,240,232,2068
04.04.2016 02:00,2255,19.59,243,233,2012
04.04.2016 03:00,2219,19.16,267,235,1952
04.04.2016 04:00,2225,19.15,307,236,1918
04.04.2016 05:00,2270,19.34,317,249,1953
04.04.2016 06:00,2475,20.55,316,260,2159
04.04.2016 07:00,2907,22.19,321,264,2586
04.04.2016 08:00,3225,23.98,349,270,2876
04.04.2016 09:00,3395,34.57,252,256,3143
04.04.2016 10:00,3411,32.69,156,247,3255
04.04.2016 11:00,3394,28.91,144,236,3250
04.04.2016 12:00,3339,24.5,145,229,3194
04.04.2016 13:00,3229,22.81,145,207,3084
04.04.2016 14:00,3200,23.26,144,204,3056
04.04.2016 15:00,3146,23.09,119,201,3027
04.04.2016 16:00,3085,22.49,116,200,2969
04.04.2016 17:00,3018,22.48,133,208,2885
04.04.2016 18:00,3030,22.7,145,214,2885
04.04.2016 19:00,2967,22.91,214,240,2753
04.04.2016 20:00,2979,22.92,260,262,2719
04.04.2016 21:00,2931,23.5,380,281,2551
04.04.2016 22:00,2778,22.71,407,298,2371
04.04.2016 23:00,2650,22.02,335,271,2315
04.05.2016 00:00,2384,21.23,360,264,2024
04.05.2016 01:00,2319,20.37,301,273,2018
04.05.2016 02:00,2311,20.04,239,236,2072
04.05.2016 03:00,2264,20.02,231,191,2033
04.05.2016 04:00,2283,19.82,182,157,2101
04.05.2016 05:00,2382,20.08,117,132,2265
04.05.2016 06:00,2593,21.26,72,107,2521
04.05.2016 07:00,3010,22.87,35,106,2975
04.05.2016 08:00,3344,31.98,26,94,3318
04.05.2016 09:00,3389,34.41,19,81,3370
04.05.2016 10:00,3346,34.08,10,62,3336
04.05.2016 11:00,3380,33.28,7,53,3373
04.05.2016 12:00,3384,32.14,8,48,3376
04.05.2016 13:00,3205,28.81,16,47,3189
04.05.2016 14:00,3141,25.94,34,48,3107
04.05.2016 15:00,3089,24.15,29,51,3060
04.05.2016 16:00,3101,23.61,33,56,3068
04.05.2016 17:00,3056,23.39,35,61,3021
04.05.2016 18:00,3065,25.26,37,65,3028
04.05.2016 19:00,3009,23.6,49,65,2960
04.05.2016 20:00,2982,24.81,131,75,2851
04.05.2016 21:00,3024,24.29,142,82,2882
04.05.2016 22:00,2917,23.06,107,105,2810
04.05.2016 23:00,2672,22.35,120,137,2552
04.06.2016 00:00,2494,21.27,122,158,2372
04.06.2016 01:00,2289,20,145,125,2144
04.06.2016 02:00,2143,19.2,226,142,1917
04.06.2016 03:00,1949,19.06,432,173,1517
04.06.2016 04:00,1768,18.95,703,259,1065
04.06.2016 05:00,1870,19.02,815,387,1055
04.06.2016 06:00,2015,20,942,477,1073
04.06.2016 07:00,2419,21.6,997,544,1422
04.06.2016 08:00,2942,22.89,928,654,2014
04.06.2016 09:00,3137,23.63,922,727,2215
04.06.2016 10:00,3084,22.91,1032,787,2052
04.06.2016 11:00,3206,22.68,1100,898,2106
04.06.2016 12:00,3269,21.97,1111,1023,2158
04.06.2016 13:00,3213,21.41,1134,1032,2079
04.06.2016 14:00,3268,21.03,1073,1029,2195
04.06.2016 15:00,3277,21.33,1006,1010,2271
04.06.2016 16:00,3268,20.86,921,960,2347
04.06.2016 17:00,3203,20.68,858,906,2345
04.06.2016 18:00,3151,21.29,801,839,2350
04.06.2016 19:00,3163,21.7,718,766,2445
04.06.2016 20:00,3286,21.88,551,685,2735
04.06.2016 21:00,3318,21.98,520,635,2798
04.06.2016 22:00,3083,21.46,582,618,2501
04.06.2016 23:00,2828,20.15,589,636,2239
04.07.2016 00:00,2586,19.01,662,665,1924
04.07.2016 01:00,2482,16.96,660,703,1822
04.07.2016 02:00,2384,16,749,756,1635
04.07.2016 03:00,2360,15.94,790,791,1570
04.07.2016 04:00,2369,15.42,806,809,1563
04.07.2016 05:00,2351,16.82,894,840,1457
04.07.2016 06:00,2401,18.95,1003,831,1398
04.07.2016 07:00,2744,20.67,1028,848,1716
04.07.2016 08:00,3260,21.62,883,875,2377
04.07.2016 09:00,3338,22.03,949,909,2389
04.07.2016 10:00,3271,21.93,1047,957,2224
04.07.2016 11:00,3329,21.55,1074,1043,2255
04.07.2016 12:00,3352,21.46,1119,1122,2233
04.07.2016 13:00,3330,21.35,1136,1180,2194
04.07.2016 14:00,3337,21.26,1154,1229,2183
04.07.2016 15:00,3251,21.19,1181,1258,2070
04.07.2016 16:00,3223,20.96,1203,1266,2020
04.07.2016 17:00,3154,21.07,1213,1256,1941
04.07.2016 18:00,3159,21.23,1128,1206,2031
04.07.2016 19:00,3196,21.47,1019,1134,2177
04.07.2016 20:00,3206,21.85,936,1051,2270
04.07.2016 21:00,3256,21.87,909,987,2347
04.07.2016 22:00,3123,21.49,917,964,2206
04.07.2016 23:00,2854,20.96,924,934,1930
04.08.2016 00:00,2625,20.03,921,908,1704
04.08.2016 01:00,2433,19.55,955,869,1478
04.08.2016 02:00,2374,19.29,911,846,1463
04.08.2016 03:00,2391,19.24,843,817,1548
04.08.2016 04:00,2428,19.3,776,775,1652
04.08.2016 05:00,2430,19.64,759,725,1671
04.08.2016 06:00,2673,20.32,683,692,1990
04.08.2016 07:00,2977,21.28,653,664,2324
04.08.2016 08:00,3355,22.63,600,629,2755
04.08.2016 09:00,3518,23.79,558,614,2960
04.08.2016 10:00,3533,23.83,509,594,3024
04.08.2016 11:00,3489,23.52,535,572,2954
04.08.2016 12:00,3432,22.99,561,590,2871
04.08.2016 13:00,3305,22.87,601,587,2704
04.08.2016 14:00,3244,22.61,599,599,2645
04.08.2016 15:00,3104,22.29,663,617,2441
04.08.2016 16:00,2983,21.67,688,589,2295
04.08.2016 17:00,2946,21.69,633,568,2313
04.08.2016 18:00,2997,21.85,522,512,2475
04.08.2016 19:00,3019,22.25,414,448,2605
04.08.2016 20:00,2985,22.18,354,388,2631
04.08.2016 21:00,2960,22.05,347,340,2613
04.08.2016 22:00,2837,22.03,375,325,2462
04.08.2016 23:00,2665,21.46,369,312,2296
04.09.2016 00:00,2538,20.96,383,312,2155
04.09.2016 01:00,2452,21.2,389,344,2063
04.09.2016 02:00,2410,20.83,364,343,2046
04.09.2016 03:00,2388,20.71,386,333,2002
04.09.2016 04:00,2371,20.79,376,314,1995
04.09.2016 05:00,2450,20.77,332,296,2118
04.09.2016 06:00,2500,21.02,312,279,2188
04.09.2016 07:00,2527,21.36,298,247,2229
04.09.2016 08:00,2648,21.4,236,216,2412
04.09.2016 09:00,2819,22.11,132,193,2687
04.09.2016 10:00,2897,22.51,147,211,2750
04.09.2016 11:00,2826,22.4,205,193,2621
04.09.2016 12:00,2745,22.25,220,182,2525
04.09.2016 13:00,2709,21.83,218,169,2491
04.09.2016 14:00,2645,20.81,179,165,2466
04.09.2016 15:00,2559,20.2,145,148,2414
04.09.2016 16:00,2526,20.35,131,128,2395
04.09.2016 17:00,2533,20.72,95,107,2438
04.09.2016 18:00,2612,21.86,52,83,2560
04.09.2016 19:00,2662,22.58,36,63,2626
04.09.2016 20:00,2672,22.52,23,52,2649
04.09.2016 21:00,2780,22.36,25,49,2755
04.09.2016 22:00,2767,22.14,37,51,2730
04.09.2016 23:00,2657,21.74,43,52,2614
04.10.2016 00:00,2578,21.25,48,65,2530
04.10.2016 01:00,2472,20.99,71,77,2401
04.10.2016 02:00,2390,20.17,114,94,2276
04.10.2016 03:00,2379,19.73,133,113,2246
04.10.2016 04:00,2392,19.59,146,130,2246
04.10.2016 05:00,2413,19.6,159,148,2254
04.10.2016 06:00,2443,19.5,172,159,2271
04.10.2016 07:00,2467,19.55,174,159,2293
04.10.2016 08:00,2523,19.66,184,149,2339
04.10.2016 09:00,2615,20.22,151,126,2464
04.10.2016 10:00,2738,20.97,74,101,2664
04.10.2016 11:00,2780,21.05,40,86,2740
04.10.2016 12:00,2721,21.06,64,79,2657
04.10.2016 13:00,2631,20.28,95,72,2536
04.10.2016 14:00,2603,20.12,104,75,2499
04.10.2016 15:00,2605,20.03,95,99,2510
04.10.2016 16:00,2628,20.07,82,113,2546
04.10.2016 17:00,2660,20.45,79,111,2581
04.10.2016 18:00,2693,20.79,93,114,2600
04.10.2016 19:00,2712,21.29,101,129,2611
04.10.2016 20:00,2818,21.93,91,141,2727
04.10.2016 21:00,2925,21.96,100,147,2825
04.10.2016 22:00,2842,21.89,131,160,2711
04.10.2016 23:00,2682,21.32,146,178,2536
04.11.2016 00:00,2503,20.09,188,190,2315
04.11.2016 01:00,2390,20.02,210,188,2180
04.11.2016 02:00,2344,19.4,233,201,2111
04.11.2016 03:00,2337,19.33,270,221,2067
04.11.2016 04:00,2379,19.54,297,253,2082
04.11.2016 05:00,2432,20.3,346,279,2086
04.11.2016 06:00,2549,21.23,452,299,2097
04.11.2016 07:00,2887,22.31,508,321,2379
04.11.2016 08:00,3234,24.76,506,335,2728
04.11.2016 09:00,3358,29.88,356,329,3002
04.11.2016 10:00,3284,28.29,362,330,2922
04.11.2016 11:00,3157,24.96,483,335,2674
04.11.2016 12:00,3044,22.96,519,351,2525
04.11.2016 13:00,3053,22.52,447,372,2606
04.11.2016 14:00,3063,22.36,410,378,2653
04.11.2016 15:00,3046,22.12,385,372,2661
04.11.2016 16:00,3021,21.83,353,358,2668
04.11.2016 17:00,2915,22.06,348,341,2567
04.11.2016 18:00,2935,22.35,338,331,2597
04.11.2016 19:00,2883,22.39,309,310,2574
04.11.2016 20:00,2947,22.45,274,305,2673
04.11.2016 21:00,3036,22.63,294,311,2742
04.11.2016 22:00,2942,22.37,387,321,2555
04.11.2016 23:00,2768,21.83,385,333,2383
04.12.2016 00:00,2598,21.17,354,331,2244
04.12.2016 01:00,2478,20.74,388,383,2090
04.12.2016 02:00,2443,20.42,396,375,2047
04.12.2016 03:00,2422,20.37,409,372,2013
04.12.2016 04:00,2437,20.37,439,369,1998
04.12.2016 05:00,2461,20.65,482,371,1979
04.12.2016 06:00,2626,21.45,532,388,2094
04.12.2016 07:00,2910,22.25,581,407,2329
04.12.2016 08:00,3274,23.39,535,419,2739
04.12.2016 09:00,3478,24.99,343,403,3135
04.12.2016 10:00,3412,24.49,324,389,3088
04.12.2016 11:00,3258,22.93,417,399,2841
04.12.2016 12:00,3114,22.62,505,402,2609
04.12.2016 13:00,3041,22.44,559,419,2482
04.12.2016 14:00,2986,22.41,521,395,2465
04.12.2016 15:00,3052,22.32,431,365,2621
04.12.2016 16:00,3039,22.21,371,335,2668
04.12.2016 17:00,3074,22.14,285,318,2789
04.12.2016 18:00,3109,22.25,233,291,2876
04.12.2016 19:00,3157,22.3,174,295,2983
04.12.2016 20:00,3157,22.44,158,277,2999
04.12.2016 21:00,3198,22.57,181,286,3017
04.12.2016 22:00,3048,22.5,218,282,2830
04.12.2016 23:00,2820,22.05,251,301,2569
13.04.2016 00:00,2655,21.54,255,312,2400
13.04.2016 01:00,2509,21.76,263,321,2246
13.04.2016 02:00,2430,21.26,250,310,2180
13.04.2016 03:00,2378,21.2,269,297,2109
13.04.2016 04:00,2349,21.28,282,288,2067
13.04.2016 05:00,2347,21.7,303,284,2044
13.04.2016 06:00,2495,22.26,333,293,2162
13.04.2016 07:00,2824,22.99,340,294,2484
13.04.2016 08:00,3231,27.59,315,285,2916
13.04.2016 09:00,3428,34.94,220,257,3208
13.04.2016 10:00,3476,32.14,161,240,3315
13.04.2016 11:00,3448,28.73,157,204,3291
13.04.2016 12:00,3351,26.76,184,187,3167
13.04.2016 13:00,3285,25.05,186,175,3099
13.04.2016 14:00,3278,24.55,190,177,3088
13.04.2016 15:00,3260,24.22,190,181,3070
13.04.2016 16:00,3217,23.33,202,185,3015
13.04.2016 17:00,3130,23.08,215,184,2915
13.04.2016 18:00,3177,23.48,211,193,2966
13.04.2016 19:00,3179,23.55,219,200,2960
13.04.2016 20:00,3217,23.55,211,211,3006
13.04.2016 21:00,3245,23.83,200,216,3045
13.04.2016 22:00,3108,23.48,215,232,2893
13.04.2016 23:00,2877,22.94,224,233,2653
14.04.2016 00:00,2648,22.5,255,240,2393
14.04.2016 01:00,2432,21.84,332,249,2100
14.04.2016 02:00,2339,21.4,363,256,1976
14.04.2016 03:00,2365,21.18,347,286,2018
14.04.2016 04:00,2372,20.94,370,307,2002
14.04.2016 05:00,2398,21.06,409,324,1989
14.04.2016 06:00,2520,22.28,441,334,2079
14.04.2016 07:00,2864,23.05,425,330,2439
14.04.2016 08:00,3273,31.27,376,326,2897
14.04.2016 09:00,3379,37.28,345,317,3034
14.04.2016 10:00,3398,34.59,283,301,3115
14.04.2016 11:00,3426,30.91,247,278,3179
14.04.2016 12:00,3406,28.08,206,250,3200
14.04.2016 13:00,3291,26.4,191,218,3100
14.04.2016 14:00,3265,25.05,173,194,3092
14.04.2016 15:00,3195,23.83,138,171,3057
14.04.2016 16:00,3225,23.44,112,150,3113
14.04.2016 17:00,3183,23.22,78,133,3105
14.04.2016 18:00,3231,23.62,53,121,3178
14.04.2016 19:00,3178,24.32,49,106,3129
14.04.2016 20:00,3182,23.67,43,96,3139
14.04.2016 21:00,3198,23.47,56,89,3142
14.04.2016 22:00,3102,22.98,75,100,3027
14.04.2016 23:00,2855,22.74,138,125,2717
15.04.2016 00:00,2592,22.23,223,154,2369
15.04.2016 01:00,2438,21.35,293,197,2145
15.04.2016 02:00,2417,20.8,339,238,2078
15.04.2016 03:00,2396,20.45,364,266,2032
15.04.2016 04:00,2453,20.14,342,289,2111
15.04.2016 05:00,2512,20.34,351,305,2161
15.04.2016 06:00,2688,21.43,356,314,2332
15.04.2016 07:00,2987,22.61,394,317,2593
15.04.2016 08:00,3342,23.45,404,327,2938
15.04.2016 09:00,3442,24.59,393,348,3049
15.04.2016 10:00,3419,23.97,446,405,2973
15.04.2016 11:00,3340,23.74,556,465,2784
15.04.2016 12:00,3294,23.24,611,525,2683
15.04.2016 13:00,3171,23.08,657,567,2514
15.04.2016 14:00,3140,22.93,638,596,2502
15.04.2016 15:00,3105,22.65,589,599,2516
15.04.2016 16:00,3072,21.89,486,593,2586
15.04.2016 17:00,3060,21.74,456,570,2604
15.04.2016 18:00,3102,22.13,402,527,2700
15.04.2016 19:00,3134,22.66,351,498,2783
15.04.2016 20:00,3028,22.65,357,481,2671
15.04.2016 21:00,2945,22.69,364,437,2581
15.04.2016 22:00,2802,22.69,349,403,2453
15.04.2016 23:00,2603,22.56,341,367,2262
16.04.2016 00:00,2448,21.92,294,327,2154
16.04.2016 01:00,2384,21.36,248,335,2136
16.04.2016 02:00,2365,20.35,160,302,2205
16.04.2016 03:00,2317,19.88,146,273,2171
16.04.2016 04:00,2267,19.4,141,238,2126
16.04.2016 05:00,2265,19.42,135,221,2130
16.04.2016 06:00,2289,19.54,152,207,2137
16.04.2016 07:00,2339,19.94,115,190,2224
16.04.2016 08:00,2432,20.43,129,171,2303
16.04.2016 09:00,2583,21.14,144,148,2439
16.04.2016 10:00,2800,21.64,106,172,2694
16.04.2016 11:00,2858,21.36,114,197,2744
16.04.2016 12:00,2827,21.24,130,216,2697
16.04.2016 13:00,2727,20.9,176,234,2551
16.04.2016 14:00,2663,20.56,209,272,2454
16.04.2016 15:00,2574,20.37,260,317,2314
16.04.2016 16:00,2539,20.15,303,363,2236
16.04.2016 17:00,2553,20.36,349,419,2204
16.04.2016 18:00,2658,20.59,344,446,2314
16.04.2016 19:00,2666,20.83,398,484,2268
16.04.2016 20:00,2773,21.41,316,518,2457
16.04.2016 21:00,2783,21.72,364,532,2419
16.04.2016 22:00,2650,21.59,518,557,2132
16.04.2016 23:00,2443,21.22,638,596,1805
17.04.2016 00:00,2293,20.33,713,631,1580
17.04.2016 01:00,2377,19.33,690,792,1687
17.04.2016 02:00,2256,17.74,755,801,1501
17.04.2016 03:00,2203,16.24,775,783,1428
17.04.2016 04:00,2089,15.63,882,796,1207
17.04.2016 05:00,2101,15.65,953,824,1148
17.04.2016 06:00,2145,15.24,986,883,1159
17.04.2016 07:00,2194,15.33,1020,956,1174
17.04.2016 08:00,2314,16.94,1068,1034,1246
17.04.2016 09:00,2471,18.14,1121,1106,1350
17.04.2016 10:00,2587,19.15,1192,1179,1395
17.04.2016 11:00,2696,19.31,1201,1220,1495
17.04.2016 12:00,2739,19.57,1236,1256,1503
17.04.2016 13:00,2723,19.3,1257,1278,1466
17.04.2016 14:00,2669,19.27,1308,1294,1361
17.04.2016 15:00,2651,18.92,1305,1300,1346
17.04.2016 16:00,2662,18.52,1291,1299,1371
17.04.2016 17:00,2757,18.16,1223,1290,1534
17.04.2016 18:00,2886,18.81,1188,1258,1698
17.04.2016 19:00,2960,19.35,1124,1219,1836
17.04.2016 20:00,3047,20.51,1004,1169,2043
17.04.2016 21:00,3054,21.2,984,1169,2070
17.04.2016 22:00,2950,21.29,1068,1174,1882
17.04.2016 23:00,2798,20.64,1084,1175,1714
18.04.2016 00:00,2624,19.93,1098,1160,1526
18.04.2016 01:00,2503,19.84,1067,1104,1436
18.04.2016 02:00,2472,19.61,999,1071,1473
18.04.2016 03:00,2478,19.1,958,1028,1520
18.04.2016 04:00,2502,18.9,904,987,1598
18.04.2016 05:00,2537,19,899,960,1638
18.04.2016 06:00,2703,20.54,884,946,1819
18.04.2016 07:00,3023,21.44,854,922,2169
18.04.2016 08:00,3412,22.46,827,908,2585
18.04.2016 09:00,3426,22.71,904,924,2522
18.04.2016 10:00,3394,22.46,934,959,2460
18.04.2016 11:00,3474,22.12,930,1008,2544
18.04.2016 12:00,3422,21.85,1019,1046,2403
18.04.2016 13:00,3398,21.14,1088,1096,2310
18.04.2016 14:00,3428,20.7,1123,1167,2305
18.04.2016 15:00,3309,20.65,1212,1203,2097
18.04.2016 16:00,3330,20.49,1233,1226,2097
18.04.2016 17:00,3329,20.31,1230,1273,2099
18.04.2016 18:00,3348,20.7,1235,1274,2113
18.04.2016 19:00,3290,20.72,1261,1287,2029
18.04.2016 20:00,3218,20.67,1272,1292,1946
18.04.2016 21:00,3222,21.04,1252,1287,1970
18.04.2016 22:00,3082,20.92,1230,1264,1852
18.04.2016 23:00,2832,19.77,1230,1240,1602
19.04.2016 00:00,2718,19.09,1149,1239,1569
19.04.2016 01:00,2579,18.85,1111,1209,1468
19.04.2016 02:00,2539,17.15,1138,1228,1401
19.04.2016 03:00,2458,14.93,1217,1257,1241
19.04.2016 04:00,2441,15.5,1271,1310,1170
19.04.2016 05:00,2528,18.44,1293,1370,1235
19.04.2016 06:00,2751,19.27,1283,1424,1468
19.04.2016 07:00,3074,20.59,1329,1461,1745
19.04.2016 08:00,3411,22.06,1355,1477,2056
19.04.2016 09:00,3512,22.49,1351,1475,2161
19.04.2016 10:00,3517,21.96,1344,1474,2173
19.04.2016 11:00,3537,20.94,1326,1460,2211
19.04.2016 12:00,3461,20.42,1315,1447,2146
19.04.2016 13:00,3355,20.15,1295,1428,2060
19.04.2016 14:00,3384,20.06,1240,1417,2144
19.04.2016 15:00,3318,19.93,1241,1395,2077
19.04.2016 16:00,3248,19.87,1240,1363,2008
19.04.2016 17:00,3168,19.59,1231,1348,1937
19.04.2016 18:00,3120,19.62,1177,1261,1943
19.04.2016 19:00,3054,20.47,1104,1178,1950
19.04.2016 20:00,3106,20.89,935,1066,2171
19.04.2016 21:00,3115,21.18,819,943,2296
19.04.2016 22:00,3157,21.17,654,838,2503
19.04.2016 23:00,2914,20.13,626,758,2288
20.04.2016 00:00,2650,19.33,646,707,2004
20.04.2016 01:00,2379,19.14,690,618,1689
20.04.2016 02:00,2319,18.85,732,628,1587
20.04.2016 03:00,2288,16.5,748,622,1540
20.04.2016 04:00,2315,17.49,732,608,1583
20.04.2016 05:00,2377,18.63,714,601,1663
20.04.2016 06:00,2558,20,661,585,1897
20.04.2016 07:00,2913,21.63,597,553,2316
20.04.2016 08:00,3282,23.13,477,519,2805
20.04.2016 09:00,3373,23.37,369,474,3004
20.04.2016 10:00,3335,23.28,305,443,3030
20.04.2016 11:00,3326,23.02,312,440,3014
20.04.2016 12:00,3186,22.43,412,450,2774
20.04.2016 13:00,3002,21.69,561,496,2441
20.04.2016 14:00,2953,21.56,651,548,2302
20.04.2016 15:00,2911,21.52,682,602,2229
20.04.2016 16:00,2946,21.57,636,615,2310
20.04.2016 17:00,2936,21.59,556,611,2380
20.04.2016 18:00,2953,22.16,488,565,2465
20.04.2016 19:00,2877,22.54,444,496,2433
20.04.2016 20:00,2904,22.93,335,418,2569
20.04.2016 21:00,3000,23.1,271,357,2729
20.04.2016 22:00,3007,23.22,230,315,2777
20.04.2016 23:00,2820,22.92,217,292,2603
21.04.2016 00:00,2573,21.69,266,270,2307
21.04.2016 01:00,2369,21.13,335,279,2034
21.04.2016 02:00,2315,20.5,349,298,1966
21.04.2016 03:00,2332,19.93,354,319,1978
21.04.2016 04:00,2315,19.58,384,338,1931
21.04.2016 05:00,2369,19.84,389,351,1980
21.04.2016 06:00,2534,21.11,409,385,2125
21.04.2016 07:00,2898,21.89,433,429,2465
21.04.2016 08:00,3336,22.95,384,479,2952
21.04.2016 09:00,3404,23.29,468,547,2936
21.04.2016 10:00,3273,22.84,640,630,2633
21.04.2016 11:00,3240,22.64,738,699,2502
21.04.2016 12:00,3227,22.24,826,793,2401
21.04.2016 13:00,3169,21.94,919,874,2250
21.04.2016 14:00,3181,21.84,990,971,2191
21.04.2016 15:00,3189,21.76,1051,1038,2138
21.04.2016 16:00,3213,21.55,1096,1092,2117
21.04.2016 17:00,3208,21.34,1128,1188,2080
21.04.2016 18:00,3253,21.3,1138,1215,2115
21.04.2016 19:00,3152,21.26,1176,1191,1976
21.04.2016 20:00,3142,21.24,1158,1224,1984
21.04.2016 21:00,3191,21.39,1125,1247,2066
21.04.2016 22:00,3176,21.49,1148,1269,2028
21.04.2016 23:00,2932,20.88,1174,1275,1758
22.04.2016 00:00,2819,20.12,1105,1268,1714
22.04.2016 01:00,2771,19.64,1063,1287,1708
22.04.2016 02:00,2687,19.07,1034,1245,1653
22.04.2016 03:00,2568,18.96,1032,1145,1536
22.04.2016 04:00,2521,18.89,979,1053,1542
22.04.2016 05:00,2540,19.33,923,980,1617
22.04.2016 06:00,2706,20.95,838,913,1868
22.04.2016 07:00,2979,21.5,790,828,2189
22.04.2016 08:00,3255,22.63,707,749,2548
22.04.2016 09:00,3352,22.89,600,683,2752
22.04.2016 10:00,3396,22.87,456,624,2940
22.04.2016 11:00,3377,22.86,407,547,2970
22.04.2016 12:00,3303,22.73,395,515,2908
22.04.2016 13:00,3142,22.57,465,524,2677
22.04.2016 14:00,3043,22.25,522,573,2521
22.04.2016 15:00,2953,21.94,558,608,2395
22.04.2016 16:00,2813,21.68,597,618,2216
22.04.2016 17:00,2796,21.52,563,625,2233
22.04.2016 18:00,2836,21.68,492,597,2344
22.04.2016 19:00,2877,21.73,362,519,2515
22.04.2016 20:00,2876,21.82,222,421,2654
22.04.2016 21:00,2874,21.89,160,331,2714
22.04.2016 22:00,2845,22.04,164,275,2681
22.04.2016 23:00,2692,21.79,165,256,2527
23.04.2016 00:00,2538,21.41,172,238,2366
23.04.2016 01:00,2362,21.59,161,191,2201
23.04.2016 02:00,2358,21.35,127,187,2231
23.04.2016 03:00,2368,21.01,105,168,2263
23.04.2016 04:00,2344,20.99,125,158,2219
23.04.2016 05:00,2361,20.99,131,148,2230
23.04.2016 06:00,2396,20.9,109,138,2287
23.04.2016 07:00,2431,21.05,106,130,2325
23.04.2016 08:00,2528,21.48,66,117,2462
23.04.2016 09:00,2682,22.42,18,93,2664
23.04.2016 10:00,2723,23.22,19,79,2704
23.04.2016 11:00,2688,23.32,38,79,2650
23.04.2016 12:00,2584,23.2,128,87,2456
23.04.2016 13:00,2549,22.66,175,102,2374
23.04.2016 14:00,2553,21.36,192,126,2361
23.04.2016 15:00,2500,20.45,188,154,2312
23.04.2016 16:00,2497,20.25,184,157,2313
23.04.2016 17:00,2508,20.34,218,172,2290
23.04.2016 18:00,2647,20.45,175,192,2472
23.04.2016 19:00,2632,21.07,188,185,2444
23.04.2016 20:00,2567,22.45,175,153,2392
23.04.2016 21:00,2656,23.23,126,156,2530
23.04.2016 22:00,2732,23.24,119,155,2613
23.04.2016 23:00,2626,22.98,132,153,2494
24.04.2016 00:00,2512,22.01,151,154,2361
24.04.2016 01:00,2447,21.43,136,182,2311
24.04.2016 02:00,2357,20.46,134,182,2223
24.04.2016 03:00,2350,20.42,133,176,2217
24.04.2016 04:00,2386,20.52,118,180,2268
24.04.2016 05:00,2391,20.62,143,180,2248
24.04.2016 06:00,2382,20.76,162,180,2220
24.04.2016 07:00,2414,20.51,143,176,2271
24.04.2016 08:00,2488,21,123,177,2365
24.04.2016 09:00,2607,21.3,94,172,2513
24.04.2016 10:00,2664,21.54,91,162,2573
24.04.2016 11:00,2672,21.39,96,161,2576
24.04.2016 12:00,2670,21.28,102,149,2568
24.04.2016 13:00,2615,21.22,171,143,2444
24.04.2016 14:00,2608,21.04,176,143,2432
24.04.2016 15:00,2587,20.91,177,149,2410
24.04.2016 16:00,2630,20.77,168,138,2462
24.04.2016 17:00,2640,20.83,158,122,2482
24.04.2016 18:00,2717,20.98,113,112,2604
24.04.2016 19:00,2828,21.01,61,100,2767
24.04.2016 20:00,2878,21.96,49,89,2829
24.04.2016 21:00,2928,23.35,25,70,2903
24.04.2016 22:00,2916,23.53,13,54,2903
24.04.2016 23:00,2802,23.32,17,52,2785
25.04.2016 00:00,2675,23.03,20,52,2655
25.04.2016 01:00,2559,22.56,26,64,2533
25.04.2016 02:00,2541,21.46,18,66,2523
25.04.2016 03:00,2542,20.82,20,63,2522
25.04.2016 04:00,2584,20.64,23,61,2561
25.04.2016 05:00,2592,20.92,37,53,2555
25.04.2016 06:00,2747,22.81,30,52,2717
25.04.2016 07:00,3137,24.11,30,50,3107
25.04.2016 08:00,3498,27.54,18,52,3480
25.04.2016 09:00,3587,30.06,15,47,3572
25.04.2016 10:00,3507,27.89,14,47,3493
25.04.2016 11:00,3491,27.05,30,52,3461
25.04.2016 12:00,3403,25.82,57,73,3346
25.04.2016 13:00,3262,25.35,135,90,3127
25.04.2016 14:00,3279,25.44,167,145,3112
25.04.2016 15:00,3143,24.39,248,190,2895
25.04.2016 16:00,3114,23.75,239,203,2875
25.04.2016 17:00,2937,23.78,312,233,2625
25.04.2016 18:00,2884,24.44,379,258,2505
25.04.2016 19:00,2952,24.27,349,298,2603
25.04.2016 20:00,2969,24.46,393,339,2576
25.04.2016 21:00,2938,24.95,470,361,2468
25.04.2016 22:00,3036,25.53,446,416,2590
25.04.2016 23:00,2885,24.19,489,491,2396
26.04.2016 00:00,2776,22.97,475,569,2301
26.04.2016 01:00,2642,21.81,502,589,2140
26.04.2016 02:00,2598,20.9,489,615,2109
26.04.2016 03:00,2623,20.96,497,642,2126
26.04.2016 04:00,2629,20.62,562,684,2067
26.04.2016 05:00,2579,21.07,673,710,1906
26.04.2016 06:00,2664,22.73,725,748,1939
26.04.2016 07:00,3021,24.38,770,810,2251
26.04.2016 08:00,3331,25.98,808,866,2523
26.04.2016 09:00,3409,28.04,882,926,2527
26.04.2016 10:00,3365,26.8,945,975,2420
26.04.2016 11:00,3330,25.83,1029,989,2301
26.04.2016 12:00,3287,25.1,1089,1022,2198
26.04.2016 13:00,3271,25.12,1102,1052,2169
26.04.2016 14:00,3340,25.03,1037,1053,2303
26.04.2016 15:00,3396,24.74,976,1035,2420
26.04.2016 16:00,3434,24.46,898,994,2536
26.04.2016 17:00,3412,24.15,849,963,2563
26.04.2016 18:00,3448,24.48,813,928,2635
26.04.2016 19:00,3418,24.45,754,900,2664
26.04.2016 20:00,3403,24.4,721,886,2682
26.04.2016 21:00,3335,24.48,754,852,2581
26.04.2016 22:00,3213,24.83,824,840,2389
26.04.2016 23:00,2935,24.37,861,817,2074
27.04.2016 00:00,2697,23.22,871,806,1826
27.04.2016 01:00,2448,22.27,911,739,1537
27.04.2016 02:00,2270,21.7,1046,717,1224
27.04.2016 03:00,2154,21.67,1104,688,1050
27.04.2016 04:00,2168,21.34,1070,651,1098
27.04.2016 05:00,2227,21.64,1058,634,1169
27.04.2016 06:00,2351,23.01,1068,609,1283
27.04.2016 07:00,2814,23.71,899,548,1915
27.04.2016 08:00,3225,25.95,767,472,2458
27.04.2016 09:00,3512,29.3,570,439,2942
27.04.2016 10:00,3504,27.93,495,390,3009
27.04.2016 11:00,3541,25.65,427,382,3114
27.04.2016 12:00,3572,24.91,400,401,3172
27.04.2016 13:00,3497,24.21,405,404,3092
27.04.2016 14:00,3392,24.14,462,412,2930
27.04.2016 15:00,3265,23.56,548,432,2717
27.04.2016 16:00,3239,23.42,538,442,2701
27.04.2016 17:00,3238,23.53,451,427,2787
27.04.2016 18:00,3266,24.03,382,405,2884
27.04.2016 19:00,3228,24.92,364,385,2864
27.04.2016 20:00,3172,24.54,340,338,2832
27.04.2016 21:00,3138,24.14,337,322,2801
27.04.2016 22:00,3141,24.75,343,320,2798
27.04.2016 23:00,2980,24.37,327,326,2653
28.04.2016 00:00,2803,23.55,305,319,2498
28.04.2016 01:00,2693,22.67,294,353,2399
28.04.2016 02:00,2645,22.47,309,353,2336
28.04.2016 03:00,2618,22.48,302,340,2316
28.04.2016 04:00,2591,22.54,330,326,2261
28.04.2016 05:00,2585,23.16,348,313,2237
28.04.2016 06:00,2680,24.26,331,297,2349
28.04.2016 07:00,2981,24.51,319,277,2662
28.04.2016 08:00,3321,29.81,272,243,3049
28.04.2016 09:00,3426,37.08,211,200,3215
28.04.2016 10:00,3402,34.1,176,180,3226
28.04.2016 11:00,3387,29.93,181,163,3206
28.04.2016 12:00,3327,28.68,184,157,3143
28.04.2016 13:00,3233,26.16,220,163,3013
28.04.2016 14:00,3330,24.98,197,187,3133
28.04.2016 15:00,3342,25.76,164,196,3178
28.04.2016 16:00,3367,24.48,155,216,3212
28.04.2016 17:00,3297,24.33,168,231,3129
28.04.2016 18:00,3353,24.32,145,248,3208
28.04.2016 19:00,3293,24.12,156,271,3137
28.04.2016 20:00,3285,24.12,164,280,3121
28.04.2016 21:00,3317,24.27,145,294,3172
28.04.2016 22:00,3251,24.41,215,320,3036
28.04.2016 23:00,3065,24.2,247,352,2818
29.04.2016 00:00,2817,23.72,295,363,2522
29.04.2016 01:00,2610,22.32,360,390,2250
29.04.2016 02:00,2510,21.7,430,423,2080
29.04.2016 03:00,2484,21.46,464,438,2020
29.04.2016 04:00,2527,21.5,451,439,2076
29.04.2016 05:00,2563,21.63,448,419,2115
29.04.2016 06:00,2652,22.3,439,402,2213
29.04.2016 07:00,2994,22.88,396,379,2598
29.04.2016 08:00,3300,25.79,373,367,2927
29.04.2016 09:00,3327,26.49,424,399,2903
29.04.2016 10:00,3249,23.22,510,467,2739
29.04.2016 11:00,3179,22.51,671,574,2508
29.04.2016 12:00,3105,21.97,818,691,2287
29.04.2016 13:00,3014,22.04,943,817,2071
29.04.2016 14:00,2955,21.86,1029,917,1926
29.04.2016 15:00,2875,21.67,1059,992,1816
29.04.2016 16:00,2828,21.94,1082,1014,1746
29.04.2016 17:00,2797,22.08,1062,1018,1735
29.04.2016 18:00,2914,22.34,1004,1026,1910
29.04.2016 19:00,2938,22.55,914,982,2024
29.04.2016 20:00,2897,22.57,885,963,2012
29.04.2016 21:00,2841,22.53,895,948,1946
29.04.2016 22:00,2797,22.44,891,937,1906
29.04.2016 23:00,2655,22.16,862,910,1793
30.04.2016 00:00,2528,21.88,813,899,1715
30.04.2016 01:00,2403,22.22,804,895,1599
30.04.2016 02:00,2278,21.98,845,871,1433
30.04.2016 03:00,2215,21.89,855,834,1360
30.04.2016 04:00,2181,21.96,844,798,1337
30.04.2016 05:00,2134,21.98,827,758,1307
30.04.2016 06:00,2140,21.89,768,725,1372
30.04.2016 07:00,2232,21.58,721,697,1511
30.04.2016 08:00,2396,22.58,655,654,1741
30.04.2016 09:00,2606,22.75,593,600,2013
30.04.2016 10:00,2696,23.79,563,574,2133
30.04.2016 11:00,2697,23.95,573,566,2124
30.04.2016 12:00,2612,23.47,592,567,2020
30.04.2016 13:00,2489,22.44,663,565,1826
30.04.2016 14:00,2488,22.01,656,561,1832
30.04.2016 15:00,2431,21.48,605,530,1826
30.04.2016 16:00,2427,21.17,542,499,1885
30.04.2016 17:00,2481,21.54,440,463,2041
30.04.2016 18:00,2567,22.34,347,408,2220
30.04.2016 19:00,2622,23.9,296,373,2326
30.04.2016 20:00,2628,23.79,215,350,2413
30.04.2016 21:00,2646,23.75,169,330,2477
30.04.2016 22:00,2665,24,187,309,2478
30.04.2016 23:00,2595,23.75,181,289,2414
05.01.2016 00:00,2502,23.3,151,259,2351
05.01.2016 01:00,2307,22.4,149,231,2158
05.01.2016 02:00,2196,20.47,145,181,2051
05.01.2016 03:00,2147,20.02,118,149,2029
05.01.2016 04:00,2171,20.06,82,130,2089
05.01.2016 05:00,2193,20.06,64,112,2129
05.01.2016 06:00,2141,20.04,51,96,2090
05.01.2016 07:00,2147,20.03,58,84,2089
05.01.2016 08:00,2203,20.65,38,68,2165
05.01.2016 09:00,2336,21,19,54,2317
05.01.2016 10:00,2406,21.57,19,36,2387
05.01.2016 11:00,2429,22.23,36,47,2393
05.01.2016 12:00,2433,22.26,47,50,2386
05.01.2016 13:00,2388,21.74,62,59,2326
05.01.2016 14:00,2324,21.2,90,70,2234
05.01.2016 15:00,2225,20.94,114,65,2111
05.01.2016 16:00,2212,20.79,126,70,2086
05.01.2016 17:00,2228,20.81,130,82,2098
05.01.2016 18:00,2280,21.18,138,93,2142
05.01.2016 19:00,2318,22.04,120,93,2198
05.01.2016 20:00,2452,23.57,103,111,2349
05.01.2016 21:00,2499,24.39,112,96,2387
05.01.2016 22:00,2584,25.13,129,84,2455
05.01.2016 23:00,2472,24.7,133,78,2339
05.02.2016 00:00,2320,23.89,145,74,2175
05.02.2016 01:00,2172,21.98,152,71,2020
05.02.2016 02:00,2145,20.73,131,63,2014
05.02.2016 03:00,2137,20.39,116,40,2021
05.02.2016 04:00,2195,20.43,90,33,2105
05.02.2016 05:00,2267,20.58,106,27,2161
05.02.2016 06:00,2396,22.98,98,32,2298
05.02.2016 07:00,2778,25.27,71,29,2707
05.02.2016 08:00,3076,34.56,39,18,3037
05.02.2016 09:00,3127,34.96,7,29,3120
05.02.2016 10:00,3090,31.35,1,29,3089
05.02.2016 11:00,3060,28.29,2,34,3058
05.02.2016 12:00,3032,26.91,15,50,3017
05.02.2016 13:00,2954,25.29,55,73,2899
05.02.2016 14:00,2944,25.07,108,106,2836
05.02.2016 15:00,2881,24.62,144,133,2737
05.02.2016 16:00,2846,24.57,175,160,2671
05.02.2016 17:00,2747,24.26,223,178,2524
05.02.2016 18:00,2719,24.15,250,188,2469
05.02.2016 19:00,2656,24,259,203,2397
05.02.2016 20:00,2681,24.13,263,243,2418
05.02.2016 21:00,2637,23.97,324,266,2313
05.02.2016 22:00,2665,24.1,391,305,2274
05.02.2016 23:00,2493,23.63,435,334,2058
05.03.2016 00:00,2276,22.54,457,352,1819
05.03.2016 01:00,2175,21.75,449,394,1726
05.03.2016 02:00,2113,21.11,481,409,1632
05.03.2016 03:00,2079,21.04,508,413,1571
05.03.2016 04:00,2066,20.8,544,405,1522
05.03.2016 05:00,2100,21.16,566,394,1534
05.03.2016 06:00,2216,22.51,530,380,1686
05.03.2016 07:00,2548,23.76,506,378,2042
05.03.2016 08:00,2899,26.94,406,347,2493
05.03.2016 09:00,3040,29.53,266,310,2774
05.03.2016 10:00,3007,28.18,261,280,2746
05.03.2016 11:00,2960,27.67,281,256,2679
05.03.2016 12:00,2943,27.6,302,265,2641
05.03.2016 13:00,2844,25.72,316,264,2528
05.03.2016 14:00,2858,25.02,299,263,2559
05.03.2016 15:00,2838,24.32,251,237,2587
05.03.2016 16:00,2807,24.1,218,218,2589
05.03.2016 17:00,2700,23.91,254,209,2446
05.03.2016 18:00,2693,24.37,314,207,2379
05.03.2016 19:00,2736,24.42,274,206,2462
05.03.2016 20:00,2760,24.55,230,207,2530
05.03.2016 21:00,2736,24.47,213,197,2523
05.03.2016 22:00,2720,24.95,207,186,2513
05.03.2016 23:00,2565,24.44,209,197,2356
05.04.2016 00:00,2327,23.73,240,210,2087
05.04.2016 01:00,2136,22.29,318,246,1818
05.04.2016 02:00,2050,21.46,384,267,1666
05.04.2016 03:00,2034,21.25,402,290,1632
05.04.2016 04:00,2065,21.17,420,313,1645
05.04.2016 05:00,2114,21.61,436,320,1678
05.04.2016 06:00,2188,23.59,404,297,1784
05.04.2016 07:00,2602,25,305,270,2297
05.04.2016 08:00,3001,33.93,223,250,2778
05.04.2016 09:00,3091,35.97,194,233,2897
05.04.2016 10:00,3042,32.46,202,222,2840
05.04.2016 11:00,3027,28.51,229,212,2798
05.04.2016 12:00,2963,27.14,240,208,2723
05.04.2016 13:00,2845,25.43,250,207,2595
05.04.2016 14:00,2836,24.37,259,216,2577
05.04.2016 15:00,2739,24.01,299,229,2440
05.04.2016 16:00,2650,23.64,331,231,2319
05.04.2016 17:00,2603,23.88,302,246,2301
05.04.2016 18:00,2650,24.5,270,250,2380
05.04.2016 19:00,2640,25.43,251,246,2389
05.04.2016 20:00,2626,25.28,229,231,2397
05.04.2016 21:00,2622,24.69,203,220,2419
05.04.2016 22:00,2673,24.82,209,214,2464
05.04.2016 23:00,2537,24.34,216,210,2321
05.05.2016 00:00,2364,23.82,203,204,2161
05.05.2016 01:00,2134,23.12,231,186,1903
05.05.2016 02:00,2036,21.86,255,187,1781
05.05.2016 03:00,2001,21.26,278,193,1723
05.05.2016 04:00,2024,20.26,272,200,1752
05.05.2016 05:00,2043,19.79,261,194,1782
05.05.2016 06:00,2002,20.27,268,175,1734
05.05.2016 07:00,2047,20.44,244,149,1803
05.05.2016 08:00,2234,20.73,111,126,2123
05.05.2016 09:00,2374,21.27,41,93,2333
05.05.2016 10:00,2418,21.39,31,69,2387
05.05.2016 11:00,2408,21.3,31,55,2377
05.05.2016 12:00,2380,21.11,30,49,2350
05.05.2016 13:00,2317,20.9,45,45,2272
05.05.2016 14:00,2256,20.55,63,52,2193
05.05.2016 15:00,2185,20.11,97,60,2088
05.05.2016 16:00,2161,19.67,110,71,2051
05.05.2016 17:00,2147,19.71,119,79,2028
05.05.2016 18:00,2173,20.37,118,84,2055
05.05.2016 19:00,2203,21.38,100,87,2103
05.05.2016 20:00,2278,23.41,93,88,2185
05.05.2016 21:00,2280,23.31,110,83,2170
05.05.2016 22:00,2327,23.64,132,81,2195
05.05.2016 23:00,2231,23.52,153,81,2078
05.06.2016 00:00,2104,21.62,146,86,1958
05.06.2016 01:00,1987,20.73,140,93,1847
05.06.2016 02:00,1951,19.08,124,89,1827
05.06.2016 03:00,1953,18.46,110,87,1843
05.06.2016 04:00,1986,18.24,93,85,1893
05.06.2016 05:00,2014,19.11,86,83,1928
05.06.2016 06:00,2033,21.16,76,76,1957
05.06.2016 07:00,2279,22.98,65,73,2214
05.06.2016 08:00,2483,23.85,45,63,2438
05.06.2016 09:00,2639,25.09,17,50,2622
05.06.2016 10:00,2669,29.27,25,39,2644
05.06.2016 11:00,2616,23.7,43,61,2573
05.06.2016 12:00,2538,22.87,85,84,2453
05.06.2016 13:00,2459,22.26,149,114,2310
05.06.2016 14:00,2367,21.96,226,152,2141
05.06.2016 15:00,2251,21.57,309,185,1942
05.06.2016 16:00,2158,20.87,376,218,1782
05.06.2016 17:00,2139,20.66,402,248,1737
05.06.2016 18:00,2232,21.85,355,275,1877
05.06.2016 19:00,2356,22.88,320,313,2036
05.06.2016 20:00,2299,22.76,310,305,1989
05.06.2016 21:00,2290,22.28,293,314,1997
05.06.2016 22:00,2309,22.09,342,324,1967
05.06.2016 23:00,2192,21.8,408,350,1784
05.07.2016 00:00,2053,20.91,418,358,1635
05.07.2016 01:00,1972,19.81,423,387,1549
05.07.2016 02:00,1950,16.9,415,403,1535
05.07.2016 03:00,1924,14.95,405,410,1519
05.07.2016 04:00,1939,14.64,379,405,1560
05.07.2016 05:00,1931,14.96,379,393,1552
05.07.2016 06:00,1871,15.2,386,382,1485
05.07.2016 07:00,1897,16.27,366,365,1531
05.07.2016 08:00,2037,19.32,279,335,1758
05.07.2016 09:00,2228,19.94,193,292,2035
05.07.2016 10:00,2318,20.1,165,245,2153
05.07.2016 11:00,2351,20.27,134,223,2217
05.07.2016 12:00,2331,19.98,127,225,2204
05.07.2016 13:00,2303,19.93,133,230,2170
05.07.2016 14:00,2243,19.39,153,236,2090
05.07.2016 15:00,2166,18.72,184,242,1982
05.07.2016 16:00,2123,18.55,198,241,1925
05.07.2016 17:00,2122,18.15,211,246,1911
05.07.2016 18:00,2133,19.26,248,255,1885
05.07.2016 19:00,2113,19.92,269,257,1844
05.07.2016 20:00,2116,21.42,252,264,1864
05.07.2016 21:00,2084,19.93,288,284,1796
05.07.2016 22:00,2101,19.81,360,311,1741
05.07.2016 23:00,2007,19.72,433,340,1574
05.08.2016 00:00,1838,18.22,489,349,1349
05.08.2016 01:00,1749,15.17,501,379,1248
05.08.2016 02:00,1713,13.99,471,376,1242
05.08.2016 03:00,1737,11.51,420,366,1317
05.08.2016 04:00,1728,7.63,401,338,1327
05.08.2016 05:00,1728,7.03,375,307,1353
05.08.2016 06:00,1665,6.01,350,277,1315
05.08.2016 07:00,1704,7.6,305,255,1399
05.08.2016 08:00,1838,13.95,186,222,1652
05.08.2016 09:00,2049,16.94,72,176,1977
05.08.2016 10:00,2191,18.59,38,151,2153
05.08.2016 11:00,2222,20.02,36,127,2186
05.08.2016 12:00,2199,19.73,53,122,2146
05.08.2016 13:00,2165,19.23,84,131,2081
05.08.2016 14:00,2152,18.48,123,155,2029
05.08.2016 15:00,2101,18.02,165,168,1936
05.08.2016 16:00,2089,17.63,178,183,1911
05.08.2016 17:00,2116,17.18,182,200,1934
05.08.2016 18:00,2157,17.72,191,203,1966
05.08.2016 19:00,2167,17.93,203,202,1964
05.08.2016 20:00,2201,19.35,178,205,2023
05.08.2016 21:00,2203,19.4,175,214,2028
05.08.2016 22:00,2222,20.02,215,230,2007
05.08.2016 23:00,2170,20.12,238,257,1932
05.09.2016 00:00,2046,18.66,229,280,1817
05.09.2016 01:00,1883,15.75,213,232,1670
05.09.2016 02:00,1851,13.1,186,232,1665
05.09.2016 03:00,1858,12.49,177,228,1681
05.09.2016 04:00,1847,12.39,198,223,1649
05.09.2016 05:00,1888,14.73,176,218,1712
05.09.2016 06:00,1987,20.15,175,217,1812
05.09.2016 07:00,2416,22.33,169,217,2247
05.09.2016 08:00,2783,28.02,130,210,2653
05.09.2016 09:00,2947,33.14,66,205,2881
05.09.2016 10:00,2953,30.49,59,187,2894
05.09.2016 11:00,2929,24.23,97,185,2832
05.09.2016 12:00,2812,22.69,166,165,2646
05.09.2016 13:00,2732,22.38,204,153,2528
05.09.2016 14:00,2755,22.2,215,164,2540
05.09.2016 15:00,2729,22.03,214,167,2515
05.09.2016 16:00,2657,22.02,235,167,2422
05.09.2016 17:00,2583,21.95,226,181,2357
05.09.2016 18:00,2601,22.76,213,185,2388
05.09.2016 19:00,2592,22.87,169,189,2423
05.09.2016 20:00,2595,22.81,138,191,2457
05.09.2016 21:00,2519,22.43,133,188,2386
05.09.2016 22:00,2558,22.7,162,194,2396
05.09.2016 23:00,2380,22.13,200,203,2180
05.10.2016 00:00,2164,21.31,237,207,1927
05.10.2016 01:00,1991,21.09,247,192,1744
05.10.2016 02:00,1950,20.42,228,194,1722
05.10.2016 03:00,1935,19.61,212,195,1723
05.10.2016 04:00,1957,19.33,189,187,1768
05.10.2016 05:00,1967,19.87,168,174,1799
05.10.2016 06:00,2053,21.56,163,168,1890
05.10.2016 07:00,2370,22.77,175,157,2195
05.10.2016 08:00,2728,26.14,155,139,2573
05.10.2016 09:00,2889,35.78,85,116,2804
05.10.2016 10:00,2884,33.78,54,99,2830
05.10.2016 11:00,2882,29.24,63,93,2819
05.10.2016 12:00,2847,24.92,84,78,2763
05.10.2016 13:00,2809,23.46,75,79,2734
05.10.2016 14:00,2825,23.34,75,83,2750
05.10.2016 15:00,2805,23.41,84,84,2721
05.10.2016 16:00,2813,23.49,80,90,2733
05.10.2016 17:00,2741,23.1,66,98,2675
05.10.2016 18:00,2727,23.2,63,101,2664
05.10.2016 19:00,2680,22.89,53,96,2627
05.10.2016 20:00,2639,22.69,51,95,2588
05.10.2016 21:00,2615,22.48,65,94,2550
05.10.2016 22:00,2591,22.46,87,100,2504
05.10.2016 23:00,2415,22.23,131,112,2284
05.11.2016 00:00,2174,21.61,135,120,2039
05.11.2016 01:00,2005,21.08,102,103,1903
05.11.2016 02:00,1971,20.05,88,106,1883
05.11.2016 03:00,1970,19.62,75,112,1895
05.11.2016 04:00,1941,19.11,131,138,1810
05.11.2016 05:00,1915,19.87,224,189,1691
05.11.2016 06:00,1956,21.71,290,240,1666
05.11.2016 07:00,2313,23.93,344,294,1969
05.11.2016 08:00,2623,35.27,380,336,2243
05.11.2016 09:00,2807,39.6,320,369,2487
05.11.2016 10:00,2807,34.94,362,392,2445
05.11.2016 11:00,2854,29.41,393,421,2461
05.11.2016 12:00,2816,24.58,445,446,2371
05.11.2016 13:00,2714,23.66,509,469,2205
05.11.2016 14:00,2687,23.47,532,490,2155
05.11.2016 15:00,2635,23.22,553,503,2082
05.11.2016 16:00,2630,23.04,578,509,2052
05.11.2016 17:00,2551,22.92,600,527,1951
05.11.2016 18:00,2536,23.36,637,560,1899
05.11.2016 19:00,2502,23.62,641,584,1861
05.11.2016 20:00,2529,23.45,620,609,1909
05.11.2016 21:00,2512,23.33,600,617,1912
05.11.2016 22:00,2484,23.31,659,622,1825
05.11.2016 23:00,2318,22.23,703,628,1615
05.12.2016 00:00,2140,20.69,688,627,1452
05.12.2016 01:00,2003,19.5,656,599,1347
05.12.2016 02:00,1935,18.02,629,572,1306
05.12.2016 03:00,1854,17.28,644,530,1210
05.12.2016 04:00,1893,17.79,610,505,1283
05.12.2016 05:00,1953,18.68,535,476,1418
05.12.2016 06:00,2037,19.9,516,456,1521
05.12.2016 07:00,2467,23.08,432,428,2035
05.12.2016 08:00,2887,30.19,290,376,2597
05.12.2016 09:00,2951,34.05,247,338,2704
05.12.2016 10:00,2909,30.96,231,310,2678
05.12.2016 11:00,2920,28.93,211,284,2709
05.12.2016 12:00,2875,26.95,223,255,2652
05.12.2016 13:00,2795,25.39,225,231,2570
05.12.2016 14:00,2782,24.75,224,218,2558
05.12.2016 15:00,2743,24.75,224,203,2519
05.12.2016 16:00,2739,25.07,208,187,2531
05.12.2016 17:00,2663,25.14,163,171,2500
05.12.2016 18:00,2670,27.47,135,170,2535
05.12.2016 19:00,2614,29.79,129,163,2485
05.12.2016 20:00,2588,28.15,127,150,2461
05.12.2016 21:00,2565,25.41,130,136,2435
05.12.2016 22:00,2548,24.83,150,128,2398
05.12.2016 23:00,2413,24.03,174,120,2239
13.05.2016 00:00,2251,23.26,150,118,2101
13.05.2016 01:00,2121,22.3,118,111,2003
13.05.2016 02:00,2062,21.41,89,111,1973
13.05.2016 03:00,2029,21.04,99,110,1930
13.05.2016 04:00,2010,20.55,133,107,1877
13.05.2016 05:00,2013,21.13,132,100,1881
13.05.2016 06:00,2099,22.81,118,89,1981
13.05.2016 07:00,2455,24.12,102,81,2353
13.05.2016 08:00,2808,35.27,41,68,2767
13.05.2016 09:00,2893,40.21,5,54,2888
13.05.2016 10:00,2841,38.23,7,42,2834
13.05.2016 11:00,2871,34.8,16,40,2855
13.05.2016 12:00,2836,34.6,29,43,2807
13.05.2016 13:00,2759,30.2,47,50,2712
13.05.2016 14:00,2704,27.32,72,63,2632
13.05.2016 15:00,2587,24.68,102,80,2485
13.05.2016 16:00,2474,23.8,140,94,2334
13.05.2016 17:00,2377,23.53,176,99,2201
13.05.2016 18:00,2318,23.58,204,117,2114
13.05.2016 19:00,2273,23.87,202,117,2071
13.05.2016 20:00,2259,23.81,167,119,2092
13.05.2016 21:00,2142,23.67,163,109,1979
13.05.2016 22:00,2130,23.5,186,107,1944
13.05.2016 23:00,2082,23.22,180,117,1902
14.05.2016 00:00,1969,22.28,183,140,1786
14.05.2016 01:00,1843,21,175,153,1668
14.05.2016 02:00,1771,19.88,178,149,1593
14.05.2016 03:00,1738,19.22,176,156,1562
14.05.2016 04:00,1691,18.96,169,155,1522
14.05.2016 05:00,1671,18.45,151,151,1520
14.05.2016 06:00,1639,18.79,145,150,1494
14.05.2016 07:00,1748,18.46,118,147,1630
14.05.2016 08:00,1880,20,119,144,1761
14.05.2016 09:00,2068,20.43,130,145,1938
14.05.2016 10:00,2214,21.5,127,141,2087
14.05.2016 11:00,2250,21.7,140,147,2110
14.05.2016 12:00,2262,21.58,139,166,2123
14.05.2016 13:00,2230,21.14,141,166,2089
14.05.2016 14:00,2192,20.73,160,199,2032
14.05.2016 15:00,2101,20.3,224,231,1877
14.05.2016 16:00,2068,20.04,290,255,1778
14.05.2016 17:00,2058,20.03,324,273,1734
14.05.2016 18:00,2140,20.32,332,308,1808
14.05.2016 19:00,2127,20.5,348,314,1779
14.05.2016 20:00,2124,20.71,365,324,1759
14.05.2016 21:00,2164,20.46,308,326,1856
14.05.2016 22:00,2162,20.66,285,333,1877
14.05.2016 23:00,2135,22.15,275,333,1860
15.05.2016 00:00,2090,20.62,253,342,1837
15.05.2016 01:00,1991,20.42,271,346,1720
15.05.2016 02:00,1921,19.51,241,348,1680
15.05.2016 03:00,1909,18.99,219,365,1690
15.05.2016 04:00,1890,18.73,220,356,1670
15.05.2016 05:00,1850,18.08,248,352,1602
15.05.2016 06:00,1827,18.05,224,352,1603
15.05.2016 07:00,1860,17.9,246,362,1614
15.05.2016 08:00,2014,18.56,247,378,1767
15.05.2016 09:00,2126,19.3,287,368,1839
15.05.2016 10:00,2270,20.26,314,380,1956
15.05.2016 11:00,2348,20.58,307,366,2041
15.05.2016 12:00,2355,20.54,336,364,2019
15.05.2016 13:00,2376,20.24,344,373,2032
15.05.2016 14:00,2363,20.04,339,377,2024
15.05.2016 15:00,2293,19.85,394,388,1899
15.05.2016 16:00,2319,19.74,374,398,1945
15.05.2016 17:00,2364,19.92,371,404,1993
15.05.2016 18:00,2427,20.23,386,425,2041
15.05.2016 19:00,2461,20.47,393,416,2068
15.05.2016 20:00,2409,21.41,484,426,1925
15.05.2016 21:00,2330,21.69,539,441,1791
15.05.2016 22:00,2358,22.21,535,469,1823
15.05.2016 23:00,2248,22.17,549,488,1699
16.05.2016 00:00,2170,21.74,501,520,1669
16.05.2016 01:00,2080,21.49,474,538,1606
16.05.2016 02:00,1947,20.12,541,541,1406
16.05.2016 03:00,1851,18.67,634,560,1217
16.05.2016 04:00,1773,18.52,778,614,995
16.05.2016 05:00,1758,18.48,895,697,863
16.05.2016 06:00,1843,19.78,936,742,907
16.05.2016 07:00,2246,21.33,939,793,1307
16.05.2016 08:00,2665,22.03,895,812,1770
16.05.2016 09:00,2845,22.54,902,856,1943
16.05.2016 10:00,2866,22.91,983,937,1883
16.05.2016 11:00,2958,23.11,1031,1020,1927
16.05.2016 12:00,2960,23.35,1076,1068,1884
16.05.2016 13:00,2888,22.9,1108,1087,1780
16.05.2016 14:00,2889,22.67,1064,1049,1825
16.05.2016 15:00,2935,22.38,951,995,1984
16.05.2016 16:00,2925,22.42,877,946,2048
16.05.2016 17:00,2852,22.37,812,872,2040
16.05.2016 18:00,2859,22.75,719,786,2140
16.05.2016 19:00,2875,23.8,583,692,2292
16.05.2016 20:00,2870,24.29,467,606,2403
16.05.2016 21:00,2828,24.22,371,533,2457
16.05.2016 22:00,2808,24.05,307,478,2501
16.05.2016 23:00,2572,23.7,354,446,2218
17.05.2016 00:00,2320,22.9,385,428,1935
17.05.2016 01:00,2106,23.05,448,433,1658
17.05.2016 02:00,2035,22.55,442,433,1593
17.05.2016 03:00,2035,22.09,409,429,1626
17.05.2016 04:00,2028,21.6,401,416,1627
17.05.2016 05:00,2021,21.73,382,393,1639
17.05.2016 06:00,2110,22.91,374,383,1736
17.05.2016 07:00,2508,25.04,346,362,2162
17.05.2016 08:00,2962,30.35,287,353,2675
17.05.2016 09:00,3042,36.32,266,327,2776
17.05.2016 10:00,2942,30.48,265,286,2677
17.05.2016 11:00,2926,28.3,243,254,2683
17.05.2016 12:00,2926,27.79,220,244,2706
17.05.2016 13:00,2830,25.94,226,243,2604
17.05.2016 14:00,2798,25.53,250,241,2548
17.05.2016 15:00,2747,26.34,255,244,2492
17.05.2016 16:00,2729,26.93,261,258,2468
17.05.2016 17:00,2630,26.01,269,260,2361
17.05.2016 18:00,2660,26.95,281,261,2379
17.05.2016 19:00,2596,26.11,267,254,2329
17.05.2016 20:00,2576,26.31,258,246,2318
17.05.2016 21:00,2583,26.94,224,239,2359
17.05.2016 22:00,2546,27.37,249,239,2297
17.05.2016 23:00,2400,25.89,269,263,2131
18.05.2016 00:00,2205,24.16,280,263,1925
18.05.2016 01:00,2070,23.73,272,255,1798
18.05.2016 02:00,1979,23.47,286,261,1693
18.05.2016 03:00,1994,23.12,249,253,1745
18.05.2016 04:00,1977,22.37,234,233,1743
18.05.2016 05:00,1980,22.75,258,209,1722
18.05.2016 06:00,2062,23.98,244,194,1818
18.05.2016 07:00,2468,27.91,184,187,2284
18.05.2016 08:00,2883,36.17,136,177,2747
18.05.2016 09:00,2942,39.48,147,172,2795
18.05.2016 10:00,2932,35.31,152,171,2780
18.05.2016 11:00,2971,32.58,150,171,2821
18.05.2016 12:00,3005,30.98,155,187,2850
18.05.2016 13:00,2964,31.12,146,200,2818
18.05.2016 14:00,2940,30.9,171,207,2769
18.05.2016 15:00,2920,30.87,161,210,2759
18.05.2016 16:00,2888,30.32,168,213,2720
18.05.2016 17:00,2817,30.57,157,208,2660
18.05.2016 18:00,2811,31.69,125,204,2686
18.05.2016 19:00,2732,33.05,126,179,2606
18.05.2016 20:00,2715,34.1,109,171,2606
18.05.2016 21:00,2680,33.81,110,169,2570
18.05.2016 22:00,2657,32.95,135,178,2522
18.05.2016 23:00,2524,30.41,170,189,2354
19.05.2016 00:00,2271,26.54,199,195,2072
19.05.2016 01:00,2109,24.48,210,203,1899
19.05.2016 02:00,2058,22.91,206,203,1852
19.05.2016 03:00,2026,22.23,210,192,1816
19.05.2016 04:00,2031,21.95,198,185,1833
19.05.2016 05:00,2009,22.29,190,167,1819
19.05.2016 06:00,2102,23.9,189,151,1913
19.05.2016 07:00,2453,30.82,189,132,2264
19.05.2016 08:00,2775,39.4,118,111,2657
19.05.2016 09:00,2835,46,77,94,2758
19.05.2016 10:00,2842,44.13,73,88,2769
19.05.2016 11:00,2883,45,75,86,2808
19.05.2016 12:00,2860,44.91,77,82,2783
19.05.2016 13:00,2812,40.07,95,91,2717
19.05.2016 14:00,2757,38.96,127,112,2630
19.05.2016 15:00,2708,35,148,128,2560
19.05.2016 16:00,2688,33.06,151,136,2537
19.05.2016 17:00,2631,31.91,146,145,2485
19.05.2016 18:00,2640,32.35,130,142,2510
19.05.2016 19:00,2636,33.18,108,132,2528
19.05.2016 20:00,2622,35.22,94,124,2528
19.05.2016 21:00,2601,34.12,96,121,2505
19.05.2016 22:00,2557,33.04,123,122,2434
19.05.2016 23:00,2444,29.36,156,140,2288
20.05.2016 00:00,2218,25.04,166,159,2052
20.05.2016 01:00,2031,23.94,182,154,1849
20.05.2016 02:00,1977,23.02,183,163,1794
20.05.2016 03:00,1957,21.57,159,168,1798
20.05.2016 04:00,1966,21.34,146,169,1820
20.05.2016 05:00,1950,21.52,163,169,1787
20.05.2016 06:00,2023,23.23,159,156,1864
20.05.2016 07:00,2417,26.36,140,142,2277
20.05.2016 08:00,2817,30.37,117,125,2700
20.05.2016 09:00,2962,29.34,79,113,2883
20.05.2016 10:00,3014,28.87,71,118,2943
20.05.2016 11:00,3009,26.84,84,129,2925
20.05.2016 12:00,2974,25.98,95,157,2879
20.05.2016 13:00,2862,24.99,137,191,2725
20.05.2016 14:00,2718,24.3,261,250,2457
20.05.2016 15:00,2663,24.22,328,307,2335
20.05.2016 16:00,2553,24.2,391,351,2162
20.05.2016 17:00,2475,24.35,428,373,2047
20.05.2016 18:00,2416,24.96,496,374,1920
20.05.2016 19:00,2410,24.66,483,363,1927
20.05.2016 20:00,2370,24.72,399,355,1971
20.05.2016 21:00,2321,24.54,350,323,1971
20.05.2016 22:00,2289,24.69,306,290,1983
20.05.2016 23:00,2230,24.49,316,278,1914
21.05.2016 00:00,2060,23.97,317,267,1743
21.05.2016 01:00,1891,24.03,325,258,1566
21.05.2016 02:00,1813,23.49,304,241,1509
21.05.2016 03:00,1801,22.6,251,226,1550
21.05.2016 04:00,1825,21.75,205,207,1620
21.05.2016 05:00,1789,21.48,166,179,1623
21.05.2016 06:00,1795,21.01,122,148,1673
21.05.2016 07:00,1869,21.6,68,115,1801
21.05.2016 08:00,2025,23.07,46,92,1979
21.05.2016 09:00,2193,23.49,40,84,2153
21.05.2016 10:00,2293,23.48,66,92,2227
21.05.2016 11:00,2279,23.48,128,110,2151
21.05.2016 12:00,2238,23.35,160,127,2078
21.05.2016 13:00,2214,22.89,184,154,2030
21.05.2016 14:00,2171,22.72,204,175,1967
21.05.2016 15:00,2132,22,224,196,1908
21.05.2016 16:00,2093,21.85,229,198,1864
21.05.2016 17:00,2097,21.69,240,206,1857
21.05.2016 18:00,2122,22.14,235,204,1887
21.05.2016 19:00,2170,23.62,202,192,1968
21.05.2016 20:00,2199,24.34,174,181,2025
21.05.2016 21:00,2162,23.92,171,176,1991
21.05.2016 22:00,2153,23.9,194,176,1959
21.05.2016 23:00,2077,23.87,238,195,1839
22.05.2016 00:00,1874,23.42,314,220,1560
22.05.2016 01:00,1736,21.94,344,262,1392
22.05.2016 02:00,1687,21.01,326,271,1361
22.05.2016 03:00,1674,20.3,320,284,1354
22.05.2016 04:00,1652,20.43,329,283,1323
22.05.2016 05:00,1613,20.52,341,281,1272
22.05.2016 06:00,1588,19.92,325,278,1263
22.05.2016 07:00,1636,19.82,325,275,1311
22.05.2016 08:00,1769,20.79,284,266,1485
22.05.2016 09:00,1908,22.52,289,256,1619
22.05.2016 10:00,2103,23.37,263,282,1840
22.05.2016 11:00,2167,23.64,325,321,1842
22.05.2016 12:00,2043,23.44,526,383,1517
22.05.2016 13:00,1996,23.05,636,455,1360
22.05.2016 14:00,1954,22.77,740,544,1214
22.05.2016 15:00,1959,22.49,775,619,1184
22.05.2016 16:00,2007,22.18,780,669,1227
22.05.2016 17:00,2067,22.17,776,710,1291
22.05.2016 18:00,2097,21.84,768,719,1329
22.05.2016 19:00,2141,21.86,763,719,1378
22.05.2016 20:00,2222,23.22,702,714,1520
22.05.2016 21:00,2246,23.71,674,727,1572
22.05.2016 22:00,2155,23.85,762,738,1393
22.05.2016 23:00,2107,23.84,832,756,1275
23.05.2016 00:00,1907,22.9,859,758,1048
23.05.2016 01:00,1773,22.07,886,807,887
23.05.2016 02:00,1700,20.82,886,781,814
23.05.2016 03:00,1739,19.51,754,728,985
23.05.2016 04:00,1869,18.91,579,662,1290
23.05.2016 05:00,1833,19.46,515,582,1318
23.05.2016 06:00,1848,21.4,481,471,1367
23.05.2016 07:00,2318,24.96,332,385,1986
23.05.2016 08:00,2732,25.91,229,320,2503
23.05.2016 09:00,2941,26.78,143,280,2798
23.05.2016 10:00,2970,27.04,125,252,2845
23.05.2016 11:00,2996,27.23,142,249,2854
23.05.2016 12:00,2981,26.72,186,251,2795
23.05.2016 13:00,2948,25.73,192,255,2756
23.05.2016 14:00,2960,26.42,220,282,2740
23.05.2016 15:00,2938,25.99,200,285,2738
23.05.2016 16:00,2899,25.79,209,305,2690
23.05.2016 17:00,2810,25.33,202,304,2608
23.05.2016 18:00,2776,25.77,197,291,2579
23.05.2016 19:00,2678,25.5,211,272,2467
23.05.2016 20:00,2611,25.21,202,234,2409
23.05.2016 21:00,2546,24.22,213,236,2333
23.05.2016 22:00,2479,24.05,233,252,2246
23.05.2016 23:00,2363,23.88,271,273,2092
24.05.2016 00:00,2105,22.71,298,280,1807
24.05.2016 01:00,1977,21.47,309,307,1668
24.05.2016 02:00,1932,21.06,330,338,1602
24.05.2016 03:00,1909,19.99,313,330,1596
24.05.2016 04:00,1906,19.62,277,302,1629
24.05.2016 05:00,1868,20.3,256,284,1612
24.05.2016 06:00,1952,22.11,215,239,1737
24.05.2016 07:00,2327,23.96,181,214,2146
24.05.2016 08:00,2732,25.12,100,177,2632
24.05.2016 09:00,2883,25.77,58,150,2825
24.05.2016 10:00,2878,25.77,54,147,2824
24.05.2016 11:00,2913,25.77,71,149,2842
24.05.2016 12:00,2885,25.87,140,158,2745
24.05.2016 13:00,2798,25.89,205,178,2593
24.05.2016 14:00,2762,25.74,245,207,2517
24.05.2016 15:00,2776,25.93,260,220,2516
24.05.2016 16:00,2787,25.7,256,222,2531
24.05.2016 17:00,2722,25.19,238,223,2484
24.05.2016 18:00,2696,25.59,182,207,2514
24.05.2016 19:00,2666,25.38,155,188,2511
24.05.2016 20:00,2626,25.16,131,179,2495
24.05.2016 21:00,2545,24.48,129,177,2416
24.05.2016 22:00,2492,24.41,149,191,2343
24.05.2016 23:00,2459,23.99,146,210,2313
25.05.2016 00:00,2265,23.24,146,223,2119
25.05.2016 01:00,2099,21.64,157,225,1942
25.05.2016 02:00,1960,21.11,214,241,1746
25.05.2016 03:00,1899,20.88,270,260,1629
25.05.2016 04:00,1892,20.38,290,278,1602
25.05.2016 05:00,1850,20.94,277,271,1573
25.05.2016 06:00,1987,22.25,224,248,1763
25.05.2016 07:00,2317,24.26,204,224,2113
25.05.2016 08:00,2686,25.55,162,199,2524
25.05.2016 09:00,2829,25.96,145,184,2684
25.05.2016 10:00,2852,25.91,154,179,2698
25.05.2016 11:00,2901,26.54,157,178,2744
25.05.2016 12:00,2906,25.88,177,182,2729
25.05.2016 13:00,2872,26.73,182,205,2690
25.05.2016 14:00,2848,26.1,229,222,2619
25.05.2016 15:00,2786,26.17,258,233,2528
25.05.2016 16:00,2754,25.23,301,254,2453
25.05.2016 17:00,2627,24.96,380,295,2247
25.05.2016 18:00,2569,26.19,464,348,2105
25.05.2016 19:00,2442,25.51,574,396,1868
25.05.2016 20:00,2462,25.74,556,424,1906
25.05.2016 21:00,2416,24.75,553,442,1863
25.05.2016 22:00,2433,24.23,525,447,1908
25.05.2016 23:00,2378,23.86,444,449,1934
26.05.2016 00:00,2247,22.64,357,437,1890
26.05.2016 01:00,2072,22.76,326,390,1746
26.05.2016 02:00,2012,22.51,297,356,1715
26.05.2016 03:00,1951,22.46,278,315,1673
26.05.2016 04:00,1932,22.46,267,275,1665
26.05.2016 05:00,1901,22.58,263,237,1638
26.05.2016 06:00,1955,23.22,231,211,1724
26.05.2016 07:00,2293,25.53,154,180,2139
26.05.2016 08:00,2684,26.66,87,150,2597
26.05.2016 09:00,2798,28.46,54,121,2744
26.05.2016 10:00,2796,27.94,51,101,2745
26.05.2016 11:00,2804,26.2,64,85,2740
26.05.2016 12:00,2764,25.4,90,72,2674
26.05.2016 13:00,2686,26.09,133,79,2553
26.05.2016 14:00,2646,25.44,199,110,2447
26.05.2016 15:00,2620,25.3,259,145,2361
26.05.2016 16:00,2640,25.58,278,186,2362
26.05.2016 17:00,2611,25.76,274,224,2337
26.05.2016 18:00,2591,27.39,283,236,2308
26.05.2016 19:00,2550,26.89,247,223,2303
26.05.2016 20:00,2574,26.22,176,199,2398
26.05.2016 21:00,2550,25.97,120,177,2430
26.05.2016 22:00,2504,25.95,111,163,2393
26.05.2016 23:00,2446,25.85,111,162,2335
27.05.2016 00:00,2221,24.27,126,151,2095
27.05.2016 01:00,2034,23.65,131,137,1903
27.05.2016 02:00,1961,22.85,141,138,1820
27.05.2016 03:00,1904,21.95,137,132,1767
27.05.2016 04:00,1906,20.61,122,117,1784
27.05.2016 05:00,1876,21.69,109,96,1767
27.05.2016 06:00,2017,23.45,87,97,1930
27.05.2016 07:00,2390,25.71,44,84,2346
27.05.2016 08:00,2751,28.13,20,69,2731
27.05.2016 09:00,2898,34.63,5,57,2893
27.05.2016 10:00,2875,33.42,2,45,2873
27.05.2016 11:00,2931,32.16,4,43,2927
27.05.2016 12:00,2874,32.12,12,40,2862
27.05.2016 13:00,2814,29.64,35,42,2779
27.05.2016 14:00,2725,27.2,30,48,2695
27.05.2016 15:00,2604,26.64,34,53,2570
27.05.2016 16:00,2560,26.21,31,58,2529
27.05.2016 17:00,2519,26.65,27,63,2492
27.05.2016 18:00,2508,26.87,31,67,2477
27.05.2016 19:00,2463,26.17,26,68,2437
27.05.2016 20:00,2401,25.73,19,73,2382
27.05.2016 21:00,2315,25.18,29,72,2286
27.05.2016 22:00,2251,25.28,46,72,2205
27.05.2016 23:00,2225,25.69,42,76,2183
28.05.2016 00:00,2079,24.48,53,78,2026
28.05.2016 01:00,1910,23.92,58,73,1852
28.05.2016 02:00,1845,23.6,57,75,1788
28.05.2016 03:00,1793,22.79,55,78,1738
28.05.2016 04:00,1757,22.14,62,84,1695
28.05.2016 05:00,1686,21.69,85,91,1601
28.05.2016 06:00,1653,21.91,106,97,1547
28.05.2016 07:00,1726,22.56,106,98,1620
28.05.2016 08:00,1904,23.44,92,99,1812
28.05.2016 09:00,2104,25.64,97,105,2007
28.05.2016 10:00,2218,26.3,112,114,2106
28.05.2016 11:00,2251,24.46,151,131,2100
28.05.2016 12:00,2227,23.61,168,150,2059
28.05.2016 13:00,2194,23.12,187,165,2007
28.05.2016 14:00,2137,22.6,209,170,1928
28.05.2016 15:00,2073,22.08,228,176,1845
28.05.2016 16:00,2090,21.9,214,186,1876
28.05.2016 17:00,2108,22.18,195,189,1913
28.05.2016 18:00,2147,22.97,199,199,1948
28.05.2016 19:00,2216,24.61,212,230,2004
28.05.2016 20:00,2211,25.79,203,236,2008
28.05.2016 21:00,2182,24.94,178,251,2004
28.05.2016 22:00,2112,24.59,233,264,1879
28.05.2016 23:00,2123,23.35,248,284,1875
29.05.2016 00:00,1994,22.33,249,300,1745
29.05.2016 01:00,1800,20.73,222,236,1578
29.05.2016 02:00,1721,20.09,225,245,1496
29.05.2016 03:00,1663,18.36,253,257,1410
29.05.2016 04:00,1608,17.34,296,264,1312
29.05.2016 05:00,1540,17.05,297,250,1243
29.05.2016 06:00,1535,15.56,289,255,1246
29.05.2016 07:00,1645,16.35,229,257,1416
29.05.2016 08:00,1791,19.22,187,257,1604
29.05.2016 09:00,2000,21.79,140,255,1860
29.05.2016 10:00,2119,22.28,161,260,1958
29.05.2016 11:00,2207,22.68,180,258,2027
29.05.2016 12:00,2224,22.68,223,276,2001
29.05.2016 13:00,2183,22.72,283,281,1900
29.05.2016 14:00,2190,22.51,309,326,1881
29.05.2016 15:00,2145,21.96,354,368,1791
29.05.2016 16:00,2085,21.3,429,402,1656
29.05.2016 17:00,2080,21.43,467,442,1613
29.05.2016 18:00,2141,22.25,483,485,1658
29.05.2016 19:00,2193,22.58,489,537,1704
29.05.2016 20:00,2149,22.56,543,587,1606
29.05.2016 21:00,2261,22.77,521,641,1740
29.05.2016 22:00,2198,23.04,653,704,1545
29.05.2016 23:00,2150,22.81,772,782,1378
30.05.2016 00:00,1980,20.01,809,806,1171
30.05.2016 01:00,1836,18.07,845,815,991
30.05.2016 02:00,1772,14.17,881,846,891
30.05.2016 03:00,1850,12.57,793,854,1057
30.05.2016 04:00,1833,11.28,795,843,1038
30.05.2016 05:00,1845,12.15,753,842,1092
30.05.2016 06:00,1923,19.71,726,820,1197
30.05.2016 07:00,2332,24.46,685,796,1647
30.05.2016 08:00,2733,25.98,691,797,2042
30.05.2016 09:00,2842,28.35,715,787,2127
30.05.2016 10:00,2877,28.18,746,819,2131
30.05.2016 11:00,2899,28.12,818,852,2081
30.05.2016 12:00,2801,27.05,939,883,1862
30.05.2016 13:00,2743,26.08,1025,927,1718
30.05.2016 14:00,2726,25.41,1103,986,1623
30.05.2016 15:00,2716,25.04,1105,1019,1611
30.05.2016 16:00,2695,24.67,1101,1029,1594
30.05.2016 17:00,2640,24.61,1083,1049,1557
30.05.2016 18:00,2619,24.86,1069,1044,1550
30.05.2016 19:00,2583,24.91,1042,1053,1541
30.05.2016 20:00,2573,25.05,1013,1052,1560
30.05.2016 21:00,2490,24.87,1007,1044,1483
30.05.2016 22:00,2390,24.35,1004,1032,1386
30.05.2016 23:00,2360,23.4,970,1020,1390
31.05.2016 00:00,2165,21.94,971,1007,1194
31.05.2016 01:00,1972,21.17,965,991,1007
31.05.2016 02:00,1954,19.25,888,971,1066
31.05.2016 03:00,1894,16.44,839,938,1055
31.05.2016 04:00,1817,16.09,857,900,960
31.05.2016 05:00,1690,17.31,869,834,821
31.05.2016 06:00,1905,21.5,745,818,1160
31.05.2016 07:00,2344,24.14,611,771,1733
31.05.2016 08:00,2750,30.61,547,693,2203
31.05.2016 09:00,2864,34.95,517,645,2347
31.05.2016 10:00,2929,34.62,462,628,2467
31.05.2016 11:00,2963,34.1,439,617,2524
31.05.2016 12:00,2925,34.94,493,606,2432
31.05.2016 13:00,2865,31.99,538,620,2327
31.05.2016 14:00,2928,30.42,528,640,2400
31.05.2016 15:00,2913,29.95,521,671,2392
31.05.2016 16:00,2831,28.82,593,660,2238
31.05.2016 17:00,2774,29.26,589,667,2185
31.05.2016 18:00,2780,31.6,542,676,2238
31.05.2016 19:00,2790,32.95,461,666,2329
31.05.2016 20:00,2781,30.76,432,663,2349
31.05.2016 21:00,2660,29.67,464,658,2196
31.05.2016 22:00,2442,29.32,561,656,1881
31.05.2016 23:00,2364,28.05,622,665,1742
06.01.2016 00:00,2181,24.53,605,662,1576
06.01.2016 01:00,2020,23.42,603,661,1417
06.01.2016 02:00,1941,21.82,574,642,1367
06.01.2016 03:00,1922,21.07,553,631,1369
06.01.2016 04:00,1898,20.08,554,617,1344
06.01.2016 05:00,1837,20.18,539,596,1298
06.01.2016 06:00,1899,23.28,494,557,1405
06.01.2016 07:00,2309,29.37,423,523,1886
06.01.2016 08:00,2693,37.49,324,480,2369
06.01.2016 09:00,2908,40.87,271,454,2637
06.01.2016 10:00,2944,41,274,452,2670
06.01.2016 11:00,2982,40.44,310,449,2672
06.01.2016 12:00,2893,40.51,431,472,2462
06.01.2016 13:00,2772,36.64,527,499,2245
06.01.2016 14:00,2801,32.11,520,522,2281
06.01.2016 15:00,2827,30.9,479,537,2348
06.01.2016 16:00,2870,28.96,429,562,2441
06.01.2016 17:00,2770,28.12,426,566,2344
06.01.2016 18:00,2742,30.11,420,559,2322
06.01.2016 19:00,2685,32.66,390,527,2295
06.01.2016 20:00,2643,32.92,380,508,2263
06.01.2016 21:00,2553,30.95,378,496,2175
06.01.2016 22:00,2463,29.57,369,485,2094
06.01.2016 23:00,2397,30.16,413,484,1984
06.02.2016 00:00,2210,26,434,489,1776
06.02.2016 01:00,1919,22.5,472,452,1447
06.02.2016 02:00,1810,20.75,514,457,1296
06.02.2016 03:00,1795,20.06,506,462,1289
06.02.2016 04:00,1775,20,513,451,1262
06.02.2016 05:00,1689,20.26,521,434,1168
06.02.2016 06:00,1748,22.92,514,400,1234
06.02.2016 07:00,2129,29.03,433,363,1696
06.02.2016 08:00,2611,37.97,311,333,2300
06.02.2016 09:00,2811,40.52,242,316,2569
06.02.2016 10:00,2857,38.91,251,328,2606
06.02.2016 11:00,2900,38,330,343,2570
06.02.2016 12:00,2797,36.37,442,372,2355
06.02.2016 13:00,2724,32.87,489,392,2235
06.02.2016 14:00,2773,30.77,486,415,2287
06.02.2016 15:00,2698,30.12,537,435,2161
06.02.2016 16:00,2569,28.38,619,442,1950
06.02.2016 17:00,2509,26.93,584,448,1925
06.02.2016 18:00,2585,28.66,473,465,2112
06.02.2016 19:00,2601,31.84,361,459,2240
06.02.2016 20:00,2569,32.96,326,433,2243
06.02.2016 21:00,2486,31.96,301,414,2185
06.02.2016 22:00,2384,29.46,359,416,2025
06.02.2016 23:00,2282,29.16,423,426,1859
06.03.2016 00:00,2028,24.59,478,422,1550
06.03.2016 01:00,1887,23.74,458,425,1429
06.03.2016 02:00,1808,21.68,444,426,1364
06.03.2016 03:00,1801,21.22,439,429,1362
06.03.2016 04:00,1812,20.64,416,424,1396
06.03.2016 05:00,1725,20.9,430,404,1295
06.03.2016 06:00,1781,22.5,414,363,1367
06.03.2016 07:00,2187,27.46,302,307,1885
06.03.2016 08:00,2616,35.45,183,241,2433
06.03.2016 09:00,2774,40.08,130,192,2644
06.03.2016 10:00,2776,39.93,132,201,2644
06.03.2016 11:00,2828,36.44,145,190,2683
06.03.2016 12:00,2805,35.64,155,178,2650
06.03.2016 13:00,2706,30.92,155,156,2551
06.03.2016 14:00,2662,28.46,149,156,2513
06.03.2016 15:00,2575,25.9,137,135,2438
06.03.2016 16:00,2504,25.26,134,127,2370
06.03.2016 17:00,2393,25.49,149,118,2244
06.03.2016 18:00,2392,28,135,108,2257
06.03.2016 19:00,2345,31.82,98,90,2247
06.03.2016 20:00,2286,32.8,58,76,2228
06.03.2016 21:00,2203,31.22,38,63,2165
06.03.2016 22:00,2136,29.93,35,61,2101
06.03.2016 23:00,2118,30.63,57,62,2061
06.04.2016 00:00,1955,28.25,93,60,1862
06.04.2016 01:00,1787,23.72,111,69,1676
06.04.2016 02:00,1702,23.21,120,89,1582
06.04.2016 03:00,1669,21.63,101,98,1568
06.04.2016 04:00,1650,21.29,99,95,1551
06.04.2016 05:00,1592,21.26,65,88,1527
06.04.2016 06:00,1608,21.3,55,84,1553
06.04.2016 07:00,1703,21.53,51,82,1652
06.04.2016 08:00,1836,23.5,55,79,1781
06.04.2016 09:00,2045,27.49,47,82,1998
06.04.2016 10:00,2215,28.98,45,90,2170
06.04.2016 11:00,2285,26.56,84,104,2201
06.04.2016 12:00,2255,26.91,118,114,2137
06.04.2016 13:00,2228,26.36,133,120,2095
06.04.2016 14:00,2139,23.76,156,134,1983
06.04.2016 15:00,2100,23.74,157,148,1943
06.04.2016 16:00,2109,23.88,143,149,1966
06.04.2016 17:00,2128,24.18,153,163,1975
06.04.2016 18:00,2180,25.91,141,176,2039
06.04.2016 19:00,2209,28.19,95,160,2114
06.04.2016 20:00,2180,30.07,58,154,2122
06.04.2016 21:00,2106,29.87,63,149,2043
06.04.2016 22:00,1935,29.88,161,147,1774
06.04.2016 23:00,1887,30.24,234,151,1653
06.05.2016 00:00,1765,28.88,282,162,1483
06.05.2016 01:00,1673,24.43,291,201,1382
06.05.2016 02:00,1612,22.05,271,204,1341
06.05.2016 03:00,1608,20.57,211,197,1397
06.05.2016 04:00,1602,19.74,190,189,1412
06.05.2016 05:00,1518,19.9,172,171,1346
06.05.2016 06:00,1477,18.79,152,147,1325
06.05.2016 07:00,1542,20.17,125,130,1417
06.05.2016 08:00,1650,22.12,96,109,1554
06.05.2016 09:00,1813,24.86,95,101,1718
06.05.2016 10:00,1943,26.8,75,100,1868
06.05.2016 11:00,2058,28.04,72,92,1986
06.05.2016 12:00,2093,28.18,68,86,2025
06.05.2016 13:00,2097,28.16,82,90,2015
06.05.2016 14:00,2058,27.6,115,103,1943
06.05.2016 15:00,1998,26.65,159,123,1839
06.05.2016 16:00,1968,26.08,202,146,1766
06.05.2016 17:00,1975,25.99,226,173,1749
06.05.2016 18:00,1927,26.56,313,199,1614
06.05.2016 19:00,1956,26.26,321,205,1635
06.05.2016 20:00,1988,27.54,285,208,1703
06.05.2016 21:00,2002,28.85,244,220,1758
06.05.2016 22:00,1965,29.14,251,232,1714
06.05.2016 23:00,1915,30.74,338,235,1577
06.06.2016 00:00,1761,27.93,385,250,1376
06.06.2016 01:00,1730,24.59,365,299,1365
06.06.2016 02:00,1680,23.32,356,315,1324
06.06.2016 03:00,1636,22.41,356,308,1280
06.06.2016 04:00,1627,21.71,333,300,1294
06.06.2016 05:00,1559,21.73,332,290,1227
06.06.2016 06:00,1606,23.26,296,281,1310
06.06.2016 07:00,1725,29.98,253,271,1472
06.06.2016 08:00,1899,35.29,240,242,1659
06.06.2016 09:00,2011,37.82,258,219,1753
06.06.2016 10:00,2131,34.94,221,208,1910
06.06.2016 11:00,2209,32.57,176,181,2033
06.06.2016 12:00,2243,31.94,166,154,2077
06.06.2016 13:00,2210,30.25,163,136,2047
06.06.2016 14:00,2168,30.46,151,128,2017
06.06.2016 15:00,2115,29.94,152,110,1963
06.06.2016 16:00,2122,30.35,146,113,1976
06.06.2016 17:00,2139,30.99,136,106,2003
06.06.2016 18:00,2183,34.68,133,101,2050
06.06.2016 19:00,2174,38.76,133,99,2041
06.06.2016 20:00,2190,41.06,116,98,2074
06.06.2016 21:00,2183,37.31,97,107,2086
06.06.2016 22:00,2130,34.2,113,121,2017
06.06.2016 23:00,2085,33.81,174,139,1911
06.07.2016 00:00,1938,28.79,233,151,1705
06.07.2016 01:00,1797,24.85,286,189,1511
06.07.2016 02:00,1738,24.04,318,210,1420
06.07.2016 03:00,1746,23.77,284,226,1462
06.07.2016 04:00,1757,23.1,287,235,1470
06.07.2016 05:00,1679,23.54,312,231,1367
06.07.2016 06:00,1790,26.41,297,221,1493
06.07.2016 07:00,2165,30.41,234,198,1931
06.07.2016 08:00,2567,35.82,158,177,2409
06.07.2016 09:00,2744,40.45,135,162,2609
06.07.2016 10:00,2759,40.04,122,164,2637
06.07.2016 11:00,2815,40,131,179,2684
06.07.2016 12:00,2819,39.94,158,196,2661
06.07.2016 13:00,2758,39.91,190,222,2568
06.07.2016 14:00,2758,36.13,233,251,2525
06.07.2016 15:00,2704,35.77,273,277,2431
06.07.2016 16:00,2693,31.93,307,308,2386
06.07.2016 17:00,2587,30.71,335,341,2252
06.07.2016 18:00,2589,32.13,338,346,2251
06.07.2016 19:00,2580,36.02,277,352,2303
06.07.2016 20:00,2591,38.48,247,355,2344
06.07.2016 21:00,2522,34.9,242,358,2280
06.07.2016 22:00,2365,32.97,327,376,2038
06.07.2016 23:00,2258,32.59,409,401,1849
06.08.2016 00:00,2108,27.54,431,408,1677
06.08.2016 01:00,1889,25.98,418,388,1471
06.08.2016 02:00,1872,23.89,374,388,1498
06.08.2016 03:00,1876,22.83,312,369,1564
06.08.2016 04:00,1807,21.68,322,345,1485
06.08.2016 05:00,1710,21.54,338,319,1372
06.08.2016 06:00,1744,23.91,363,291,1381
06.08.2016 07:00,2110,28.21,300,259,1810
06.08.2016 08:00,2531,35.07,218,220,2313
06.08.2016 09:00,2669,41.31,204,204,2465
06.08.2016 10:00,2702,37.33,196,201,2506
06.08.2016 11:00,2769,34.25,180,192,2589
06.08.2016 12:00,2798,32.99,192,216,2606
06.08.2016 13:00,2793,30.06,264,275,2529
06.08.2016 14:00,2661,30.27,425,358,2236
06.08.2016 15:00,2660,30.87,458,425,2202
06.08.2016 16:00,2705,30.14,417,446,2288
06.08.2016 17:00,2649,29.59,384,447,2265
06.08.2016 18:00,2617,29.21,376,420,2241
06.08.2016 19:00,2589,31.07,300,384,2289
06.08.2016 20:00,2548,32.52,277,359,2271
06.08.2016 21:00,2504,31.35,220,295,2284
06.08.2016 22:00,2438,31.76,193,250,2245
06.08.2016 23:00,2336,30.16,155,202,2181
06.09.2016 00:00,2120,26.5,162,162,1958
06.09.2016 01:00,1953,23.67,173,157,1780
06.09.2016 02:00,1920,21.87,151,160,1769
06.09.2016 03:00,1912,20.81,157,173,1755
06.09.2016 04:00,1903,20.58,167,176,1736
06.09.2016 05:00,1836,21.11,190,175,1646
06.09.2016 06:00,1885,23.63,199,162,1686
06.09.2016 07:00,2254,28.72,129,142,2125
06.09.2016 08:00,2632,33.97,57,116,2575
06.09.2016 09:00,2731,43.08,43,91,2688
06.09.2016 10:00,2665,44,76,82,2589
06.09.2016 11:00,2667,42.89,114,75,2553
06.09.2016 12:00,2655,41.4,147,97,2508
06.09.2016 13:00,2671,35.86,172,123,2499
06.09.2016 14:00,2666,34.99,210,156,2456
06.09.2016 15:00,2614,36.67,235,186,2379
06.09.2016 16:00,2567,35.68,266,210,2301
06.09.2016 17:00,2495,33.15,288,245,2207
06.09.2016 18:00,2513,32.88,277,275,2236
06.09.2016 19:00,2422,34.25,302,275,2120
06.09.2016 20:00,2444,35.76,256,263,2188
06.09.2016 21:00,2409,33.7,206,245,2203
06.09.2016 22:00,2297,32.83,243,239,2054
06.09.2016 23:00,2211,31.24,262,243,1949
06.10.2016 00:00,1981,29.13,330,256,1651
06.10.2016 01:00,1853,24.37,367,296,1486
06.10.2016 02:00,1799,23.37,373,316,1426
06.10.2016 03:00,1814,21.55,345,308,1469
06.10.2016 04:00,1874,19.98,259,301,1615
06.10.2016 05:00,1840,21.6,230,281,1610
06.10.2016 06:00,1864,24.84,263,263,1601
06.10.2016 07:00,2168,29.7,325,277,1843
06.10.2016 08:00,2604,34.77,302,333,2302
06.10.2016 09:00,2823,39.79,280,382,2543
06.10.2016 10:00,2847,42.39,335,469,2512
06.10.2016 11:00,2885,41.9,416,533,2469
06.10.2016 12:00,2744,33.78,549,554,2195
06.10.2016 13:00,2615,32.8,625,567,1990
06.10.2016 14:00,2560,32.78,648,589,1912
06.10.2016 15:00,2592,32.67,550,595,2042
06.10.2016 16:00,2568,32.69,490,569,2078
06.10.2016 17:00,2437,31.81,509,558,1928
06.10.2016 18:00,2356,31.83,525,526,1831
06.10.2016 19:00,2292,33.12,432,452,1860
06.10.2016 20:00,2300,33.28,319,400,1981
06.10.2016 21:00,2224,32.06,267,363,1957
06.10.2016 22:00,2189,31.67,218,339,1971
06.10.2016 23:00,2161,32.86,251,329,1910
06.11.2016 00:00,2075,30.17,288,334,1787
06.11.2016 01:00,1868,26.78,338,312,1530
06.11.2016 02:00,1715,24.79,447,332,1268
06.11.2016 03:00,1633,24.5,513,356,1120
06.11.2016 04:00,1634,24.1,497,366,1137
06.11.2016 05:00,1624,23.39,449,368,1175
06.11.2016 06:00,1709,23.35,381,368,1328
06.11.2016 07:00,1821,24.17,294,345,1527
06.11.2016 08:00,1943,27.96,249,311,1694
06.11.2016 09:00,2104,30.86,188,281,1916
06.11.2016 10:00,2250,32.19,134,250,2116
06.11.2016 11:00,2310,32.57,110,221,2200
06.11.2016 12:00,2296,32.18,112,178,2184
06.11.2016 13:00,2253,31.76,91,152,2162
06.11.2016 14:00,2196,31.02,74,120,2122
06.11.2016 15:00,2122,30.7,77,102,2045
06.11.2016 16:00,2091,30.62,79,92,2012
06.11.2016 17:00,2085,30.99,79,80,2006
06.11.2016 18:00,2089,32.06,99,77,1990
06.11.2016 19:00,2081,31.92,97,81,1984
06.11.2016 20:00,2076,32.25,82,91,1994
06.11.2016 21:00,2053,32.62,67,88,1986
06.11.2016 22:00,2003,31.71,72,90,1931
06.11.2016 23:00,1995,31.7,103,93,1892
06.12.2016 00:00,1881,30.73,144,90,1737
06.12.2016 01:00,1725,27.85,188,86,1537
06.12.2016 02:00,1676,26.16,192,94,1484
06.12.2016 03:00,1663,24.84,169,94,1494
06.12.2016 04:00,1660,24.81,157,89,1503
06.12.2016 05:00,1588,24.7,128,81,1460
06.12.2016 06:00,1580,24.75,124,73,1456
06.12.2016 07:00,1651,24.81,77,65,1574
06.12.2016 08:00,1731,25.08,45,58,1686
06.12.2016 09:00,1883,27.43,47,49,1836
06.12.2016 10:00,2014,28.87,49,41,1965
06.12.2016 11:00,2130,30.37,39,44,2091
06.12.2016 12:00,2167,30.66,46,49,2121
06.12.2016 13:00,2152,30.51,80,50,2072
06.12.2016 14:00,2141,29.58,108,82,2033
06.12.2016 15:00,2094,29.76,124,97,1970
06.12.2016 16:00,2091,29.7,118,105,1973
06.12.2016 17:00,2142,30.32,106,111,2036
06.12.2016 18:00,2191,31.23,101,111,2090
06.12.2016 19:00,2204,32.56,96,102,2108
06.12.2016 20:00,2178,32.59,91,97,2087
06.12.2016 21:00,2146,32.18,75,97,2071
06.12.2016 22:00,2069,32.54,91,104,1978
06.12.2016 23:00,2062,31.58,125,115,1937
13.06.2016 00:00,1962,29.62,141,127,1821
13.06.2016 01:00,1874,24.79,155,154,1719
13.06.2016 02:00,1830,24.52,184,171,1646
13.06.2016 03:00,1861,23.6,162,184,1699
13.06.2016 04:00,1882,23.05,166,196,1716
13.06.2016 05:00,1823,23.14,185,207,1638
13.06.2016 06:00,1898,24.8,203,210,1695
13.06.2016 07:00,2245,29.66,202,221,2043
13.06.2016 08:00,2609,33.49,199,236,2410
13.06.2016 09:00,2714,37.13,291,260,2423
13.06.2016 10:00,2682,39.91,403,305,2279
13.06.2016 11:00,2718,38.17,488,365,2230
13.06.2016 12:00,2746,39.09,517,407,2229
13.06.2016 13:00,2748,34.23,523,451,2225
13.06.2016 14:00,2768,33.11,525,484,2243
13.06.2016 15:00,2693,32.46,555,495,2138
13.06.2016 16:00,2613,31.65,576,489,2037
13.06.2016 17:00,2496,30.53,604,483,1892
13.06.2016 18:00,2541,31.2,557,466,1984
13.06.2016 19:00,2506,31.75,512,462,1994
13.06.2016 20:00,2434,32.97,479,436,1955
13.06.2016 21:00,2401,32.58,430,412,1971
13.06.2016 22:00,2351,30.72,365,399,1986
13.06.2016 23:00,2323,30.04,331,387,1992
14.06.2016 00:00,2200,27.69,296,391,1904
14.06.2016 01:00,2096,25.43,312,451,1784
14.06.2016 02:00,1965,24.18,376,464,1589
14.06.2016 03:00,1943,23.47,417,482,1526
14.06.2016 04:00,1945,22.99,440,515,1505
14.06.2016 05:00,1897,23.52,487,546,1410
14.06.2016 06:00,1985,27.21,503,552,1482
14.06.2016 07:00,2322,31.46,488,555,1834
14.06.2016 08:00,2625,37.56,534,560,2091
14.06.2016 09:00,2726,44.91,554,553,2172
14.06.2016 10:00,2778,44.96,552,583,2226
14.06.2016 11:00,2870,44.92,569,618,2301
14.06.2016 12:00,2867,49.94,603,635,2264
14.06.2016 13:00,2803,70.3,638,643,2165
14.06.2016 14:00,2819,51.6,652,650,2167
14.06.2016 15:00,2834,50.08,636,661,2198
14.06.2016 16:00,2778,40.16,652,658,2126
14.06.2016 17:00,2736,33.23,670,667,2066
14.06.2016 18:00,2749,33.07,661,673,2088
14.06.2016 19:00,2698,35.95,639,651,2059
14.06.2016 20:00,2601,37.52,645,627,1956
14.06.2016 21:00,2530,36,619,591,1911
14.06.2016 22:00,2430,32.01,576,553,1854
14.06.2016 23:00,2350,30.84,524,529,1826
15.06.2016 00:00,2110,29.89,517,498,1593
15.06.2016 01:00,2014,26.83,495,515,1519
15.06.2016 02:00,1877,25.97,512,478,1365
15.06.2016 03:00,1851,24.92,455,442,1396
15.06.2016 04:00,1854,24.52,382,387,1472
15.06.2016 05:00,1833,24.61,315,333,1518
15.06.2016 06:00,1918,30.25,280,284,1638
15.06.2016 07:00,2277,34.57,211,253,2066
15.06.2016 08:00,2657,36.79,156,226,2501
15.06.2016 09:00,2812,38.97,123,201,2689
15.06.2016 10:00,2820,37.09,112,189,2708
15.06.2016 11:00,2847,37.11,113,178,2734
15.06.2016 12:00,2855,38.19,118,171,2737
15.06.2016 13:00,2833,34.9,128,175,2705
15.06.2016 14:00,2831,33.4,161,194,2670
15.06.2016 15:00,2761,33,198,210,2563
15.06.2016 16:00,2687,32.66,215,219,2472
15.06.2016 17:00,2584,30.85,248,225,2336
15.06.2016 18:00,2576,31.42,222,208,2354
15.06.2016 19:00,2561,34.53,181,202,2380
15.06.2016 20:00,2514,36.91,150,197,2364
15.06.2016 21:00,2489,35.49,106,186,2383
15.06.2016 22:00,2406,33.25,100,179,2306
15.06.2016 23:00,2243,33.02,174,170,2069
16.06.2016 00:00,2043,27.33,206,158,1837
16.06.2016 01:00,1906,26.76,182,140,1724
16.06.2016 02:00,1891,25.67,133,142,1758
16.06.2016 03:00,1864,25.21,110,135,1754
16.06.2016 04:00,1854,24.32,107,133,1747
16.06.2016 05:00,1787,24.73,122,121,1665
16.06.2016 06:00,1836,29.2,141,102,1695
16.06.2016 07:00,2149,33.97,109,78,2040
16.06.2016 08:00,2495,42.11,87,70,2408
16.06.2016 09:00,2678,48.37,48,53,2630
16.06.2016 10:00,2731,49.79,32,53,2699
16.06.2016 11:00,2777,55.54,31,45,2746
16.06.2016 12:00,2800,55.5,42,43,2758
16.06.2016 13:00,2753,42.81,54,45,2699
16.06.2016 14:00,2758,42.53,72,54,2686
16.06.2016 15:00,2726,42.5,75,63,2651
16.06.2016 16:00,2715,40.93,69,74,2646
16.06.2016 17:00,2692,35.17,70,96,2622
16.06.2016 18:00,2667,34.49,53,81,2614
16.06.2016 19:00,2604,38.11,45,98,2559
16.06.2016 20:00,2542,36.07,41,83,2501
16.06.2016 21:00,2448,35.28,67,87,2381
16.06.2016 22:00,2360,33.02,88,95,2272
16.06.2016 23:00,2294,31.53,100,104,2194
17.06.2016 00:00,2129,29.72,108,110,2021
17.06.2016 01:00,1979,26.54,87,110,1892
17.06.2016 02:00,1863,25.05,82,101,1781
17.06.2016 03:00,1835,24.39,71,85,1764
17.06.2016 04:00,1847,24.11,58,64,1789
17.06.2016 05:00,1801,24.13,50,48,1751
17.06.2016 06:00,1891,28.75,35,38,1856
17.06.2016 07:00,2195,30.3,14,32,2181
17.06.2016 08:00,2558,36.17,6,30,2552
17.06.2016 09:00,2683,47.24,4,33,2679
17.06.2016 10:00,2745,48.63,4,37,2741
17.06.2016 11:00,2818,49.58,7,45,2811
17.06.2016 12:00,2780,48.91,10,46,2770
17.06.2016 13:00,2722,48,17,50,2705
17.06.2016 14:00,2662,43.56,44,80,2618
17.06.2016 15:00,2527,41.18,102,92,2425
17.06.2016 16:00,2479,36.71,146,146,2333
17.06.2016 17:00,2388,32.64,223,211,2165
17.06.2016 18:00,2409,31.32,288,295,2121
17.06.2016 19:00,2350,31.48,364,379,1986
17.06.2016 20:00,2383,32.94,364,455,2019
17.06.2016 21:00,2383,31.17,335,516,2048
17.06.2016 22:00,2265,28.85,412,569,1853
17.06.2016 23:00,2137,29.79,509,596,1628
18.06.2016 00:00,2016,26.71,558,634,1458
18.06.2016 01:00,1824,25.14,675,680,1149
18.06.2016 02:00,1734,24.29,783,764,951
18.06.2016 03:00,1673,23.27,868,819,805
18.06.2016 04:00,1676,22.46,915,875,761
18.06.2016 05:00,1636,21.75,942,911,694
18.06.2016 06:00,1665,21.68,940,949,725
18.06.2016 07:00,1734,22.51,962,949,772
18.06.2016 08:00,1892,23.36,947,946,945
18.06.2016 09:00,2108,25.36,919,957,1189
18.06.2016 10:00,2253,26.37,893,960,1360
18.06.2016 11:00,2358,28.05,872,964,1486
18.06.2016 12:00,2320,27.82,915,959,1405
18.06.2016 13:00,2294,27.47,948,963,1346
18.06.2016 14:00,2224,26.77,973,955,1251
18.06.2016 15:00,2175,24.75,972,953,1203
18.06.2016 16:00,2115,24.52,982,936,1133
18.06.2016 17:00,2111,24.72,954,900,1157
18.06.2016 18:00,2069,25.17,919,838,1150
18.06.2016 19:00,2049,27.19,854,759,1195
18.06.2016 20:00,1986,27.28,760,670,1226
18.06.2016 21:00,2030,26.83,625,615,1405
18.06.2016 22:00,2022,26.97,521,572,1501
18.06.2016 23:00,2007,28,509,528,1498
19.06.2016 00:00,1875,25.08,548,511,1327
19.06.2016 01:00,1763,24.24,550,524,1213
19.06.2016 02:00,1633,22.14,591,516,1042
19.06.2016 03:00,1638,20.36,576,507,1062
19.06.2016 04:00,1612,19.09,558,493,1054
19.06.2016 05:00,1542,17.9,532,486,1010
19.06.2016 06:00,1500,18.57,520,463,980
19.06.2016 07:00,1591,17.71,507,469,1084
19.06.2016 08:00,1648,20.12,599,497,1049
19.06.2016 09:00,1746,25.78,668,539,1078
19.06.2016 10:00,1888,27.53,704,589,1184
19.06.2016 11:00,2018,27.84,682,630,1336
19.06.2016 12:00,2086,28.49,734,676,1352
19.06.2016 13:00,2128,27.62,760,714,1368
19.06.2016 14:00,2099,27.37,783,755,1316
19.06.2016 15:00,2003,26.71,855,770,1148
19.06.2016 16:00,1922,26.59,914,770,1008
19.06.2016 17:00,1972,26.8,886,761,1086
19.06.2016 18:00,2054,27.07,806,728,1248
19.06.2016 19:00,2136,27.36,683,683,1453
19.06.2016 20:00,2183,27.61,585,617,1598
19.06.2016 21:00,2198,27.8,481,556,1717
19.06.2016 22:00,2153,29.88,451,496,1702
19.06.2016 23:00,2067,29.26,468,453,1599
20.06.2016 00:00,1968,27.81,412,411,1556
20.06.2016 01:00,1820,25.53,431,402,1389
20.06.2016 02:00,1739,23.92,412,371,1327
20.06.2016 03:00,1707,22.33,400,346,1307
20.06.2016 04:00,1736,22.44,339,321,1397
20.06.2016 05:00,1690,22.3,326,294,1364
20.06.2016 06:00,1826,28.12,276,259,1550
20.06.2016 07:00,2215,30.77,165,225,2050
20.06.2016 08:00,2576,35.27,141,203,2435
20.06.2016 09:00,2720,42.81,198,204,2522
20.06.2016 10:00,2713,42.81,223,201,2490
20.06.2016 11:00,2736,42.88,240,205,2496
20.06.2016 12:00,2771,42.83,231,214,2540
20.06.2016 13:00,2748,42.84,245,245,2503
20.06.2016 14:00,2747,39.92,317,283,2430
20.06.2016 15:00,2679,37.18,388,325,2291
20.06.2016 16:00,2614,36.08,464,373,2150
20.06.2016 17:00,2546,32.5,519,428,2027
20.06.2016 18:00,2503,31.86,545,444,1958
20.06.2016 19:00,2539,33.45,490,477,2049
20.06.2016 20:00,2545,34.81,459,484,2086
20.06.2016 21:00,2464,33.37,462,490,2002
20.06.2016 22:00,2370,31.76,487,489,1883
20.06.2016 23:00,2179,30.74,565,500,1614
21.06.2016 00:00,2066,27.07,549,514,1517
21.06.2016 01:00,1951,24.23,521,532,1430
21.06.2016 02:00,1924,23.37,473,534,1451
21.06.2016 03:00,1887,22.89,453,512,1434
21.06.2016 04:00,1916,21.75,403,508,1513
21.06.2016 05:00,1891,22.42,336,470,1555
21.06.2016 06:00,2043,25.14,279,439,1764
21.06.2016 07:00,2323,29.56,258,402,2065
21.06.2016 08:00,2683,38.73,237,359,2446
21.06.2016 09:00,2782,40.78,231,315,2551
21.06.2016 10:00,2839,42.59,211,292,2628
21.06.2016 11:00,2890,41.79,201,254,2689
21.06.2016 12:00,2884,43.73,249,232,2635
21.06.2016 13:00,2703,39.59,375,232,2328
21.06.2016 14:00,2658,37.64,435,251,2223
21.06.2016 15:00,2668,35.84,429,294,2239
21.06.2016 16:00,2683,34.58,384,308,2299
21.06.2016 17:00,2651,32.45,339,311,2312
21.06.2016 18:00,2602,33.05,327,294,2275
21.06.2016 19:00,2531,34.94,293,265,2238
21.06.2016 20:00,2496,35.91,231,228,2265
21.06.2016 21:00,2426,37.44,196,203,2230
21.06.2016 22:00,2354,34.98,182,193,2172
21.06.2016 23:00,2227,33.93,256,196,1971
22.06.2016 00:00,2040,30,306,197,1734
22.06.2016 01:00,1913,28.75,294,215,1619
22.06.2016 02:00,1828,25.57,288,205,1540
22.06.2016 03:00,1777,24.53,267,188,1510
22.06.2016 04:00,1746,23.71,239,168,1507
22.06.2016 05:00,1709,24.56,219,148,1490
22.06.2016 06:00,1835,30.35,176,123,1659
22.06.2016 07:00,2165,34.49,126,98,2039
22.06.2016 08:00,2563,40.98,65,79,2498
22.06.2016 09:00,2693,48.41,72,78,2621
22.06.2016 10:00,2703,44.5,107,98,2596
22.06.2016 11:00,2785,44.49,145,135,2640
22.06.2016 12:00,2800,44.43,176,167,2624
22.06.2016 13:00,2745,43.05,218,202,2527
22.06.2016 14:00,2747,38.32,279,242,2468
22.06.2016 15:00,2697,37.16,316,269,2381
22.06.2016 16:00,2691,37.96,318,282,2373
22.06.2016 17:00,2592,32.99,332,305,2260
22.06.2016 18:00,2571,34.53,332,306,2239
22.06.2016 19:00,2560,39.06,270,291,2290
22.06.2016 20:00,2527,39.8,224,267,2303
22.06.2016 21:00,2458,38.3,215,250,2243
22.06.2016 22:00,2331,37.39,224,232,2107
22.06.2016 23:00,2281,35.98,229,226,2052
23.06.2016 00:00,2117,31.09,230,219,1887
23.06.2016 01:00,1942,28.78,203,203,1739
23.06.2016 02:00,1875,26.27,167,184,1708
23.06.2016 03:00,1841,24.98,144,160,1697
23.06.2016 04:00,1792,23.87,135,132,1657
23.06.2016 05:00,1736,23.81,121,107,1615
23.06.2016 06:00,1800,30.32,83,75,1717
23.06.2016 07:00,2160,35.89,33,55,2127
23.06.2016 08:00,2538,36.8,10,47,2528
23.06.2016 09:00,2697,38.74,28,47,2669
23.06.2016 10:00,2735,38.96,43,57,2692
23.06.2016 11:00,2778,40.43,69,75,2709
23.06.2016 12:00,2758,39.26,105,89,2653
23.06.2016 13:00,2674,36.06,159,104,2515
23.06.2016 14:00,2611,33.32,219,137,2392
23.06.2016 15:00,2545,32.54,257,169,2288
23.06.2016 16:00,2558,32.41,245,212,2313
23.06.2016 17:00,2487,30.91,273,234,2214
23.06.2016 18:00,2488,31.59,273,250,2215
23.06.2016 19:00,2467,35.92,266,268,2201
23.06.2016 20:00,2361,40.06,336,305,2025
23.06.2016 21:00,2192,38.04,469,354,1723
23.06.2016 22:00,2097,32.72,568,391,1529
23.06.2016 23:00,2067,30.77,563,467,1504
24.06.2016 00:00,1928,26.99,527,476,1401
24.06.2016 01:00,1890,26.03,427,524,1463
24.06.2016 02:00,1846,24.56,348,526,1498
24.06.2016 03:00,1775,24.08,349,515,1426
24.06.2016 04:00,1748,23.36,308,505,1440
24.06.2016 05:00,1595,23.91,359,487,1236
24.06.2016 06:00,1555,26.91,373,461,1182
24.06.2016 07:00,1682,31.09,309,403,1373
24.06.2016 08:00,1953,32.98,192,351,1761
24.06.2016 09:00,2199,36.69,95,319,2104
24.06.2016 10:00,2198,34.46,174,276,2024
24.06.2016 11:00,2237,31.96,159,261,2078
24.06.2016 12:00,2274,30.74,175,286,2099
24.06.2016 13:00,2156,30.66,219,249,1937
24.06.2016 14:00,2170,29.93,194,266,1976
24.06.2016 15:00,2152,29.37,132,273,2020
24.06.2016 16:00,2129,29.08,133,277,1996
24.06.2016 17:00,2100,29.63,147,262,1953
24.06.2016 18:00,2051,31.65,168,239,1883
24.06.2016 19:00,1999,34.07,173,216,1826
24.06.2016 20:00,1904,34.01,187,195,1717
24.06.2016 21:00,1829,31.26,184,170,1645
24.06.2016 22:00,1776,31.24,186,154,1590
24.06.2016 23:00,1757,32.75,211,147,1546
25.06.2016 00:00,1703,31.28,217,128,1486
25.06.2016 01:00,1485,30.14,261,109,1224
25.06.2016 02:00,1436,28.97,209,93,1227
25.06.2016 03:00,1448,26.64,151,99,1297
25.06.2016 04:00,1402,24.28,157,87,1245
25.06.2016 05:00,1375,23.6,136,102,1239
25.06.2016 06:00,1391,23.56,88,89,1303
25.06.2016 07:00,1447,24.59,52,80,1395
25.06.2016 08:00,1538,27.59,31,62,1507
25.06.2016 09:00,1703,30.25,31,60,1672
25.06.2016 10:00,1871,32.96,35,65,1836
25.06.2016 11:00,1966,33.86,41,77,1925
25.06.2016 12:00,1984,32.95,62,80,1922
25.06.2016 13:00,1996,30.06,76,106,1920
25.06.2016 14:00,1961,28.49,103,130,1858
25.06.2016 15:00,1938,28.02,136,156,1802
25.06.2016 16:00,1890,27.86,204,188,1686
25.06.2016 17:00,1836,27.33,285,214,1551
25.06.2016 18:00,1798,27.98,378,236,1420
25.06.2016 19:00,1834,29.42,391,260,1443
25.06.2016 20:00,1878,30.53,339,277,1539
25.06.2016 21:00,1922,29.8,311,311,1611
25.06.2016 22:00,1954,28.81,244,345,1710
25.06.2016 23:00,1832,29.61,349,380,1483
26.06.2016 00:00,1722,27.02,386,376,1336
26.06.2016 01:00,1663,25.07,410,455,1253
26.06.2016 02:00,1583,23.6,410,450,1173
26.06.2016 03:00,1593,22.61,316,412,1277
26.06.2016 04:00,1550,21.58,292,371,1258
26.06.2016 05:00,1498,20.06,247,341,1251
26.06.2016 06:00,1495,19.96,234,326,1261
26.06.2016 07:00,1528,23.19,240,316,1288
26.06.2016 08:00,1660,26.76,225,331,1435
26.06.2016 09:00,1769,26.47,300,373,1469
26.06.2016 10:00,1885,27.22,395,428,1490
26.06.2016 11:00,1982,29.51,456,465,1526
26.06.2016 12:00,2067,30.47,482,510,1585
26.06.2016 13:00,2130,30.45,483,542,1647
26.06.2016 14:00,2125,30.07,476,559,1649
26.06.2016 15:00,2050,29.33,517,562,1533
26.06.2016 16:00,1956,28.65,585,551,1371
26.06.2016 17:00,1842,28.65,675,540,1167
26.06.2016 18:00,1868,29.14,653,511,1215
26.06.2016 19:00,1865,29.17,635,474,1230
26.06.2016 20:00,1959,29.19,526,451,1433
26.06.2016 21:00,2025,29.97,388,412,1637
26.06.2016 22:00,2030,29.84,292,371,1738
26.06.2016 23:00,1989,30.48,291,348,1698
27.06.2016 00:00,1806,28.12,382,316,1424
27.06.2016 01:00,1558,25.04,463,309,1095
27.06.2016 02:00,1500,23.36,450,316,1050
27.06.2016 03:00,1559,22.12,376,312,1183
27.06.2016 04:00,1541,20.64,347,298,1194
27.06.2016 05:00,1531,23.09,307,273,1224
27.06.2016 06:00,1677,29.31,250,260,1427
27.06.2016 07:00,1990,36.22,212,242,1778
27.06.2016 08:00,2378,43.47,221,238,2157
27.06.2016 09:00,2446,77.9,347,279,2099
27.06.2016 10:00,2441,94.58,442,341,1999
27.06.2016 11:00,2529,88.64,479,347,2050
27.06.2016 12:00,2591,103.15,488,384,2103
27.06.2016 13:00,2597,100.2,492,413,2105
27.06.2016 14:00,2638,108.77,535,453,2103
27.06.2016 15:00,2533,95.18,554,438,1979
27.06.2016 16:00,2547,87.81,549,452,1998
27.06.2016 17:00,2520,43.47,505,436,2015
27.06.2016 18:00,2589,42.18,431,439,2158
27.06.2016 19:00,2470,43.51,416,401,2054
27.06.2016 20:00,2490,44.91,297,368,2193
27.06.2016 21:00,2412,40.09,302,340,2110
27.06.2016 22:00,2295,37.62,336,330,1959
27.06.2016 23:00,2173,37.29,391,325,1782
28.06.2016 00:00,2030,32.17,407,336,1623
28.06.2016 01:00,1878,29.21,391,339,1487
28.06.2016 02:00,1775,27.34,381,306,1394
28.06.2016 03:00,1745,25.92,357,290,1388
28.06.2016 04:00,1725,25.01,331,260,1394
28.06.2016 05:00,1711,25.41,273,240,1438
28.06.2016 06:00,1830,31.1,235,217,1595
28.06.2016 07:00,2147,41.76,170,189,1977
28.06.2016 08:00,2497,119.92,153,170,2344
28.06.2016 09:00,2570,150.02,167,161,2403
28.06.2016 10:00,2629,145.26,159,136,2470
28.06.2016 11:00,2675,150.05,165,138,2510
28.06.2016 12:00,2686,167.88,175,165,2511
28.06.2016 13:00,2669,150.94,190,175,2479
28.06.2016 14:00,2668,160.08,217,195,2451
28.06.2016 15:00,2640,160.01,213,195,2427
28.06.2016 16:00,2664,103.28,177,205,2487
28.06.2016 17:00,2594,56.2,151,195,2443
28.06.2016 18:00,2569,43.83,140,181,2429
28.06.2016 19:00,2512,51.47,100,153,2412
28.06.2016 20:00,2458,60.13,78,130,2380
28.06.2016 21:00,2366,41.93,74,116,2292
28.06.2016 22:00,2267,41.93,78,106,2189
28.06.2016 23:00,2173,38.64,98,93,2075
29.06.2016 00:00,2032,31.73,117,86,1915
29.06.2016 01:00,1887,31.09,95,61,1792
29.06.2016 02:00,1839,30.1,77,63,1762
29.06.2016 03:00,1824,30.02,59,69,1765
29.06.2016 04:00,1847,29.94,57,72,1790
29.06.2016 05:00,1778,29.9,61,79,1717
29.06.2016 06:00,1849,31.41,94,92,1755
29.06.2016 07:00,2164,42.07,132,109,2032
29.06.2016 08:00,2484,48.32,131,130,2353
29.06.2016 09:00,2604,71.59,198,160,2406
29.06.2016 10:00,2538,79.85,343,211,2195
29.06.2016 11:00,2678,83.57,345,259,2333
29.06.2016 12:00,2756,75.29,327,297,2429
29.06.2016 13:00,2817,79.85,297,323,2520
29.06.2016 14:00,2903,61.77,258,334,2645
29.06.2016 15:00,2863,61.75,209,303,2654
29.06.2016 16:00,2745,61.69,171,266,2574
29.06.2016 17:00,2557,42.71,174,236,2383
29.06.2016 18:00,2637,42.01,188,208,2449
29.06.2016 19:00,2546,42.05,174,189,2372
29.06.2016 20:00,2513,42.03,137,184,2376
29.06.2016 21:00,2480,38.41,95,185,2385
29.06.2016 22:00,2399,36.73,87,184,2312
29.06.2016 23:00,2300,35.8,124,175,2176
30.06.2016 00:00,2105,31.02,163,178,1942
30.06.2016 01:00,1930,29.21,189,183,1741
30.06.2016 02:00,1820,28.08,232,198,1588
30.06.2016 03:00,1774,28.02,246,196,1528
30.06.2016 04:00,1797,27.75,193,183,1604
30.06.2016 05:00,1789,27.49,142,169,1647
30.06.2016 06:00,1881,31.89,124,163,1757
30.06.2016 07:00,2124,37.2,159,153,1965
30.06.2016 08:00,2458,42.03,176,181,2282
30.06.2016 09:00,2580,45.06,273,222,2307
30.06.2016 10:00,2685,48.15,300,283,2385
30.06.2016 11:00,2784,45.08,316,337,2468
30.06.2016 12:00,2856,45.03,281,350,2575
30.06.2016 13:00,2888,39.94,254,409,2634
30.06.2016 14:00,2752,36.63,333,346,2419
30.06.2016 15:00,2707,36.47,356,370,2351
30.06.2016 16:00,2666,34.78,353,357,2313
30.06.2016 17:00,2620,32.32,307,342,2313
30.06.2016 18:00,2622,31.29,240,325,2382
30.06.2016 19:00,2561,35.07,216,299,2345
30.06.2016 20:00,2500,38.28,220,277,2280
30.06.2016 21:00,2447,34.91,216,260,2231
30.06.2016 22:00,2313,31.88,215,247,2098
30.06.2016 23:00,2199,32.38,254,236,1945
07.01.2016 00:00,2022,28.4,262,228,1760
07.01.2016 01:00,1870,29.36,250,202,1620
07.01.2016 02:00,1750,25.3,234,186,1516
07.01.2016 03:00,1727,24.06,239,193,1488
07.01.2016 04:00,1695,23.64,254,214,1441
07.01.2016 05:00,1674,23.59,285,249,1389
07.01.2016 06:00,1701,29.04,350,282,1351
07.01.2016 07:00,1968,29.91,435,328,1533
07.01.2016 08:00,2347,33.58,449,377,1898
07.01.2016 09:00,2561,36.66,486,432,2075
07.01.2016 10:00,2594,33.33,567,486,2027
07.01.2016 11:00,2662,32.95,611,544,2051
07.01.2016 12:00,2720,31.7,629,622,2091
07.01.2016 13:00,2666,30.67,675,667,1991
07.01.2016 14:00,2594,29.69,742,715,1852
07.01.2016 15:00,2526,28.82,794,755,1732
07.01.2016 16:00,2451,28.39,795,737,1656
07.01.2016 17:00,2415,27.67,724,706,1691
07.01.2016 18:00,2429,28.09,627,639,1802
07.01.2016 19:00,2472,30.51,477,558,1995
07.01.2016 20:00,2405,30.76,388,470,2017
07.01.2016 21:00,2357,27.71,276,408,2081
07.01.2016 22:00,2237,27.48,269,358,1968
07.01.2016 23:00,2147,27.52,285,329,1862
07.02.2016 00:00,1943,26.88,341,336,1602
07.02.2016 01:00,1826,26.14,354,381,1472
07.02.2016 02:00,1701,21.14,398,408,1303
07.02.2016 03:00,1658,19.4,449,435,1209
07.02.2016 04:00,1616,17.51,492,470,1124
07.02.2016 05:00,1493,16.79,592,504,901
07.02.2016 06:00,1515,16.58,575,524,940
07.02.2016 07:00,1639,19.7,533,543,1106
07.02.2016 08:00,1818,22.61,496,565,1322
07.02.2016 09:00,2026,25.01,452,545,1574
07.02.2016 10:00,2065,25.5,539,527,1526
07.02.2016 11:00,2149,25.53,565,536,1584
07.02.2016 12:00,2098,25.17,634,523,1464
07.02.2016 13:00,2114,24.34,588,509,1526
07.02.2016 14:00,2172,23.76,489,500,1683
07.02.2016 15:00,2145,22.92,415,440,1730
07.02.2016 16:00,2128,22.99,350,400,1778
07.02.2016 17:00,2212,24.16,222,378,1990
07.02.2016 18:00,2200,25.18,194,326,2006
07.02.2016 19:00,2188,25.11,167,294,2021
07.02.2016 20:00,2092,25.35,172,267,1920
07.02.2016 21:00,2035,25.48,187,246,1848
07.02.2016 22:00,1944,25.03,237,246,1707
07.02.2016 23:00,1906,25.75,281,264,1625
07.03.2016 00:00,1835,22.95,318,285,1517
07.03.2016 01:00,1662,21.64,379,275,1283
07.03.2016 02:00,1543,20.49,429,280,1114
07.03.2016 03:00,1541,18.67,407,285,1134
07.03.2016 04:00,1530,16.56,402,285,1128
07.03.2016 05:00,1454,12.22,412,289,1042
07.03.2016 06:00,1418,12.14,414,276,1004
07.03.2016 07:00,1525,14.96,341,264,1184
07.03.2016 08:00,1653,18.03,295,272,1358
07.03.2016 09:00,1762,19.91,356,295,1406
07.03.2016 10:00,1890,24.82,376,320,1514
07.03.2016 11:00,1948,25.21,423,357,1525
07.03.2016 12:00,2032,25.75,454,404,1578
07.03.2016 13:00,2040,26.05,473,440,1567
07.03.2016 14:00,1999,26.27,528,476,1471
07.03.2016 15:00,1938,26.55,588,483,1350
07.03.2016 16:00,1949,26.79,571,489,1378
07.03.2016 17:00,2033,26.61,495,460,1538
07.03.2016 18:00,2126,26.86,410,437,1716
07.03.2016 19:00,2161,26.84,322,381,1839
07.03.2016 20:00,2181,27.42,259,345,1922
07.03.2016 21:00,2167,28.66,221,326,1946
07.03.2016 22:00,2109,30.49,226,308,1883
07.03.2016 23:00,2037,31.63,313,313,1724
07.04.2016 00:00,1819,30.09,438,332,1381
07.04.2016 01:00,1646,26.36,501,319,1145
07.04.2016 02:00,1585,24.82,497,347,1088
07.04.2016 03:00,1616,24.42,485,373,1131
07.04.2016 04:00,1604,23.92,489,367,1115
07.04.2016 05:00,1567,23.68,483,361,1084
07.04.2016 06:00,1746,24.81,393,342,1353
07.04.2016 07:00,2121,31.93,312,326,1809
07.04.2016 08:00,2431,35.19,311,315,2120
07.04.2016 09:00,2568,37.93,341,317,2227
07.04.2016 10:00,2623,33.54,358,338,2265
07.04.2016 11:00,2672,33.72,388,353,2284
07.04.2016 12:00,2666,32.46,431,371,2235
07.04.2016 13:00,2613,31.39,465,384,2148
07.04.2016 14:00,2626,30.97,478,411,2148
07.04.2016 15:00,2619,30.92,485,432,2134
07.04.2016 16:00,2585,30.83,467,434,2118
07.04.2016 17:00,2594,31.22,380,437,2214
07.04.2016 18:00,2570,32.9,358,408,2212
07.04.2016 19:00,2489,35.98,340,357,2149
07.04.2016 20:00,2439,38.41,274,309,2165
07.04.2016 21:00,2413,38.65,216,277,2197
07.04.2016 22:00,2324,35.56,215,257,2109
07.04.2016 23:00,2215,34.96,279,253,1936
07.05.2016 00:00,2038,33.17,320,247,1718
07.05.2016 01:00,1834,29.93,329,244,1505
07.05.2016 02:00,1753,27,312,239,1441
07.05.2016 03:00,1707,25.46,323,228,1384
07.05.2016 04:00,1676,23.88,312,206,1364
07.05.2016 05:00,1680,23.43,223,181,1457
07.05.2016 06:00,1788,25.55,172,151,1616
07.05.2016 07:00,2061,30.28,116,122,1945
07.05.2016 08:00,2465,34.1,55,105,2410
07.05.2016 09:00,2665,35.59,37,104,2628
07.05.2016 10:00,2675,34.25,66,104,2609
07.05.2016 11:00,2706,32.54,91,107,2615
07.05.2016 12:00,2708,31.46,104,112,2604
07.05.2016 13:00,2658,30.02,105,118,2553
07.05.2016 14:00,2667,29.94,116,128,2551
07.05.2016 15:00,2632,30.01,116,143,2516
07.05.2016 16:00,2658,29.57,92,149,2566
07.05.2016 17:00,2556,28.9,107,148,2449
07.05.2016 18:00,2602,28.72,116,156,2486
07.05.2016 19:00,2546,28.85,117,156,2429
07.05.2016 20:00,2479,27.57,95,160,2384
07.05.2016 21:00,2337,26.9,104,172,2233
07.05.2016 22:00,2233,27.09,144,184,2089
07.05.2016 23:00,2178,27.38,136,210,2042
07.06.2016 00:00,1984,24.92,161,221,1823
07.06.2016 01:00,1834,21.39,175,225,1659
07.06.2016 02:00,1708,19.13,196,243,1512
07.06.2016 03:00,1551,15.02,355,276,1196
07.06.2016 04:00,1487,13.23,491,329,996
07.06.2016 05:00,1481,12.19,575,390,906
07.06.2016 06:00,1571,16.58,615,468,956
07.06.2016 07:00,1883,24.24,651,522,1232
07.06.2016 08:00,2265,26.18,714,594,1551
07.06.2016 09:00,2467,27.63,765,645,1702
07.06.2016 10:00,2655,28.08,703,691,1952
07.06.2016 11:00,2735,28.53,735,731,2000
07.06.2016 12:00,2831,28.53,757,817,2074
07.06.2016 13:00,2793,28.27,756,821,2037
07.06.2016 14:00,2682,28.13,863,831,1819
07.06.2016 15:00,2547,27.96,954,817,1593
07.06.2016 16:00,2479,27.56,956,802,1523
07.06.2016 17:00,2388,27.64,933,799,1455
07.06.2016 18:00,2415,27.75,858,761,1557
07.06.2016 19:00,2421,28.26,800,735,1621
07.06.2016 20:00,2483,28.63,681,703,1802
07.06.2016 21:00,2399,28.96,688,685,1711
07.06.2016 22:00,2367,29.18,674,699,1693
07.06.2016 23:00,2263,28.62,789,721,1474
07.07.2016 00:00,2041,27.17,844,700,1197
07.07.2016 01:00,1859,26.54,817,695,1042
07.07.2016 02:00,1795,24.94,811,703,984
07.07.2016 03:00,1748,23.63,803,698,945
07.07.2016 04:00,1811,21.58,736,684,1075
07.07.2016 05:00,1811,22.43,662,677,1149
07.07.2016 06:00,1859,24.72,655,659,1204
07.07.2016 07:00,2186,29.47,649,651,1537
07.07.2016 08:00,2448,30.78,719,667,1729
07.07.2016 09:00,2622,32.58,742,688,1880
07.07.2016 10:00,2695,30.78,751,707,1944
07.07.2016 11:00,2704,29.56,780,722,1924
07.07.2016 12:00,2640,29.31,843,739,1797
07.07.2016 13:00,2665,28.4,834,766,1831
07.07.2016 14:00,2665,28.89,833,773,1832
07.07.2016 15:00,2614,28.98,835,782,1779
07.07.2016 16:00,2528,29.09,831,782,1697
07.07.2016 17:00,2414,28.46,860,775,1554
07.07.2016 18:00,2483,29.69,816,747,1667
07.07.2016 19:00,2560,30.83,758,717,1802
07.07.2016 20:00,2517,31.12,687,660,1830
07.07.2016 21:00,2556,31.65,556,615,2000
07.07.2016 22:00,2487,31.18,480,569,2007
07.07.2016 23:00,2364,31.19,489,526,1875
07.08.2016 00:00,2171,29.94,480,515,1691
07.08.2016 01:00,1940,27.93,498,486,1442
07.08.2016 02:00,1849,26.31,502,474,1347
07.08.2016 03:00,1794,25.04,503,458,1291
07.08.2016 04:00,1743,23.46,467,441,1276
07.08.2016 05:00,1768,23.18,371,419,1397
07.08.2016 06:00,1845,25.02,305,392,1540
07.08.2016 07:00,2168,30,277,370,1891
07.08.2016 08:00,2551,34.15,260,351,2291
07.08.2016 09:00,2674,37.69,311,330,2363
07.08.2016 10:00,2669,35.26,337,313,2332
07.08.2016 11:00,2747,33.36,309,306,2438
07.08.2016 12:00,2705,32.93,316,314,2389
07.08.2016 13:00,2568,30.89,309,312,2259
07.08.2016 14:00,2567,30.26,260,311,2307
07.08.2016 15:00,2474,30.19,261,313,2213
07.08.2016 16:00,2394,29.68,269,306,2125
07.08.2016 17:00,2337,29.38,251,300,2086
07.08.2016 18:00,2291,29.6,246,250,2045
07.08.2016 19:00,2167,29.44,283,222,1884
07.08.2016 20:00,2095,29.79,243,207,1852
07.08.2016 21:00,2024,28.1,199,193,1825
07.08.2016 22:00,1955,26.91,184,184,1771
07.08.2016 23:00,1926,28.08,144,166,1782
07.09.2016 00:00,1856,25.04,98,152,1758
07.09.2016 01:00,1733,24.96,69,118,1664
07.09.2016 02:00,1643,23.41,53,113,1590
07.09.2016 03:00,1560,22.13,103,120,1457
07.09.2016 04:00,1549,21.68,140,156,1409
07.09.2016 05:00,1552,19.94,156,177,1396
07.09.2016 06:00,1540,20.82,142,172,1398
07.09.2016 07:00,1613,22.54,121,161,1492
07.09.2016 08:00,1765,25.15,77,151,1688
07.09.2016 09:00,1981,28.01,82,165,1899
07.09.2016 10:00,2030,29.76,163,187,1867
07.09.2016 11:00,2081,30.52,255,241,1826
07.09.2016 12:00,2092,30.46,317,304,1775
07.09.2016 13:00,2075,29.79,377,362,1698
07.09.2016 14:00,2093,29.1,399,426,1694
07.09.2016 15:00,2039,27.4,486,481,1553
07.09.2016 16:00,1918,26.45,624,542,1294
07.09.2016 17:00,1837,26.37,776,603,1061
07.09.2016 18:00,1801,26.36,859,636,942
07.09.2016 19:00,1755,28.61,912,644,843
07.09.2016 20:00,1857,29.95,796,646,1061
07.09.2016 21:00,1927,29.89,628,613,1299
07.09.2016 22:00,1903,29.86,558,573,1345
07.09.2016 23:00,1899,30.37,525,518,1374
07.10.2016 00:00,1863,28,480,469,1383
07.10.2016 01:00,1647,23.74,497,426,1150
07.10.2016 02:00,1612,22.64,462,417,1150
07.10.2016 03:00,1577,21.74,422,399,1155
07.10.2016 04:00,1537,20.77,387,366,1150
07.10.2016 05:00,1524,20.36,340,335,1184
07.10.2016 06:00,1473,19.96,314,295,1159
07.10.2016 07:00,1511,20.86,305,275,1206
07.10.2016 08:00,1622,23.59,284,269,1338
07.10.2016 09:00,1805,26.7,248,271,1557
07.10.2016 10:00,2029,29.52,232,281,1797
07.10.2016 11:00,2153,29.65,234,301,1919
07.10.2016 12:00,2281,30.17,200,319,2081
07.10.2016 13:00,2271,29.79,240,335,2031
07.10.2016 14:00,2277,29.77,245,363,2032
07.10.2016 15:00,2201,29.76,303,383,1898
07.10.2016 16:00,2185,29.47,304,403,1881
07.10.2016 17:00,2180,29.45,338,401,1842
07.10.2016 18:00,2171,29.57,341,368,1830
07.10.2016 19:00,2166,29.63,339,339,1827
07.10.2016 20:00,2214,30.27,255,306,1959
07.10.2016 21:00,2222,30.91,209,280,2013
07.10.2016 22:00,2157,30.92,189,257,1968
07.10.2016 23:00,2155,31.49,160,253,1995
07.11.2016 00:00,2012,29.81,196,262,1816
07.11.2016 01:00,1836,24.58,195,246,1641
07.11.2016 02:00,1761,22.47,181,274,1580
07.11.2016 03:00,1714,21.6,206,293,1508
07.11.2016 04:00,1680,20.45,226,296,1454
07.11.2016 05:00,1660,19.96,254,313,1406
07.11.2016 06:00,1622,24.6,345,318,1277
07.11.2016 07:00,1869,29.43,373,330,1496
07.11.2016 08:00,2172,30.27,408,358,1764
07.11.2016 09:00,2416,32.15,469,402,1947
07.11.2016 10:00,2406,30.74,569,430,1837
07.11.2016 11:00,2440,30.7,610,483,1830
07.11.2016 12:00,2488,30.4,613,530,1875
07.11.2016 13:00,2544,30.31,595,589,1949
07.11.2016 14:00,2511,30.33,688,627,1823
07.11.2016 15:00,2366,29.92,865,674,1501
07.11.2016 16:00,2319,29.62,907,712,1412
07.11.2016 17:00,2341,28.93,831,728,1510
07.11.2016 18:00,2330,28.73,857,767,1473
07.11.2016 19:00,2320,29.51,809,726,1511
07.11.2016 20:00,2230,30.19,810,689,1420
07.11.2016 21:00,2232,30.72,704,679,1528
07.11.2016 22:00,2193,29.76,659,669,1534
07.11.2016 23:00,2156,28.5,664,687,1492
07.12.2016 00:00,2060,26.97,632,711,1428
07.12.2016 01:00,1882,25.09,696,770,1186
07.12.2016 02:00,1716,23.98,799,785,917
07.12.2016 03:00,1662,22.39,876,849,786
07.12.2016 04:00,1688,22.59,856,872,832
07.12.2016 05:00,1689,22.58,831,873,858
07.12.2016 06:00,1790,24.97,791,866,999
07.12.2016 07:00,2059,28.94,783,852,1276
07.12.2016 08:00,2394,32.24,740,817,1654
07.12.2016 09:00,2601,34.1,702,782,1899
07.12.2016 10:00,2624,32.77,697,740,1927
07.12.2016 11:00,2660,31.96,685,732,1975
07.12.2016 12:00,2612,32.7,735,716,1877
07.12.2016 13:00,2627,31.44,716,730,1911
07.12.2016 14:00,2562,30.73,757,735,1805
07.12.2016 15:00,2532,30.97,774,735,1758
07.12.2016 16:00,2536,30.42,738,727,1798
07.12.2016 17:00,2461,30.55,735,723,1726
07.12.2016 18:00,2416,31.69,700,673,1716
07.12.2016 19:00,2414,32.51,646,642,1768
07.12.2016 20:00,2325,32.81,620,586,1705
07.12.2016 21:00,2274,32.26,555,538,1719
07.12.2016 22:00,2205,32.74,515,499,1690
07.12.2016 23:00,2165,32.57,484,465,1681
13.07.2016 00:00,1975,30.84,462,437,1513
13.07.2016 01:00,1777,28.09,439,408,1338
13.07.2016 02:00,1672,27.16,429,378,1243
13.07.2016 03:00,1635,26.05,416,354,1219
13.07.2016 04:00,1627,25,393,333,1234
13.07.2016 05:00,1589,25.1,383,303,1206
13.07.2016 06:00,1681,26.69,319,283,1362
13.07.2016 07:00,1969,31.85,238,262,1731
13.07.2016 08:00,2280,34.94,239,247,2041
13.07.2016 09:00,2443,40.42,277,252,2166
13.07.2016 10:00,2552,40.62,270,261,2282
13.07.2016 11:00,2590,39.36,301,276,2289
13.07.2016 12:00,2601,39.66,328,308,2273
13.07.2016 13:00,2532,36.03,384,326,2148
13.07.2016 14:00,2469,36.94,425,347,2044
13.07.2016 15:00,2460,36.23,414,359,2046
13.07.2016 16:00,2438,33.68,413,367,2025
13.07.2016 17:00,2349,32.73,424,367,1925
13.07.2016 18:00,2368,33.75,397,348,1971
13.07.2016 19:00,2321,35.06,368,312,1953
13.07.2016 20:00,2311,35.06,292,286,2019
13.07.2016 21:00,2282,33.01,195,254,2087
13.07.2016 22:00,2199,31.56,182,238,2017
13.07.2016 23:00,2171,31.57,197,226,1974
14.07.2016 00:00,1981,29.15,216,223,1765
14.07.2016 01:00,1799,25.15,262,224,1537
14.07.2016 02:00,1710,24.02,264,226,1446
14.07.2016 03:00,1698,22.84,238,231,1460
14.07.2016 04:00,1694,22.36,225,227,1469
14.07.2016 05:00,1668,21.58,197,208,1471
14.07.2016 06:00,1716,24.57,170,176,1546
14.07.2016 07:00,1969,28.43,108,142,1861
14.07.2016 08:00,2271,30.15,72,120,2199
14.07.2016 09:00,2445,32.83,103,105,2342
14.07.2016 10:00,2467,32.8,107,93,2360
14.07.2016 11:00,2541,33.92,87,90,2454
14.07.2016 12:00,2578,34.19,70,89,2508
14.07.2016 13:00,2562,34.02,54,87,2508
14.07.2016 14:00,2587,34.49,42,85,2545
14.07.2016 15:00,2547,34.57,46,85,2501
14.07.2016 16:00,2507,34.65,42,84,2465
14.07.2016 17:00,2402,32.93,46,78,2356
14.07.2016 18:00,2398,32.78,40,67,2358
14.07.2016 19:00,2344,34.09,38,61,2306
14.07.2016 20:00,2304,32.96,31,59,2273
14.07.2016 21:00,2221,31.77,35,64,2186
14.07.2016 22:00,2147,30.89,55,76,2092
14.07.2016 23:00,2097,29.65,91,92,2006
15.07.2016 00:00,1913,27.87,132,112,1781
15.07.2016 01:00,1754,26.15,177,145,1577
15.07.2016 02:00,1694,24.08,195,168,1499
15.07.2016 03:00,1672,21.05,202,183,1470
15.07.2016 04:00,1645,20.32,223,198,1422
15.07.2016 05:00,1626,20.27,234,202,1392
15.07.2016 06:00,1672,24.01,205,193,1467
15.07.2016 07:00,1939,28.05,157,180,1782
15.07.2016 08:00,2204,30.66,168,183,2036
15.07.2016 09:00,2368,31.12,191,203,2177
15.07.2016 10:00,2431,31.82,276,236,2155
15.07.2016 11:00,2497,32.06,334,269,2163
15.07.2016 12:00,2413,31.96,461,342,1952
15.07.2016 13:00,2340,31.68,546,389,1794
15.07.2016 14:00,2320,31.55,580,441,1740
15.07.2016 15:00,2298,31.37,561,474,1737
15.07.2016 16:00,2246,31.28,594,494,1652
15.07.2016 17:00,2206,31.07,581,496,1625
15.07.2016 18:00,2159,30.89,612,510,1547
15.07.2016 19:00,2127,31.54,611,535,1516
15.07.2016 20:00,2079,32.98,610,531,1469
15.07.2016 21:00,2020,31.95,625,547,1395
15.07.2016 22:00,1962,31.47,621,577,1341
15.07.2016 23:00,1967,32.57,619,580,1348
16.07.2016 00:00,1771,31.57,653,573,1118
16.07.2016 01:00,1632,29.23,626,548,1006
16.07.2016 02:00,1560,24.4,601,527,959
16.07.2016 03:00,1571,23.04,572,534,999
16.07.2016 04:00,1615,22.04,513,527,1102
16.07.2016 05:00,1572,21.91,497,512,1075
16.07.2016 06:00,1519,22.32,462,475,1057
16.07.2016 07:00,1591,24.76,393,432,1198
16.07.2016 08:00,1731,28.74,380,414,1351
16.07.2016 09:00,1876,30.32,399,410,1477
16.07.2016 10:00,1956,30.82,466,404,1490
16.07.2016 11:00,2018,31.47,489,430,1529
16.07.2016 12:00,2060,31.5,538,483,1522
16.07.2016 13:00,2042,31,607,535,1435
16.07.2016 14:00,2037,30.27,643,566,1394
16.07.2016 15:00,2034,29.76,634,611,1400
16.07.2016 16:00,2125,28.85,553,617,1572
16.07.2016 17:00,2149,29.01,524,600,1625
16.07.2016 18:00,2094,29.35,548,557,1546
16.07.2016 19:00,2067,30.76,541,528,1526
16.07.2016 20:00,2069,31.16,472,515,1597
16.07.2016 21:00,2090,30.61,372,494,1718
16.07.2016 22:00,2034,30.53,372,493,1662
16.07.2016 23:00,1985,30.7,433,492,1552
17.07.2016 00:00,1830,27.95,446,483,1384
17.07.2016 01:00,1665,24.53,456,458,1209
17.07.2016 02:00,1571,22.03,477,463,1094
17.07.2016 03:00,1498,21.43,518,468,980
17.07.2016 04:00,1462,20.17,557,471,905
17.07.2016 05:00,1434,19.57,526,459,908
17.07.2016 06:00,1431,19.4,429,415,1002
17.07.2016 07:00,1574,19.47,296,373,1278
17.07.2016 08:00,1718,21.48,235,348,1483
17.07.2016 09:00,1852,26.12,237,341,1615
17.07.2016 10:00,1937,27.24,289,335,1648
17.07.2016 11:00,1995,28.28,325,340,1670
17.07.2016 12:00,1999,28.71,357,364,1642
17.07.2016 13:00,2001,28.38,399,390,1602
17.07.2016 14:00,1979,28.64,431,413,1548
17.07.2016 15:00,1907,28.36,499,429,1408
17.07.2016 16:00,1912,28.09,480,435,1432
17.07.2016 17:00,1986,28.17,405,432,1581
17.07.2016 18:00,2039,28.54,370,415,1669
17.07.2016 19:00,2030,29,344,368,1686
17.07.2016 20:00,2038,28.96,298,341,1740
17.07.2016 21:00,2042,28.76,259,324,1783
17.07.2016 22:00,2020,30.09,270,318,1750
17.07.2016 23:00,1994,30.57,282,314,1712
18.07.2016 00:00,1819,29,304,307,1515
18.07.2016 01:00,1635,26.03,310,277,1325
18.07.2016 02:00,1560,24.05,301,284,1259
18.07.2016 03:00,1547,23.31,294,287,1253
18.07.2016 04:00,1535,23.13,299,287,1236
18.07.2016 05:00,1529,23.02,277,269,1252
18.07.2016 06:00,1575,24.4,241,245,1334
18.07.2016 07:00,1824,29.53,191,237,1633
18.07.2016 08:00,2144,32.38,161,233,1983
18.07.2016 09:00,2348,34.54,167,252,2181
18.07.2016 10:00,2408,32.98,213,263,2195
18.07.2016 11:00,2421,31.97,261,286,2160
18.07.2016 12:00,2454,31.83,265,316,2189
18.07.2016 13:00,2417,31.78,301,352,2116
18.07.2016 14:00,2444,31.8,295,376,2149
18.07.2016 15:00,2447,31.51,285,399,2162
18.07.2016 16:00,2404,30.96,305,396,2099
18.07.2016 17:00,2326,30.21,327,387,1999
18.07.2016 18:00,2370,30.8,288,364,2082
18.07.2016 19:00,2396,32.15,234,343,2162
18.07.2016 20:00,2371,32.44,215,322,2156
18.07.2016 21:00,2286,32.27,181,284,2105
18.07.2016 22:00,2201,32.4,149,257,2052
18.07.2016 23:00,2102,32.3,170,239,1932
19.07.2016 00:00,1882,30.45,211,226,1671
19.07.2016 01:00,1648,27.59,242,196,1406
19.07.2016 02:00,1550,27.09,256,187,1294
19.07.2016 03:00,1508,26.41,240,177,1268
19.07.2016 04:00,1478,25.89,219,163,1259
19.07.2016 05:00,1480,25.61,173,145,1307
19.07.2016 06:00,1502,26.14,134,125,1368
19.07.2016 07:00,1736,31,79,100,1657
19.07.2016 08:00,2090,34.48,31,75,2059
19.07.2016 09:00,2293,38.19,14,57,2279
19.07.2016 10:00,2319,35.7,24,47,2295
19.07.2016 11:00,2321,32.99,40,45,2281
19.07.2016 12:00,2329,32.91,50,47,2279
19.07.2016 13:00,2316,32.15,55,55,2261
19.07.2016 14:00,2292,31.84,66,63,2226
19.07.2016 15:00,2228,31.8,78,68,2150
19.07.2016 16:00,2195,32.05,86,73,2109
19.07.2016 17:00,2177,32.4,95,73,2082
19.07.2016 18:00,2201,35.25,95,79,2106
19.07.2016 19:00,2185,38.01,87,74,2098
19.07.2016 20:00,2149,36.83,81,72,2068
19.07.2016 21:00,2109,35.07,85,70,2024
19.07.2016 22:00,2028,34.41,118,72,1910
19.07.2016 23:00,1961,31.91,166,76,1795
20.07.2016 00:00,1741,28.92,165,74,1576
20.07.2016 01:00,1578,28.01,172,63,1406
20.07.2016 02:00,1529,26.32,134,56,1395
20.07.2016 03:00,1534,25.72,107,52,1427
20.07.2016 04:00,1529,25.4,88,49,1441
20.07.2016 05:00,1525,25.26,62,42,1463
20.07.2016 06:00,1551,26.49,44,35,1507
20.07.2016 07:00,1744,29.82,28,29,1716
20.07.2016 08:00,2065,32.71,8,23,2057
20.07.2016 09:00,2284,35.91,1,17,2283
20.07.2016 10:00,2361,33.99,3,15,2358
20.07.2016 11:00,2418,32.5,10,16,2408
20.07.2016 12:00,2388,32.21,16,20,2372
20.07.2016 13:00,2363,31.68,22,25,2341
20.07.2016 14:00,2337,31.84,32,30,2305
20.07.2016 15:00,2291,31.78,44,24,2247
20.07.2016 16:00,2274,31.63,52,38,2222
20.07.2016 17:00,2235,31.19,44,42,2191
20.07.2016 18:00,2287,31.78,36,42,2251
20.07.2016 19:00,2273,32.57,31,35,2242
20.07.2016 20:00,2246,33.65,29,50,2217
20.07.2016 21:00,2153,32.18,33,52,2120
20.07.2016 22:00,2067,31.2,45,56,2022
20.07.2016 23:00,2045,29.7,32,61,2013
21.07.2016 00:00,1900,29.05,22,67,1878
21.07.2016 01:00,1745,26.15,19,50,1726
21.07.2016 02:00,1666,26.15,25,54,1641
21.07.2016 03:00,1617,25.78,45,58,1572
21.07.2016 04:00,1592,25.52,76,69,1516
21.07.2016 05:00,1540,25.47,105,84,1435
21.07.2016 06:00,1548,26.9,108,91,1440
21.07.2016 07:00,1751,30.36,96,87,1655
21.07.2016 08:00,2093,32.4,54,81,2039
21.07.2016 09:00,2297,32.96,54,82,2243
21.07.2016 10:00,2379,33.42,76,94,2303
21.07.2016 11:00,2410,36.13,121,112,2289
21.07.2016 12:00,2406,33.98,137,126,2269
21.07.2016 13:00,2412,33.94,130,133,2282
21.07.2016 14:00,2359,33.42,138,149,2221
21.07.2016 15:00,2330,32.94,132,151,2198
21.07.2016 16:00,2308,32.68,138,148,2170
21.07.2016 17:00,2318,32.51,115,156,2203
21.07.2016 18:00,2380,33.54,87,148,2293
21.07.2016 19:00,2356,33.15,72,132,2284
21.07.2016 20:00,2292,32.82,47,105,2245
21.07.2016 21:00,2186,32.45,38,91,2148
21.07.2016 22:00,2120,32.84,48,83,2072
21.07.2016 23:00,2069,32.13,64,81,2005
22.07.2016 00:00,1908,30.87,58,81,1850
22.07.2016 01:00,1742,29.26,39,76,1703
22.07.2016 02:00,1680,27.24,30,78,1650
22.07.2016 03:00,1660,27.1,31,79,1629
22.07.2016 04:00,1617,26.56,30,79,1587
22.07.2016 05:00,1596,26.5,35,80,1561
22.07.2016 06:00,1591,28.06,40,79,1551
22.07.2016 07:00,1771,31.58,43,75,1728
22.07.2016 08:00,2063,33.89,31,62,2032
22.07.2016 09:00,2261,35.92,21,53,2240
22.07.2016 10:00,2339,36,34,55,2305
22.07.2016 11:00,2375,35.16,48,55,2327
22.07.2016 12:00,2360,34.41,60,61,2300
22.07.2016 13:00,2325,32.15,66,71,2259
22.07.2016 14:00,2281,30.78,77,76,2204
22.07.2016 15:00,2234,30.68,84,79,2150
22.07.2016 16:00,2196,31.19,98,84,2098
22.07.2016 17:00,2172,31.62,105,95,2067
22.07.2016 18:00,2209,32.48,97,98,2112
22.07.2016 19:00,2217,33.78,83,97,2134
22.07.2016 20:00,2138,33.3,81,93,2057
22.07.2016 21:00,2024,32.16,91,87,1933
22.07.2016 22:00,1945,31.5,104,81,1841
22.07.2016 23:00,1923,31.2,84,79,1839
23.07.2016 00:00,1794,29,69,75,1725
23.07.2016 01:00,1703,31.04,43,68,1660
23.07.2016 02:00,1631,30.24,46,77,1585
23.07.2016 03:00,1557,29.1,40,62,1517
23.07.2016 04:00,1536,27.02,35,63,1501
23.07.2016 05:00,1468,25.77,35,49,1433
23.07.2016 06:00,1410,25.65,35,41,1375
23.07.2016 07:00,1475,26.22,28,35,1447
23.07.2016 08:00,1591,30.32,20,29,1571
23.07.2016 09:00,1796,31.96,8,26,1788
23.07.2016 10:00,1975,32.53,4,27,1971
23.07.2016 11:00,2054,32.26,6,30,2048
23.07.2016 12:00,2075,31.97,10,35,2065
23.07.2016 13:00,2034,30.31,18,40,2016
23.07.2016 14:00,2005,30.02,25,46,1980
23.07.2016 15:00,1947,29.87,42,50,1905
23.07.2016 16:00,1916,29.67,62,55,1854
23.07.2016 17:00,1939,29.78,66,59,1873
23.07.2016 18:00,1960,30.57,61,62,1899
23.07.2016 19:00,1991,31.86,46,60,1945
23.07.2016 20:00,1968,32.81,41,54,1927
23.07.2016 21:00,1914,31.88,40,50,1874
23.07.2016 22:00,1878,31.6,53,52,1825
23.07.2016 23:00,1892,31.37,67,61,1825
24.07.2016 00:00,1710,29.08,88,60,1622
24.07.2016 01:00,1625,30.11,55,49,1570
24.07.2016 02:00,1551,28.11,47,45,1504
24.07.2016 03:00,1499,25.99,41,38,1458
24.07.2016 04:00,1472,25.43,29,31,1443
24.07.2016 05:00,1433,24.84,29,26,1404
24.07.2016 06:00,1345,24.57,39,23,1306
24.07.2016 07:00,1385,25.07,38,21,1347
24.07.2016 08:00,1515,26.65,19,20,1496
24.07.2016 09:00,1674,29.18,8,16,1666
24.07.2016 10:00,1830,30.46,8,15,1822
24.07.2016 11:00,1917,31.07,15,19,1902
24.07.2016 12:00,1963,31.18,19,23,1944
24.07.2016 13:00,1956,30.99,29,31,1927
24.07.2016 14:00,1944,30.63,44,41,1900
24.07.2016 15:00,1906,29.95,62,52,1844
24.07.2016 16:00,1879,29.36,87,60,1792
24.07.2016 17:00,1878,29.15,97,62,1781
24.07.2016 18:00,1914,29.79,101,63,1813
24.07.2016 19:00,1950,30.64,84,60,1866
24.07.2016 20:00,1986,31.82,58,55,1928
24.07.2016 21:00,1981,32.16,44,50,1937
24.07.2016 22:00,1995,32.42,47,52,1948
24.07.2016 23:00,2023,32.11,53,53,1970
25.07.2016 00:00,1850,31,44,55,1806
25.07.2016 01:00,1684,29.08,37,49,1647
25.07.2016 02:00,1599,27.32,28,51,1571
25.07.2016 03:00,1577,26.32,29,47,1548
25.07.2016 04:00,1564,25.93,25,43,1539
25.07.2016 05:00,1528,25.92,35,42,1493
25.07.2016 06:00,1533,27.8,37,39,1496
25.07.2016 07:00,1726,31.87,40,32,1686
25.07.2016 08:00,2037,32.93,20,31,2017
25.07.2016 09:00,2272,34.22,11,28,2261
25.07.2016 10:00,2408,37.03,14,31,2394
25.07.2016 11:00,2448,35.6,25,37,2423
25.07.2016 12:00,2447,35.19,45,46,2402
25.07.2016 13:00,2388,33.28,70,59,2318
25.07.2016 14:00,2371,32.95,89,75,2282
25.07.2016 15:00,2346,32.35,99,89,2247
25.07.2016 16:00,2369,32.6,96,92,2273
25.07.2016 17:00,2343,32.52,103,90,2240
25.07.2016 18:00,2342,34.34,99,85,2243
25.07.2016 19:00,2322,35.12,80,82,2242
25.07.2016 20:00,2275,33.22,79,83,2196
25.07.2016 21:00,2175,33.18,91,87,2084
25.07.2016 22:00,2117,33.15,132,90,1985
25.07.2016 23:00,2027,32.55,154,95,1873
26.07.2016 00:00,1797,30.4,179,92,1618
26.07.2016 01:00,1624,27.98,188,107,1436
26.07.2016 02:00,1568,27.5,163,102,1405
26.07.2016 03:00,1557,26.38,142,98,1415
26.07.2016 04:00,1565,25.88,119,94,1446
26.07.2016 05:00,1560,25.91,97,89,1463
26.07.2016 06:00,1552,26.53,111,83,1441
26.07.2016 07:00,1758,30.97,86,78,1672
26.07.2016 08:00,2080,32.2,69,83,2011
26.07.2016 09:00,2326,32.6,67,93,2259
26.07.2016 10:00,2416,36.55,77,115,2339
26.07.2016 11:00,2480,35.58,93,137,2387
26.07.2016 12:00,2499,36.12,131,167,2368
26.07.2016 13:00,2438,32.34,211,204,2227
26.07.2016 14:00,2429,32.16,227,235,2202
26.07.2016 15:00,2356,31.8,292,268,2064
26.07.2016 16:00,2290,32.13,346,282,1944
26.07.2016 17:00,2222,31.86,367,281,1855
26.07.2016 18:00,2229,33.01,347,276,1882
26.07.2016 19:00,2229,33.61,272,250,1957
26.07.2016 20:00,2232,33.56,187,224,2045
26.07.2016 21:00,2193,33.53,119,201,2074
26.07.2016 22:00,2095,34.21,156,178,1939
26.07.2016 23:00,1987,32.93,216,167,1771
27.07.2016 00:00,1802,30.2,232,157,1570
27.07.2016 01:00,1664,28.12,210,148,1454
27.07.2016 02:00,1577,26.95,203,136,1374
27.07.2016 03:00,1534,26.04,194,113,1340
27.07.2016 04:00,1529,25.87,151,90,1378
27.07.2016 05:00,1530,26,124,70,1406
27.07.2016 06:00,1532,26.63,93,56,1439
27.07.2016 07:00,1715,31.53,65,42,1650
27.07.2016 08:00,2021,32.4,34,32,1987
27.07.2016 09:00,2255,38.17,24,35,2231
27.07.2016 10:00,2359,39.69,44,52,2315
27.07.2016 11:00,2397,39.94,85,77,2312
27.07.2016 12:00,2401,40.26,107,93,2294
27.07.2016 13:00,2394,36.2,125,109,2269
27.07.2016 14:00,2413,35.65,115,130,2298
27.07.2016 15:00,2374,32.72,124,138,2250
27.07.2016 16:00,2344,32.6,127,146,2217
27.07.2016 17:00,2314,32.23,121,152,2193
27.07.2016 18:00,2297,32.35,170,161,2127
27.07.2016 19:00,2294,35.1,158,163,2136
27.07.2016 20:00,2286,35.73,120,178,2166
27.07.2016 21:00,2177,32.49,137,182,2040
27.07.2016 22:00,2145,32.95,141,175,2004
27.07.2016 23:00,2030,32.41,181,175,1849
28.07.2016 00:00,1789,29.94,231,174,1558
28.07.2016 01:00,1643,26.25,246,178,1397
28.07.2016 02:00,1575,25.75,255,174,1320
28.07.2016 03:00,1566,25.18,215,169,1351
28.07.2016 04:00,1553,24.8,182,163,1371
28.07.2016 05:00,1564,24.65,159,169,1405
28.07.2016 06:00,1614,25.76,137,168,1477
28.07.2016 07:00,1807,29.2,106,159,1701
28.07.2016 08:00,2100,31.19,87,152,2013
28.07.2016 09:00,2288,31.52,75,150,2213
28.07.2016 10:00,2407,31.77,90,143,2317
28.07.2016 11:00,2463,31.86,96,158,2367
28.07.2016 12:00,2454,31.72,125,163,2329
28.07.2016 13:00,2408,31.56,153,176,2255
28.07.2016 14:00,2400,31.1,159,196,2241
28.07.2016 15:00,2384,30.97,172,212,2212
28.07.2016 16:00,2341,30.81,176,214,2165
28.07.2016 17:00,2266,30.68,199,211,2067
28.07.2016 18:00,2224,31.45,218,197,2006
28.07.2016 19:00,2191,31.51,187,163,2004
28.07.2016 20:00,2164,31.45,137,142,2027
28.07.2016 21:00,2097,31.57,102,126,1995
28.07.2016 22:00,2050,31.7,123,120,1927
28.07.2016 23:00,2018,32.03,147,118,1871
29.07.2016 00:00,1837,29.92,148,111,1689
29.07.2016 01:00,1684,28.21,128,90,1556
29.07.2016 02:00,1606,27.04,111,79,1495
29.07.2016 03:00,1570,26.03,107,66,1463
29.07.2016 04:00,1538,24.58,108,63,1430
29.07.2016 05:00,1509,24.84,123,60,1386
29.07.2016 06:00,1514,25.95,116,61,1398
29.07.2016 07:00,1681,29.68,109,63,1572
29.07.2016 08:00,1980,31.59,75,64,1905
29.07.2016 09:00,2222,31.94,48,65,2174
29.07.2016 10:00,2368,32.79,37,69,2331
29.07.2016 11:00,2444,32.94,28,79,2416
29.07.2016 12:00,2434,32.41,42,77,2392
29.07.2016 13:00,2371,30.94,52,81,2319
29.07.2016 14:00,2347,30.23,64,90,2283
29.07.2016 15:00,2285,29.23,67,93,2218
29.07.2016 16:00,2223,29.12,85,95,2138
29.07.2016 17:00,2188,28.94,83,97,2105
29.07.2016 18:00,2212,29.82,84,103,2128
29.07.2016 19:00,2200,30.78,90,102,2110
29.07.2016 20:00,2139,31.59,108,103,2031
29.07.2016 21:00,2079,30.86,84,109,1995
29.07.2016 22:00,2032,30.12,122,120,1910
29.07.2016 23:00,1925,29.79,188,135,1737
30.07.2016 00:00,1758,28.87,213,133,1545
30.07.2016 01:00,1626,30.32,213,129,1413
30.07.2016 02:00,1512,26.83,220,135,1292
30.07.2016 03:00,1500,25.59,219,124,1281
30.07.2016 04:00,1465,24.63,179,124,1286
30.07.2016 05:00,1476,24.3,140,120,1336
30.07.2016 06:00,1450,24.39,104,108,1346
30.07.2016 07:00,1503,24.72,76,98,1427
30.07.2016 08:00,1626,26.09,49,88,1577
30.07.2016 09:00,1789,27.4,41,89,1748
30.07.2016 10:00,1948,29.21,53,92,1895
30.07.2016 11:00,2026,29.08,80,112,1946
30.07.2016 12:00,2043,28.83,103,141,1940
30.07.2016 13:00,2047,28.59,152,187,1895
30.07.2016 14:00,2002,27.99,206,218,1796
30.07.2016 15:00,1946,27.03,267,254,1679
30.07.2016 16:00,1913,27.01,309,296,1604
30.07.2016 17:00,1985,27.4,251,303,1734
30.07.2016 18:00,2035,27.8,212,296,1823
30.07.2016 19:00,2014,29.73,222,291,1792
30.07.2016 20:00,1983,30.64,234,279,1749
30.07.2016 21:00,1944,30.4,234,276,1710
30.07.2016 22:00,1929,30.46,258,278,1671
30.07.2016 23:00,1853,30.37,331,278,1522
31.07.2016 00:00,1663,29.43,376,279,1287
31.07.2016 01:00,1572,27.42,348,280,1224
31.07.2016 02:00,1499,25.36,344,288,1155
31.07.2016 03:00,1441,23.8,345,277,1096
31.07.2016 04:00,1417,22.56,334,260,1083
31.07.2016 05:00,1389,22.14,335,244,1054
31.07.2016 06:00,1348,21.65,307,224,1041
31.07.2016 07:00,1398,20.98,252,202,1146
31.07.2016 08:00,1531,21.99,180,183,1351
31.07.2016 09:00,1644,24.39,215,178,1429
31.07.2016 10:00,1696,25.74,250,191,1446
31.07.2016 11:00,1839,26.84,258,200,1581
31.07.2016 12:00,1868,27.43,262,218,1606
31.07.2016 13:00,1904,26.98,271,232,1633
31.07.2016 14:00,1901,26.19,277,249,1624
31.07.2016 15:00,1892,25.21,267,248,1625
31.07.2016 16:00,1861,25.27,318,263,1543
31.07.2016 17:00,1847,25.5,341,270,1506
31.07.2016 18:00,1904,26.53,303,235,1601
31.07.2016 19:00,1952,26.99,264,228,1688
31.07.2016 20:00,1927,28.37,232,201,1695
31.07.2016 21:00,1935,28.92,171,171,1764
31.07.2016 22:00,1964,30.19,141,153,1823
31.07.2016 23:00,1911,30.64,164,147,1747
08.01.2016 00:00,1780,27.78,134,142,1646
08.01.2016 01:00,1619,24.91,104,130,1515
08.01.2016 02:00,1510,23.79,130,120,1380
08.01.2016 03:00,1456,22.55,154,112,1302
08.01.2016 04:00,1495,22.14,126,116,1369
08.01.2016 05:00,1537,21.91,106,129,1431
08.01.2016 06:00,1556,24.52,88,119,1468
08.01.2016 07:00,1759,28.97,77,117,1682
08.01.2016 08:00,2066,31.2,55,116,2011
08.01.2016 09:00,2289,33.67,56,122,2233
08.01.2016 10:00,2363,32.55,79,151,2284
08.01.2016 11:00,2403,30.87,129,182,2274
08.01.2016 12:00,2407,30.79,197,231,2210
08.01.2016 13:00,2389,30.7,245,273,2144
08.01.2016 14:00,2398,30.56,304,335,2094
08.01.2016 15:00,2368,30.26,364,398,2004
08.01.2016 16:00,2252,30.08,493,450,1759
08.01.2016 17:00,2186,29.54,556,501,1630
08.01.2016 18:00,2228,30.99,532,494,1696
08.01.2016 19:00,2229,32.61,511,508,1718
08.01.2016 20:00,2250,31.99,461,510,1789
08.01.2016 21:00,2141,30.66,485,484,1656
08.01.2016 22:00,2079,30.78,518,463,1561
08.01.2016 23:00,1982,30.79,539,457,1443
08.02.2016 00:00,1772,29.38,552,459,1220
08.02.2016 01:00,1642,26.82,557,478,1085
08.02.2016 02:00,1547,25.25,555,468,992
08.02.2016 03:00,1493,24.74,557,452,936
08.02.2016 04:00,1494,24.63,531,432,963
08.02.2016 05:00,1508,24.27,484,393,1024
08.02.2016 06:00,1508,25.9,445,357,1063
08.02.2016 07:00,1732,30.43,364,313,1368
08.02.2016 08:00,2103,32.73,263,273,1840
08.02.2016 09:00,2253,33.65,293,258,1960
08.02.2016 10:00,2324,34.86,307,255,2017
08.02.2016 11:00,2405,36.08,293,260,2112
08.02.2016 12:00,2413,37.04,307,268,2106
08.02.2016 13:00,2434,36.77,291,293,2143
08.02.2016 14:00,2434,35,287,298,2147
08.02.2016 15:00,2359,34.25,311,301,2048
08.02.2016 16:00,2361,33.58,258,293,2103
08.02.2016 17:00,2263,32.74,270,273,1993
08.02.2016 18:00,2294,33.94,211,248,2083
08.02.2016 19:00,2247,35.06,154,202,2093
08.02.2016 20:00,2210,34.11,113,176,2097
08.02.2016 21:00,2117,32.83,108,154,2009
08.02.2016 22:00,2084,32.4,138,139,1946
08.02.2016 23:00,1960,31.19,191,130,1769
08.03.2016 00:00,1754,28.98,205,124,1549
08.03.2016 01:00,1641,26.03,178,113,1463
08.03.2016 02:00,1612,24.53,142,108,1470
08.03.2016 03:00,1604,23.74,110,102,1494
08.03.2016 04:00,1632,22.69,77,96,1555
08.03.2016 05:00,1635,23.04,69,89,1566
08.03.2016 06:00,1642,25.8,56,79,1586
08.03.2016 07:00,1826,29,61,75,1765
08.03.2016 08:00,2074,31.82,54,72,2020
08.03.2016 09:00,2259,33.95,60,89,2199
08.03.2016 10:00,2327,34.97,135,135,2192
08.03.2016 11:00,2365,35.02,230,204,2135
08.03.2016 12:00,2330,34.95,353,279,1977
08.03.2016 13:00,2284,33.57,478,373,1806
08.03.2016 14:00,2283,31.95,574,472,1709
08.03.2016 15:00,2253,32.58,647,534,1606
08.03.2016 16:00,2273,32.2,658,586,1615
08.03.2016 17:00,2334,31.21,606,636,1728
08.03.2016 18:00,2381,31.72,608,638,1773
08.03.2016 19:00,2305,32.52,656,616,1649
08.03.2016 20:00,2260,33,618,599,1642
08.03.2016 21:00,2175,31.25,619,600,1556
08.03.2016 22:00,2129,30.33,630,621,1499
08.03.2016 23:00,1922,28.99,717,623,1205
08.04.2016 00:00,1755,26.91,694,608,1061
08.04.2016 01:00,1714,23.55,624,635,1090
08.04.2016 02:00,1674,22.43,557,600,1117
08.04.2016 03:00,1634,20.05,520,555,1114
08.04.2016 04:00,1573,19.42,526,514,1047
08.04.2016 05:00,1575,19.83,477,463,1098
08.04.2016 06:00,1602,23.95,422,436,1180
08.04.2016 07:00,1763,26.99,383,392,1380
08.04.2016 08:00,2042,30.11,385,383,1657
08.04.2016 09:00,2241,32.99,399,387,1842
08.04.2016 10:00,2324,32.37,430,406,1894
08.04.2016 11:00,2423,32.73,389,415,2034
08.04.2016 12:00,2429,32.74,418,441,2011
08.04.2016 13:00,2345,32.53,475,456,1870
08.04.2016 14:00,2376,32.25,510,501,1866
08.04.2016 15:00,2312,32.16,608,555,1704
08.04.2016 16:00,2295,31.91,658,586,1637
08.04.2016 17:00,2311,31.28,581,590,1730
08.04.2016 18:00,2309,32.19,549,557,1760
08.04.2016 19:00,2308,33.75,522,540,1786
08.04.2016 20:00,2274,33.51,457,489,1817
08.04.2016 21:00,2296,32.1,318,443,1978
08.04.2016 22:00,2244,32.02,317,421,1927
08.04.2016 23:00,2136,31.89,327,415,1809
08.05.2016 00:00,1901,29.37,341,380,1560
08.05.2016 01:00,1702,27.45,348,334,1354
08.05.2016 02:00,1603,26.18,354,322,1249
08.05.2016 03:00,1542,25.12,360,313,1182
08.05.2016 04:00,1576,23.95,304,299,1272
08.05.2016 05:00,1589,24.07,266,278,1323
08.05.2016 06:00,1578,26.24,250,246,1328
08.05.2016 07:00,1772,30.45,212,209,1560
08.05.2016 08:00,2082,33.19,146,178,1936
08.05.2016 09:00,2320,36.3,104,153,2216
08.05.2016 10:00,2371,38.69,123,145,2248
08.05.2016 11:00,2413,38.54,157,145,2256
08.05.2016 12:00,2411,38,191,162,2220
08.05.2016 13:00,2372,36,211,178,2161
08.05.2016 14:00,2370,33.96,187,195,2183
08.05.2016 15:00,2311,32.16,207,214,2104
08.05.2016 16:00,2274,31.88,224,230,2050
08.05.2016 17:00,2219,30.92,253,251,1966
08.05.2016 18:00,2189,32.06,287,254,1902
08.05.2016 19:00,2164,33.12,242,235,1922
08.05.2016 20:00,2099,33.57,200,213,1899
08.05.2016 21:00,2062,32.47,166,203,1896
08.05.2016 22:00,2059,32.16,199,214,1860
08.05.2016 23:00,1933,31.52,250,225,1683
08.06.2016 00:00,1740,28.84,315,242,1425
08.06.2016 01:00,1551,29.58,379,261,1172
08.06.2016 02:00,1424,26.68,452,290,972
08.06.2016 03:00,1430,25.34,433,327,997
08.06.2016 04:00,1422,24.03,466,362,956
08.06.2016 05:00,1437,22.4,453,373,984
08.06.2016 06:00,1455,22.56,412,397,1043
08.06.2016 07:00,1520,23.53,391,397,1129
08.06.2016 08:00,1655,25.64,373,402,1282
08.06.2016 09:00,1792,28.23,452,440,1340
08.06.2016 10:00,1891,28.66,546,486,1345
08.06.2016 11:00,1922,29.82,648,534,1274
08.06.2016 12:00,1890,29.83,730,580,1160
08.06.2016 13:00,1931,29.58,747,629,1184
08.06.2016 14:00,1899,28.96,813,673,1086
08.06.2016 15:00,1944,28.35,772,713,1172
08.06.2016 16:00,2025,28.07,739,780,1286
08.06.2016 17:00,2015,27.84,756,780,1259
08.06.2016 18:00,2049,27.82,750,782,1299
08.06.2016 19:00,2036,27.46,745,776,1291
08.06.2016 20:00,1996,28.26,736,762,1260
08.06.2016 21:00,1975,28.92,707,751,1268
08.06.2016 22:00,1968,29.62,707,724,1261
08.06.2016 23:00,1846,29.54,774,723,1072
08.07.2016 00:00,1714,27.45,792,728,922
08.07.2016 01:00,1608,24.62,765,734,843
08.07.2016 02:00,1551,20.05,750,733,801
08.07.2016 03:00,1573,17.99,677,726,896
08.07.2016 04:00,1574,13.17,680,731,894
08.07.2016 05:00,1533,12.69,692,713,841
08.07.2016 06:00,1458,12.76,691,693,767
08.07.2016 07:00,1511,12.93,640,666,871
08.07.2016 08:00,1608,18.24,613,650,995
08.07.2016 09:00,1695,25.04,641,636,1054
08.07.2016 10:00,1713,27.72,702,614,1011
08.07.2016 11:00,1880,28.15,663,587,1217
08.07.2016 12:00,1991,29.03,562,561,1429
08.07.2016 13:00,1997,29.03,529,531,1468
08.07.2016 14:00,1954,28.59,543,502,1411
08.07.2016 15:00,1930,27.69,541,490,1389
08.07.2016 16:00,1936,27.39,588,533,1348
08.07.2016 17:00,2047,27.2,575,601,1472
08.07.2016 18:00,2112,27.09,584,632,1528
08.07.2016 19:00,2082,27.21,674,653,1408
08.07.2016 20:00,2010,28.45,742,673,1268
08.07.2016 21:00,2034,29.75,733,714,1301
08.07.2016 22:00,2105,29.98,689,722,1416
08.07.2016 23:00,1914,28.9,759,719,1155
08.08.2016 00:00,1771,26.33,765,732,1006
08.08.2016 01:00,1652,21.13,682,664,970
08.08.2016 02:00,1580,16.84,701,646,879
08.08.2016 03:00,1563,12.91,675,619,888
08.08.2016 04:00,1580,8.16,618,593,962
08.08.2016 05:00,1603,8.12,605,576,998
08.08.2016 06:00,1599,23.43,639,569,960
08.08.2016 07:00,1893,26.24,613,587,1280
08.08.2016 08:00,2231,26.96,664,622,1567
08.08.2016 09:00,2421,28.54,773,709,1648
08.08.2016 10:00,2502,29.54,909,819,1593
08.08.2016 11:00,2600,29.5,995,923,1605
08.08.2016 12:00,2586,29.06,1107,990,1479
08.08.2016 13:00,2542,28.74,1177,1040,1365
08.08.2016 14:00,2563,28.38,1198,1094,1365
08.08.2016 15:00,2535,27.91,1239,1151,1296
08.08.2016 16:00,2559,27.74,1219,1180,1340
08.08.2016 17:00,2480,26.79,1233,1207,1247
08.08.2016 18:00,2427,28.05,1239,1200,1188
08.08.2016 19:00,2436,28.74,1170,1179,1266
08.08.2016 20:00,2415,29.11,1126,1159,1289
08.08.2016 21:00,2400,27.93,1067,1126,1333
08.08.2016 22:00,2440,28.11,1013,1092,1427
08.08.2016 23:00,2324,26.84,967,1067,1357
08.09.2016 00:00,2165,25.41,922,1046,1243
08.09.2016 01:00,1945,19.51,951,1001,994
08.09.2016 02:00,1891,18,913,998,978
08.09.2016 03:00,1841,18.22,924,993,917
08.09.2016 04:00,1831,17.78,943,1005,888
08.09.2016 05:00,1834,18.73,972,1013,862
08.09.2016 06:00,1903,22.42,963,1025,940
08.09.2016 07:00,2145,28.33,950,1044,1195
08.09.2016 08:00,2475,31.85,1021,1081,1454
08.09.2016 09:00,2636,34,1089,1128,1547
08.09.2016 10:00,2667,34.19,1148,1164,1519
08.09.2016 11:00,2731,33.77,1170,1177,1561
08.09.2016 12:00,2751,33.44,1156,1196,1595
08.09.2016 13:00,2727,33.08,1152,1201,1575
08.09.2016 14:00,2736,32.04,1151,1196,1585
08.09.2016 15:00,2704,30.96,1152,1207,1552
08.09.2016 16:00,2686,29.9,1134,1220,1552
08.09.2016 17:00,2612,28.4,1094,1202,1518
08.09.2016 18:00,2589,28.61,1067,1167,1522
08.09.2016 19:00,2518,29.85,1058,1123,1460
08.09.2016 20:00,2501,31.25,985,1083,1516
08.09.2016 21:00,2566,29.29,885,1056,1681
08.09.2016 22:00,2573,29.62,861,1032,1712
08.09.2016 23:00,2431,28.4,871,1011,1560
08.10.2016 00:00,2242,25.82,858,999,1384
08.10.2016 01:00,1992,23.13,915,977,1077
08.10.2016 02:00,1908,22.41,934,977,974
08.10.2016 03:00,1909,21.47,920,969,989
08.10.2016 04:00,1880,19.99,914,951,966
08.10.2016 05:00,1883,19.87,931,942,952
08.10.2016 06:00,1885,23.5,950,937,935
08.10.2016 07:00,2142,28.12,932,932,1210
08.10.2016 08:00,2440,31.67,952,939,1488
08.10.2016 09:00,2487,33.95,1069,953,1418
08.10.2016 10:00,2500,34.33,1123,969,1377
08.10.2016 11:00,2531,35.41,1136,971,1395
08.10.2016 12:00,2630,38.13,1084,979,1546
08.10.2016 13:00,2630,35.07,1068,990,1562
08.10.2016 14:00,2627,36.05,1079,964,1548
08.10.2016 15:00,2634,37.43,977,924,1657
08.10.2016 16:00,2685,36.7,870,870,1815
08.10.2016 17:00,2608,35.07,783,787,1825
08.10.2016 18:00,2603,35.9,664,692,1939
08.10.2016 19:00,2562,35.52,579,606,1983
08.10.2016 20:00,2520,34.97,483,527,2037
08.10.2016 21:00,2458,33.72,425,470,2033
08.10.2016 22:00,2419,34.72,439,427,1980
08.10.2016 23:00,2339,32.14,367,402,1972
08.11.2016 00:00,2157,28.65,362,410,1795
08.11.2016 01:00,1895,24.83,447,406,1448
08.11.2016 02:00,1711,23.57,512,374,1199
08.11.2016 03:00,1697,23.27,506,377,1191
08.11.2016 04:00,1690,23.02,535,389,1155
08.11.2016 05:00,1680,23.06,563,398,1117
08.11.2016 06:00,1751,25.24,553,391,1198
08.11.2016 07:00,2035,29.29,517,389,1518
08.11.2016 08:00,2418,34.93,407,385,2011
08.11.2016 09:00,2534,36.7,456,395,2078
08.11.2016 10:00,2505,38.77,551,416,1954
08.11.2016 11:00,2590,40.52,560,453,2030
08.11.2016 12:00,2573,41.31,573,465,2000
08.11.2016 13:00,2564,42.72,569,478,1995
08.11.2016 14:00,2657,41.96,524,506,2133
08.11.2016 15:00,2592,40.35,541,499,2051
08.11.2016 16:00,2538,39.52,497,473,2041
08.11.2016 17:00,2492,34.8,441,441,2051
08.11.2016 18:00,2445,37.42,397,391,2048
08.11.2016 19:00,2417,36.97,299,317,2118
08.11.2016 20:00,2420,39.38,208,246,2212
08.11.2016 21:00,2393,35.98,170,203,2223
08.11.2016 22:00,2371,35.68,202,185,2169
08.11.2016 23:00,2190,33.87,222,166,1968
08.12.2016 00:00,1946,28.82,253,151,1693
08.12.2016 01:00,1819,24.66,239,157,1580
08.12.2016 02:00,1773,24.03,211,147,1562
08.12.2016 03:00,1777,23.56,177,138,1600
08.12.2016 04:00,1777,23.69,159,123,1618
08.12.2016 05:00,1826,23.96,148,116,1678
08.12.2016 06:00,1911,25.63,102,98,1809
08.12.2016 07:00,2185,29.36,72,87,2113
08.12.2016 08:00,2482,33.35,54,75,2428
08.12.2016 09:00,2551,35.74,55,67,2496
08.12.2016 10:00,2645,36,87,74,2558
08.12.2016 11:00,2684,36.02,132,86,2552
08.12.2016 12:00,2664,36.12,180,116,2484
08.12.2016 13:00,2570,35.91,244,159,2326
08.12.2016 14:00,2485,35.29,319,202,2166
08.12.2016 15:00,2339,32.15,423,244,1916
08.12.2016 16:00,2243,31.4,506,293,1737
08.12.2016 17:00,2220,30.7,548,361,1672
08.12.2016 18:00,2236,30.2,562,401,1674
08.12.2016 19:00,2260,29.47,588,457,1672
08.12.2016 20:00,2139,29.06,687,496,1452
08.12.2016 21:00,2056,29.13,746,540,1310
08.12.2016 22:00,2049,28.99,789,605,1260
08.12.2016 23:00,1931,27.86,856,683,1075
13.08.2016 00:00,1806,25.18,868,736,938
13.08.2016 01:00,1731,21.7,865,785,866
13.08.2016 02:00,1669,19.97,875,802,794
13.08.2016 03:00,1614,18.09,863,785,751
13.08.2016 04:00,1580,16.89,858,775,722
13.08.2016 05:00,1593,16.1,832,762,761
13.08.2016 06:00,1569,14.46,829,744,740
13.08.2016 07:00,1576,16.08,846,740,730
13.08.2016 08:00,1643,23.61,892,736,751
13.08.2016 09:00,1888,25.07,877,752,1011
13.08.2016 10:00,2117,26.11,804,770,1313
13.08.2016 11:00,2190,26.33,790,770,1400
13.08.2016 12:00,2184,26.51,809,753,1375
13.08.2016 13:00,2184,26.36,807,743,1377
13.08.2016 14:00,2195,26.26,783,757,1412
13.08.2016 15:00,2146,26.14,818,782,1328
13.08.2016 16:00,2204,26.02,770,809,1434
13.08.2016 17:00,2192,26.12,806,816,1386
13.08.2016 18:00,2095,26.2,880,798,1215
13.08.2016 19:00,2113,26.18,853,798,1260
13.08.2016 20:00,2012,26.51,896,773,1116
13.08.2016 21:00,1949,27.03,918,764,1031
13.08.2016 22:00,1998,28.38,891,760,1107
13.08.2016 23:00,1871,27.63,965,784,906
14.08.2016 00:00,1769,25.73,953,811,816
14.08.2016 01:00,1730,24.02,935,874,795
14.08.2016 02:00,1658,21.18,942,871,716
14.08.2016 03:00,1600,19.61,933,862,667
14.08.2016 04:00,1645,19.03,865,860,780
14.08.2016 05:00,1674,18.05,802,832,872
14.08.2016 06:00,1706,18.08,733,812,973
14.08.2016 07:00,1723,18.06,677,795,1046
14.08.2016 08:00,1826,24.43,642,765,1184
14.08.2016 09:00,1913,25.61,681,751,1232
14.08.2016 10:00,1988,27.12,751,739,1237
14.08.2016 11:00,2009,27.53,829,737,1180
14.08.2016 12:00,2041,27.73,823,719,1218
14.08.2016 13:00,2071,27.58,778,696,1293
14.08.2016 14:00,2121,27.3,665,666,1456
14.08.2016 15:00,2162,27.12,571,627,1591
14.08.2016 16:00,2148,26.64,527,589,1621
14.08.2016 17:00,2213,26.66,423,527,1790
14.08.2016 18:00,2268,26.71,350,474,1918
14.08.2016 19:00,2288,27.4,294,418,1994
14.08.2016 20:00,2260,29.57,231,337,2029
14.08.2016 21:00,2227,30.8,216,293,2011
14.08.2016 22:00,2203,31.53,284,268,1919
14.08.2016 23:00,2058,30.32,317,259,1741
15.08.2016 00:00,1856,27.82,335,265,1521
15.08.2016 01:00,1731,25.67,346,251,1385
15.08.2016 02:00,1676,22.94,341,260,1335
15.08.2016 03:00,1719,21.61,283,259,1436
15.08.2016 04:00,1731,21.52,254,247,1477
15.08.2016 05:00,1723,21.81,292,238,1431
15.08.2016 06:00,1773,25.42,306,222,1467
15.08.2016 07:00,2040,33.68,315,202,1725
15.08.2016 08:00,2432,36.76,233,184,2199
15.08.2016 09:00,2700,35.96,112,172,2588
15.08.2016 10:00,2777,35.87,102,169,2675
15.08.2016 11:00,2831,36.47,100,179,2731
15.08.2016 12:00,2826,36.02,135,201,2691
15.08.2016 13:00,2766,38.54,186,219,2580
15.08.2016 14:00,2725,35.55,247,233,2478
15.08.2016 15:00,2699,34.91,283,266,2416
15.08.2016 16:00,2616,33.96,324,282,2292
15.08.2016 17:00,2507,32.4,332,292,2175
15.08.2016 18:00,2497,32.94,333,286,2164
15.08.2016 19:00,2472,34.82,299,270,2173
15.08.2016 20:00,2431,35.88,274,250,2157
15.08.2016 21:00,2447,34.32,231,240,2216
15.08.2016 22:00,2487,34.47,233,257,2254
15.08.2016 23:00,2323,33.22,253,273,2070
16.08.2016 00:00,2098,29.69,293,289,1805
16.08.2016 01:00,1938,26.26,302,279,1636
16.08.2016 02:00,1854,23.99,295,281,1559
16.08.2016 03:00,1789,22.94,329,278,1460
16.08.2016 04:00,1781,22.03,341,278,1440
16.08.2016 05:00,1804,22.1,341,282,1463
16.08.2016 06:00,1825,24.1,377,280,1448
16.08.2016 07:00,2091,29.42,382,267,1709
16.08.2016 08:00,2496,33.63,279,237,2217
16.08.2016 09:00,2724,34.51,200,216,2524
16.08.2016 10:00,2786,34.73,203,216,2583
16.08.2016 11:00,2807,34.43,274,238,2533
16.08.2016 12:00,2785,33.7,325,260,2460
16.08.2016 13:00,2811,33.58,290,267,2521
16.08.2016 14:00,2886,33.87,187,276,2699
16.08.2016 15:00,2864,33.83,174,256,2690
16.08.2016 16:00,2759,33.32,197,235,2562
16.08.2016 17:00,2616,31.33,203,223,2413
16.08.2016 18:00,2650,33.12,174,212,2476
16.08.2016 19:00,2571,34.33,168,202,2403
16.08.2016 20:00,2519,35.79,145,180,2374
16.08.2016 21:00,2499,34.81,127,167,2372
16.08.2016 22:00,2533,34.36,143,174,2390
16.08.2016 23:00,2318,31.25,173,200,2145
17.08.2016 00:00,2140,27.74,183,215,1957
17.08.2016 01:00,1966,25.03,193,211,1773
17.08.2016 02:00,1870,24.01,230,230,1640
17.08.2016 03:00,1800,23.51,313,251,1487
17.08.2016 04:00,1789,21.9,343,274,1446
17.08.2016 05:00,1836,22.56,357,294,1479
17.08.2016 06:00,1935,25.05,366,304,1569
17.08.2016 07:00,2201,30.44,370,294,1831
17.08.2016 08:00,2508,35.55,326,273,2182
17.08.2016 09:00,2748,37.07,228,255,2520
17.08.2016 10:00,2832,37.15,171,256,2661
17.08.2016 11:00,2835,39.24,243,275,2592
17.08.2016 12:00,2797,40.81,336,298,2461
17.08.2016 13:00,2700,38.05,419,324,2281
17.08.2016 14:00,2705,37.09,453,364,2252
17.08.2016 15:00,2689,37.02,451,387,2238
17.08.2016 16:00,2722,35.78,424,398,2298
17.08.2016 17:00,2617,33.87,446,410,2171
17.08.2016 18:00,2609,35.08,433,405,2176
17.08.2016 19:00,2567,35.67,427,398,2140
17.08.2016 20:00,2590,37.07,380,391,2210
17.08.2016 21:00,2565,36.45,380,386,2185
17.08.2016 22:00,2492,35.48,384,383,2108
17.08.2016 23:00,2285,32.42,390,389,1895
18.08.2016 00:00,2095,28.82,405,399,1690
18.08.2016 01:00,1936,25.16,439,432,1497
18.08.2016 02:00,1885,24.12,443,453,1442
18.08.2016 03:00,1825,23.34,505,487,1320
18.08.2016 04:00,1773,21.83,602,529,1171
18.08.2016 05:00,1795,22.66,641,553,1154
18.08.2016 06:00,1913,25.17,656,600,1257
18.08.2016 07:00,2164,30.69,707,629,1457
18.08.2016 08:00,2515,34.62,736,651,1779
18.08.2016 09:00,2675,36.49,755,674,1920
18.08.2016 10:00,2756,35.78,772,688,1984
18.08.2016 11:00,2801,34.9,785,691,2016
18.08.2016 12:00,2852,34.69,734,669,2118
18.08.2016 13:00,2875,34.81,624,630,2251
18.08.2016 14:00,2982,34.83,489,597,2493
18.08.2016 15:00,2935,35.31,432,539,2503
18.08.2016 16:00,2833,34.78,402,473,2431
18.08.2016 17:00,2706,33.59,400,416,2306
18.08.2016 18:00,2656,35.01,370,363,2286
18.08.2016 19:00,2580,36.05,359,328,2221
18.08.2016 20:00,2529,37.34,280,297,2249
18.08.2016 21:00,2600,36.85,187,264,2413
18.08.2016 22:00,2552,36.01,164,233,2388
18.08.2016 23:00,2325,32.74,144,203,2181
19.08.2016 00:00,2114,28.92,103,165,2011
19.08.2016 01:00,1968,27.71,79,126,1889
19.08.2016 02:00,1878,26.62,80,109,1798
19.08.2016 03:00,1839,25.51,69,90,1770
19.08.2016 04:00,1828,24.5,47,71,1781
19.08.2016 05:00,1832,25.58,44,52,1788
19.08.2016 06:00,1931,28.26,35,42,1896
19.08.2016 07:00,2188,33.81,43,33,2145
19.08.2016 08:00,2544,43.34,30,27,2514
19.08.2016 09:00,2718,43.4,18,24,2700
19.08.2016 10:00,2780,44.21,13,22,2767
19.08.2016 11:00,2815,44.47,11,23,2804
19.08.2016 12:00,2823,44.63,14,27,2809
19.08.2016 13:00,2751,44.78,23,37,2728
19.08.2016 14:00,2707,44.25,44,49,2663
19.08.2016 15:00,2615,42.77,51,63,2564
19.08.2016 16:00,2539,39.48,59,76,2480
19.08.2016 17:00,2432,35.63,89,89,2343
19.08.2016 18:00,2431,38.65,104,103,2327
19.08.2016 19:00,2388,36.09,91,99,2297
19.08.2016 20:00,2301,36.46,90,94,2211
19.08.2016 21:00,2237,34.99,100,89,2137
19.08.2016 22:00,2239,34.32,110,91,2129
19.08.2016 23:00,2081,32.22,108,95,1973
20.08.2016 00:00,1971,28.87,92,96,1879
20.08.2016 01:00,1852,26.54,107,94,1745
20.08.2016 02:00,1730,25.65,128,97,1602
20.08.2016 03:00,1710,25.01,107,101,1603
20.08.2016 04:00,1695,24.91,102,105,1593
20.08.2016 05:00,1701,24.87,112,106,1589
20.08.2016 06:00,1676,25.08,138,113,1538
20.08.2016 07:00,1671,25.81,158,118,1513
20.08.2016 08:00,1758,28.76,189,119,1569
20.08.2016 09:00,1956,34.11,189,126,1767
20.08.2016 10:00,2163,35.42,163,132,2000
20.08.2016 11:00,2253,36.76,168,154,2085
20.08.2016 12:00,2284,36.56,180,174,2104
20.08.2016 13:00,2211,35.39,280,210,1931
20.08.2016 14:00,2130,34.85,330,231,1800
20.08.2016 15:00,2128,34.15,285,236,1843
20.08.2016 16:00,2119,33.47,252,235,1867
20.08.2016 17:00,2174,33.48,201,228,1973
20.08.2016 18:00,2190,33.92,183,207,2007
20.08.2016 19:00,2132,33.9,237,190,1895
20.08.2016 20:00,2114,33.48,209,181,1905
20.08.2016 21:00,2150,33.16,182,175,1968
20.08.2016 22:00,2107,33.71,158,171,1949
20.08.2016 23:00,1993,30.2,112,171,1881
21.08.2016 00:00,1843,27.99,122,144,1721
21.08.2016 01:00,1715,25.76,132,120,1583
21.08.2016 02:00,1664,25.19,83,105,1581
21.08.2016 03:00,1594,25.1,69,89,1525
21.08.2016 04:00,1590,25.01,54,73,1536
21.08.2016 05:00,1594,24.97,24,56,1570
21.08.2016 06:00,1587,24.9,21,45,1566
21.08.2016 07:00,1563,25.43,38,40,1525
21.08.2016 08:00,1648,26.82,35,37,1613
21.08.2016 09:00,1839,28.44,19,30,1820
21.08.2016 10:00,2038,29.56,9,29,2029
21.08.2016 11:00,2177,31.31,7,26,2170
21.08.2016 12:00,2240,33.5,5,27,2235
21.08.2016 13:00,2245,33.87,10,30,2235
21.08.2016 14:00,2201,33.23,19,38,2182
21.08.2016 15:00,2186,32.34,23,44,2163
21.08.2016 16:00,2126,31.86,58,49,2068
21.08.2016 17:00,2106,32.46,84,52,2022
21.08.2016 18:00,2164,32.19,78,57,2086
21.08.2016 19:00,2185,32.04,67,59,2118
21.08.2016 20:00,2226,33.13,35,64,2191
21.08.2016 21:00,2257,33.92,32,67,2225
21.08.2016 22:00,2245,33.93,45,78,2200
21.08.2016 23:00,2086,31.34,74,90,2012
22.08.2016 00:00,1888,27.64,106,93,1782
22.08.2016 01:00,1743,26.72,130,98,1613
22.08.2016 02:00,1677,25.09,148,100,1529
22.08.2016 03:00,1650,25.07,158,102,1492
22.08.2016 04:00,1663,25.11,158,105,1505
22.08.2016 05:00,1737,25.25,131,104,1606
22.08.2016 06:00,1894,26.95,101,101,1793
22.08.2016 07:00,2175,32.14,88,95,2087
22.08.2016 08:00,2562,43.53,76,92,2486
22.08.2016 09:00,2727,43.56,47,86,2680
22.08.2016 10:00,2744,44.93,43,87,2701
22.08.2016 11:00,2817,49.4,68,98,2749
22.08.2016 12:00,2781,48.76,130,114,2651
22.08.2016 13:00,2754,47.59,182,150,2572
22.08.2016 14:00,2725,47.77,248,196,2477
22.08.2016 15:00,2673,44.81,295,226,2378
22.08.2016 16:00,2626,43.53,337,254,2289
22.08.2016 17:00,2609,38.4,289,265,2320
22.08.2016 18:00,2654,40.03,230,257,2424
22.08.2016 19:00,2612,38.09,195,236,2417
22.08.2016 20:00,2554,37.71,188,213,2366
22.08.2016 21:00,2482,37.64,238,201,2244
22.08.2016 22:00,2350,35.02,339,209,2011
22.08.2016 23:00,2145,31.63,346,221,1799
23.08.2016 00:00,1969,27.92,290,227,1679
23.08.2016 01:00,1842,24.26,277,236,1565
23.08.2016 02:00,1795,22.9,243,223,1552
23.08.2016 03:00,1777,21.62,233,196,1544
23.08.2016 04:00,1752,20.79,210,188,1542
23.08.2016 05:00,1795,22.55,190,183,1605
23.08.2016 06:00,1918,26.01,155,162,1763
23.08.2016 07:00,2255,31.31,102,151,2153
23.08.2016 08:00,2583,38.08,97,133,2486
23.08.2016 09:00,2727,43.43,87,110,2640
23.08.2016 10:00,2761,43.5,85,105,2676
23.08.2016 11:00,2799,43.5,90,104,2709
23.08.2016 12:00,2806,43.49,115,111,2691
23.08.2016 13:00,2754,43.49,146,123,2608
23.08.2016 14:00,2750,43.42,174,136,2576
23.08.2016 15:00,2686,43.04,182,154,2504
23.08.2016 16:00,2652,39.52,174,155,2478
23.08.2016 17:00,2566,37.26,173,149,2393
23.08.2016 18:00,2578,38.89,142,134,2436
23.08.2016 19:00,2539,40.2,103,116,2436
23.08.2016 20:00,2512,41.6,64,98,2448
23.08.2016 21:00,2522,42,66,86,2456
23.08.2016 22:00,2420,38.92,101,81,2319
23.08.2016 23:00,2216,33.38,110,78,2106
24.08.2016 00:00,2013,28.36,100,71,1913
24.08.2016 01:00,1846,26.19,86,74,1760
24.08.2016 02:00,1806,25.09,71,69,1735
24.08.2016 03:00,1806,24.85,49,61,1757
24.08.2016 04:00,1818,25.01,31,52,1787
24.08.2016 05:00,1843,25.53,26,48,1817
24.08.2016 06:00,1948,27.48,25,43,1923
24.08.2016 07:00,2225,31.95,14,36,2211
24.08.2016 08:00,2588,38.99,6,27,2582
24.08.2016 09:00,2694,43.47,3,21,2691
24.08.2016 10:00,2719,46.18,2,18,2717
24.08.2016 11:00,2742,46.16,7,20,2735
24.08.2016 12:00,2779,46.1,12,22,2767
24.08.2016 13:00,2752,44.92,20,26,2732
24.08.2016 14:00,2745,43.48,33,40,2712
24.08.2016 15:00,2714,43.43,48,47,2666
24.08.2016 16:00,2719,38.91,64,60,2655
24.08.2016 17:00,2630,36.27,81,73,2549
24.08.2016 18:00,2594,36.97,89,91,2505
24.08.2016 19:00,2508,37.69,105,104,2403
24.08.2016 20:00,2458,38.44,129,124,2329
24.08.2016 21:00,2464,37.99,181,142,2283
24.08.2016 22:00,2387,34.01,230,165,2157
24.08.2016 23:00,2173,29.31,261,191,1912
25.08.2016 00:00,1964,26.87,260,210,1704
25.08.2016 01:00,1866,22.63,269,265,1597
25.08.2016 02:00,1788,22.4,296,269,1492
25.08.2016 03:00,1750,20.97,321,275,1429
25.08.2016 04:00,1736,21.16,337,282,1399
25.08.2016 05:00,1776,21.98,322,285,1454
25.08.2016 06:00,1896,24.95,291,285,1605
25.08.2016 07:00,2160,30.52,277,281,1883
25.08.2016 08:00,2518,35.04,255,253,2263
25.08.2016 09:00,2729,36.58,178,227,2551
25.08.2016 10:00,2794,35.96,145,220,2649
25.08.2016 11:00,2859,36.06,180,235,2679
25.08.2016 12:00,2839,35.65,250,262,2589
25.08.2016 13:00,2729,35.54,352,312,2377
25.08.2016 14:00,2706,34.74,448,373,2258
25.08.2016 15:00,2706,34.52,487,419,2219
25.08.2016 16:00,2696,34.08,499,452,2197
25.08.2016 17:00,2627,32.94,516,481,2111
25.08.2016 18:00,2542,34.84,531,458,2011
25.08.2016 19:00,2551,36.65,447,454,2104
25.08.2016 20:00,2610,38.78,421,458,2189
25.08.2016 21:00,2536,37.96,518,444,2018
25.08.2016 22:00,2300,34.16,611,435,1689
25.08.2016 23:00,2085,28.88,618,430,1467
26.08.2016 00:00,1873,26.5,623,430,1250
26.08.2016 01:00,1838,22.64,638,536,1200
26.08.2016 02:00,1786,20.84,612,534,1174
26.08.2016 03:00,1776,20.81,603,547,1173
26.08.2016 04:00,1763,20.73,602,558,1161
26.08.2016 05:00,1744,23.03,647,570,1097
26.08.2016 06:00,1839,25.94,683,564,1156
26.08.2016 07:00,2105,29.71,671,553,1434
26.08.2016 08:00,2525,34.47,579,513,1946
26.08.2016 09:00,2814,35.9,438,479,2376
26.08.2016 10:00,2916,34.92,372,488,2544
26.08.2016 11:00,2930,33.35,381,490,2549
26.08.2016 12:00,2911,32.38,397,497,2514
26.08.2016 13:00,2855,33.35,423,495,2432
26.08.2016 14:00,2826,33.09,452,546,2374
26.08.2016 15:00,2709,32.29,490,555,2219
26.08.2016 16:00,2604,30.11,526,554,2078
26.08.2016 17:00,2514,30.46,562,543,1952
26.08.2016 18:00,2495,34.19,573,528,1922
26.08.2016 19:00,2404,34.79,589,532,1815
26.08.2016 20:00,2390,33.9,555,525,1835
26.08.2016 21:00,2351,32.84,560,512,1791
26.08.2016 22:00,2295,32.49,549,492,1746
26.08.2016 23:00,2105,29.36,536,469,1569
27.08.2016 00:00,1978,26.57,475,448,1503
27.08.2016 01:00,1869,25.31,436,433,1433
27.08.2016 02:00,1779,24.05,425,428,1354
27.08.2016 03:00,1671,23,448,410,1223
27.08.2016 04:00,1630,23.07,441,388,1189
27.08.2016 05:00,1639,23.28,434,373,1205
27.08.2016 06:00,1656,23.18,414,353,1242
27.08.2016 07:00,1640,25.28,393,324,1247
27.08.2016 08:00,1829,26.84,325,300,1504
27.08.2016 09:00,2018,29.5,344,286,1674
27.08.2016 10:00,2138,29.56,368,300,1770
27.08.2016 11:00,2173,25.48,369,307,1804
27.08.2016 12:00,2149,23.86,388,319,1761
27.08.2016 13:00,2127,22.82,397,336,1730
27.08.2016 14:00,2102,22.24,403,344,1699
27.08.2016 15:00,2057,21.99,382,337,1675
27.08.2016 16:00,2053,22.46,348,316,1705
27.08.2016 17:00,2080,23.59,300,280,1780
27.08.2016 18:00,2134,28.41,240,237,1894
27.08.2016 19:00,2197,33.2,166,192,2031
27.08.2016 20:00,2180,34.51,112,155,2068
27.08.2016 21:00,2176,34.11,129,131,2047
27.08.2016 22:00,2108,32.8,154,120,1954
27.08.2016 23:00,1966,29.33,147,113,1819
28.08.2016 00:00,1849,25.03,124,109,1725
28.08.2016 01:00,1763,23.14,99,93,1664
28.08.2016 02:00,1699,20.98,93,89,1606
28.08.2016 03:00,1659,21.01,108,91,1551
28.08.2016 04:00,1603,21.29,160,104,1443
28.08.2016 05:00,1541,20.34,230,132,1311
28.08.2016 06:00,1558,20.32,273,170,1285
28.08.2016 07:00,1716,20.48,165,209,1551
28.08.2016 08:00,1731,24.08,265,242,1466
28.08.2016 09:00,1740,26.91,442,291,1298
28.08.2016 10:00,1860,29.42,543,350,1317
28.08.2016 11:00,2045,30.53,565,413,1480
28.08.2016 12:00,2129,31.52,553,433,1576
28.08.2016 13:00,2196,30.54,518,455,1678
28.08.2016 14:00,2214,30.07,446,444,1768
28.08.2016 15:00,2222,29.94,390,430,1832
28.08.2016 16:00,2348,29.83,240,415,2108
28.08.2016 17:00,2414,29.67,189,407,2225
28.08.2016 18:00,2416,29.75,215,405,2201
28.08.2016 19:00,2358,29.92,297,383,2061
28.08.2016 20:00,2325,32.95,342,358,1983
28.08.2016 21:00,2420,33.76,296,333,2124
28.08.2016 22:00,2274,32.45,288,310,1986
28.08.2016 23:00,2081,28.98,267,277,1814
29.08.2016 00:00,1940,24.29,206,248,1734
29.08.2016 01:00,1771,23.24,185,172,1586
29.08.2016 02:00,1710,23.02,171,183,1539
29.08.2016 03:00,1687,22.09,215,212,1472
29.08.2016 04:00,1726,22.09,244,261,1482
29.08.2016 05:00,1772,22.61,297,335,1475
29.08.2016 06:00,1881,24.52,363,387,1518
29.08.2016 07:00,2208,31.91,399,410,1809
29.08.2016 08:00,2587,39.29,392,430,2195
29.08.2016 09:00,2680,40.69,484,476,2196
29.08.2016 10:00,2637,36.35,576,527,2061
29.08.2016 11:00,2701,36.33,682,616,2019
29.08.2016 12:00,2609,35.92,919,709,1690
29.08.2016 13:00,2580,37.12,1013,777,1567
29.08.2016 14:00,2658,38.06,1017,873,1641
29.08.2016 15:00,2726,36.26,991,935,1735
29.08.2016 16:00,2716,34.74,1032,978,1684
29.08.2016 17:00,2589,31.3,1104,1018,1485
29.08.2016 18:00,2614,31.43,1048,1014,1566
29.08.2016 19:00,2662,32.58,929,984,1733
29.08.2016 20:00,2680,35.76,833,944,1847
29.08.2016 21:00,2686,33.93,824,887,1862
29.08.2016 22:00,2478,30.79,883,837,1595
29.08.2016 23:00,2178,28.39,935,827,1243
30.08.2016 00:00,1951,24.19,910,792,1041
30.08.2016 01:00,1860,24.73,822,779,1038
30.08.2016 02:00,1794,24.15,759,734,1035
30.08.2016 03:00,1767,23.74,731,676,1036
30.08.2016 04:00,1770,23.35,682,636,1088
30.08.2016 05:00,1819,22.74,630,608,1189
30.08.2016 06:00,1912,24.54,622,568,1290
30.08.2016 07:00,2123,32.65,632,511,1491
30.08.2016 08:00,2483,40.59,539,465,1944
30.08.2016 09:00,2621,43.82,469,436,2152
30.08.2016 10:00,2661,38.97,479,441,2182
30.08.2016 11:00,2396,38.98,503,445,1893
30.08.2016 12:00,2224,38.93,535,452,1689
30.08.2016 13:00,2678,39.33,537,488,2141
30.08.2016 14:00,2707,39.03,548,516,2159
30.08.2016 15:00,2582,38.63,616,542,1966
30.08.2016 16:00,2581,37.7,614,557,1967
30.08.2016 17:00,2513,34.15,586,525,1927
30.08.2016 18:00,2565,37.84,534,498,2031
30.08.2016 19:00,2480,40.6,492,442,1988
30.08.2016 20:00,2488,43.71,402,419,2086
30.08.2016 21:00,2494,44.83,432,415,2062
30.08.2016 22:00,2329,40.83,501,403,1828
30.08.2016 23:00,2065,32.96,584,407,1481
31.08.2016 00:00,1871,26.64,546,396,1325
31.08.2016 01:00,1817,25.6,491,422,1326
31.08.2016 02:00,1767,24.02,438,386,1329
31.08.2016 03:00,1794,23.48,366,336,1428
31.08.2016 04:00,1787,22.77,323,292,1464
31.08.2016 05:00,1801,22.79,276,255,1525
31.08.2016 06:00,1924,25.34,238,225,1686
31.08.2016 07:00,2226,32.98,193,198,2033
31.08.2016 08:00,2581,40.46,147,177,2434
31.08.2016 09:00,2730,43.07,124,154,2606
31.08.2016 10:00,2692,45.44,141,137,2551
31.08.2016 11:00,2721,43.91,147,134,2574
31.08.2016 12:00,2737,37.03,142,138,2595
31.08.2016 13:00,2703,35.87,161,152,2542
31.08.2016 14:00,2715,35.89,171,167,2544
31.08.2016 15:00,2735,34.95,165,193,2570
31.08.2016 16:00,2723,32.57,180,213,2543
31.08.2016 17:00,2652,31.58,180,223,2472
31.08.2016 18:00,2690,35.15,179,236,2511
31.08.2016 19:00,2672,38.03,173,244,2499
31.08.2016 20:00,2634,39.95,212,263,2422
31.08.2016 21:00,2608,38.66,302,298,2306
31.08.2016 22:00,2465,32.42,383,332,2082
31.08.2016 23:00,2244,27.7,452,368,1792
09.01.2016 00:00,1962,24.2,508,394,1454
09.01.2016 01:00,1862,22.65,503,394,1359
09.01.2016 02:00,1799,21.24,460,388,1339
09.01.2016 03:00,1818,21.09,417,371,1401
09.01.2016 04:00,1838,21.85,393,341,1445
09.01.2016 05:00,1829,23.59,374,310,1455
09.01.2016 06:00,1915,25.1,371,278,1544
09.01.2016 07:00,2191,32.16,332,258,1859
09.01.2016 08:00,2568,37.06,265,245,2303
09.01.2016 09:00,2767,41.08,179,224,2588
09.01.2016 10:00,2791,38.24,183,241,2608
09.01.2016 11:00,2774,34.92,270,260,2504
09.01.2016 12:00,2694,32.98,374,294,2320
09.01.2016 13:00,2630,30.75,440,335,2190
09.01.2016 14:00,2724,30.27,422,382,2302
09.01.2016 15:00,2737,29.3,398,406,2339
09.01.2016 16:00,2722,29.51,421,429,2301
09.01.2016 17:00,2683,29.68,429,452,2254
09.01.2016 18:00,2749,33.24,368,436,2381
09.01.2016 19:00,2694,35.94,340,408,2354
09.01.2016 20:00,2678,36,289,370,2389
09.01.2016 21:00,2719,36.09,311,367,2408
09.01.2016 22:00,2524,33.5,402,382,2122
09.01.2016 23:00,2288,29.7,437,397,1851
09.02.2016 00:00,2090,25.19,443,419,1647
09.02.2016 01:00,1885,24.35,495,399,1390
09.02.2016 02:00,1753,23.32,560,421,1193
09.02.2016 03:00,1734,23.19,562,423,1172
09.02.2016 04:00,1704,22.91,560,426,1144
09.02.2016 05:00,1756,23.1,517,414,1239
09.02.2016 06:00,1877,25.97,517,402,1360
09.02.2016 07:00,2184,32.29,459,368,1725
09.02.2016 08:00,2612,37.49,365,353,2247
09.02.2016 09:00,2780,40.5,312,361,2468
09.02.2016 10:00,2779,37.91,378,386,2401
09.02.2016 11:00,2714,33.07,462,370,2252
09.02.2016 12:00,2744,31.26,438,396,2306
09.02.2016 13:00,2654,30.65,448,387,2206
09.02.2016 14:00,2620,30.22,430,397,2190
09.02.2016 15:00,2552,28.13,403,395,2149
09.02.2016 16:00,2548,28.71,361,387,2187
09.02.2016 17:00,2521,29.98,358,372,2163
09.02.2016 18:00,2563,33.11,336,355,2227
09.02.2016 19:00,2511,35.22,352,342,2159
09.02.2016 20:00,2397,35.2,424,350,1973
09.02.2016 21:00,2403,32.62,413,365,1990
09.02.2016 22:00,2279,31.23,444,399,1835
09.02.2016 23:00,2149,28.39,432,438,1717
09.03.2016 00:00,1994,26.6,445,446,1549
09.03.2016 01:00,1851,26.18,487,534,1364
09.03.2016 02:00,1726,25.3,498,525,1228
09.03.2016 03:00,1738,24.76,442,529,1296
09.03.2016 04:00,1757,24.28,412,542,1345
09.03.2016 05:00,1721,24.02,437,534,1284
09.03.2016 06:00,1714,24.32,459,509,1255
09.03.2016 07:00,1779,25.04,442,501,1337
09.03.2016 08:00,1859,28.73,464,474,1395
09.03.2016 09:00,1961,30.79,497,448,1464
09.03.2016 10:00,2058,32.16,550,451,1508
09.03.2016 11:00,2056,30.35,612,459,1444
09.03.2016 12:00,2075,29.06,637,489,1438
09.03.2016 13:00,2045,27.83,680,513,1365
09.03.2016 14:00,2019,25.71,663,536,1356
09.03.2016 15:00,1993,25.73,657,542,1336
09.03.2016 16:00,2018,25.98,632,544,1386
09.03.2016 17:00,2079,26.93,562,525,1517
09.03.2016 18:00,2071,30.44,545,486,1526
09.03.2016 19:00,2166,33.45,451,435,1715
09.03.2016 20:00,2195,33.61,399,394,1796
09.03.2016 21:00,2156,33.63,407,361,1749
09.03.2016 22:00,2038,32.69,455,342,1583
09.03.2016 23:00,1867,31.59,462,321,1405
09.04.2016 00:00,1702,27.96,451,297,1251
09.04.2016 01:00,1680,25.47,388,343,1292
09.04.2016 02:00,1631,24.91,323,306,1308
09.04.2016 03:00,1573,23.09,284,257,1289
09.04.2016 04:00,1544,22.04,258,213,1286
09.04.2016 05:00,1544,20.81,226,182,1318
09.04.2016 06:00,1585,20.09,182,153,1403
09.04.2016 07:00,1577,20.03,147,125,1430
09.04.2016 08:00,1674,23.53,116,100,1558
09.04.2016 09:00,1876,24.48,62,80,1814
09.04.2016 10:00,2029,25.78,31,70,1998
09.04.2016 11:00,2113,27.25,24,68,2089
09.04.2016 12:00,2186,27.63,20,58,2166
09.04.2016 13:00,2229,27.68,14,63,2215
09.04.2016 14:00,2213,27.08,24,72,2189
09.04.2016 15:00,2200,26.53,37,79,2163
09.04.2016 16:00,2185,25.96,53,92,2132
09.04.2016 17:00,2199,26.07,75,104,2124
09.04.2016 18:00,2248,27.36,85,116,2163
09.04.2016 19:00,2328,27.91,82,133,2246
09.04.2016 20:00,2395,30.71,95,152,2300
09.04.2016 21:00,2412,33.83,137,160,2275
09.04.2016 22:00,2307,31.79,139,182,2168
09.04.2016 23:00,2039,29.53,241,203,1798
09.05.2016 00:00,1929,25.06,267,252,1662
09.05.2016 01:00,1860,23.18,326,306,1534
09.05.2016 02:00,1752,22.3,413,348,1339
09.05.2016 03:00,1675,22.42,489,374,1186
09.05.2016 04:00,1689,21.73,510,390,1179
09.05.2016 05:00,1725,22.96,506,400,1219
09.05.2016 06:00,1894,24.96,516,402,1378
09.05.2016 07:00,2235,32.79,517,394,1718
09.05.2016 08:00,2622,42.98,449,361,2173
09.05.2016 09:00,2806,44.42,290,320,2516
09.05.2016 10:00,2837,43.31,212,289,2625
09.05.2016 11:00,2888,44.97,197,268,2691
09.05.2016 12:00,2884,48.01,176,239,2708
09.05.2016 13:00,2841,45.98,153,208,2688
09.05.2016 14:00,2876,45.31,119,187,2757
09.05.2016 15:00,2870,42.58,80,164,2790
09.05.2016 16:00,2837,43.03,70,147,2767
09.05.2016 17:00,2750,41.9,65,135,2685
09.05.2016 18:00,2695,41.98,66,112,2629
09.05.2016 19:00,2630,39.92,60,92,2570
09.05.2016 20:00,2613,43.12,65,87,2548
09.05.2016 21:00,2660,43.13,87,79,2573
09.05.2016 22:00,2541,37.51,70,71,2471
09.05.2016 23:00,2355,32.77,34,67,2321
09.06.2016 00:00,2087,28.07,25,62,2062
09.06.2016 01:00,1940,27.68,27,35,1913
09.06.2016 02:00,1870,25.98,39,32,1831
09.06.2016 03:00,1827,24.84,55,32,1772
09.06.2016 04:00,1841,23.76,56,36,1785
09.06.2016 05:00,1863,23.92,67,46,1796
09.06.2016 06:00,2012,26.43,85,54,1927
09.06.2016 07:00,2330,33.54,101,59,2229
09.06.2016 08:00,2692,40.93,115,67,2577
09.06.2016 09:00,2808,43.81,103,74,2705
09.06.2016 10:00,2796,41.05,69,82,2727
09.06.2016 11:00,2870,35.46,58,84,2812
09.06.2016 12:00,2888,32.84,120,134,2768
09.06.2016 13:00,2798,29.4,215,182,2583
09.06.2016 14:00,2743,28.9,301,237,2442
09.06.2016 15:00,2698,29.29,369,294,2329
09.06.2016 16:00,2694,29.27,405,344,2289
09.06.2016 17:00,2638,30.7,426,379,2212
09.06.2016 18:00,2682,36.78,414,393,2268
09.06.2016 19:00,2667,31.44,373,406,2294
09.06.2016 20:00,2596,31.28,456,440,2140
09.06.2016 21:00,2582,30.52,582,476,2000
09.06.2016 22:00,2384,29.36,659,506,1725
09.06.2016 23:00,2106,26,723,546,1383
09.07.2016 00:00,1946,24.08,710,582,1236
09.07.2016 01:00,1817,20.29,706,601,1111
09.07.2016 02:00,1785,19.41,695,608,1090
09.07.2016 03:00,1812,18.66,655,616,1157
09.07.2016 04:00,1847,18.96,619,609,1228
09.07.2016 05:00,1922,20.02,551,594,1371
09.07.2016 06:00,2064,24.02,522,561,1542
09.07.2016 07:00,2361,27.87,498,528,1863
09.07.2016 08:00,2693,32.86,473,472,2220
09.07.2016 09:00,2839,37.22,414,433,2425
09.07.2016 10:00,2819,34.07,405,393,2414
09.07.2016 11:00,2832,29.95,390,369,2442
09.07.2016 12:00,2827,28.92,388,362,2439
09.07.2016 13:00,2758,28.1,391,362,2367
09.07.2016 14:00,2764,28.09,394,360,2370
09.07.2016 15:00,2797,27.92,328,355,2469
09.07.2016 16:00,2813,28.5,300,345,2513
09.07.2016 17:00,2765,28.93,278,323,2487
09.07.2016 18:00,2781,36.04,253,287,2528
09.07.2016 19:00,2700,39.72,210,249,2490
09.07.2016 20:00,2691,43.29,171,220,2520
09.07.2016 21:00,2709,40.9,157,199,2552
09.07.2016 22:00,2556,36.05,135,180,2421
09.07.2016 23:00,2281,28.85,148,165,2133
09.08.2016 00:00,2045,25.96,156,146,1889
09.08.2016 01:00,1927,24.97,130,153,1797
09.08.2016 02:00,1870,24.07,95,137,1775
09.08.2016 03:00,1826,23.5,84,121,1742
09.08.2016 04:00,1812,23.08,67,103,1745
09.08.2016 05:00,1826,23.1,50,85,1776
09.08.2016 06:00,1955,24.24,38,70,1917
09.08.2016 07:00,2290,31.91,26,52,2264
09.08.2016 08:00,2627,38.71,17,41,2610
09.08.2016 09:00,2717,39.62,13,33,2704
09.08.2016 10:00,2759,38.31,6,30,2753
09.08.2016 11:00,2840,33.73,6,33,2834
09.08.2016 12:00,2819,33.12,16,39,2803
09.08.2016 13:00,2765,32.48,55,51,2710
09.08.2016 14:00,2733,32.07,96,68,2637
09.08.2016 15:00,2698,31.77,114,84,2584
09.08.2016 16:00,2705,31.2,113,102,2592
09.08.2016 17:00,2632,30.24,132,123,2500
09.08.2016 18:00,2638,35.67,137,143,2501
09.08.2016 19:00,2645,40.41,122,171,2523
09.08.2016 20:00,2674,42.59,134,219,2540
09.08.2016 21:00,2661,40.31,229,259,2432
09.08.2016 22:00,2469,34.55,315,295,2154
09.08.2016 23:00,2221,28.65,338,318,1883
09.09.2016 00:00,2014,25.99,358,337,1656
09.09.2016 01:00,1845,25.08,382,343,1463
09.09.2016 02:00,1781,23.81,394,338,1387
09.09.2016 03:00,1746,23.49,384,323,1362
09.09.2016 04:00,1773,22.97,342,313,1431
09.09.2016 05:00,1829,23.26,281,285,1548
09.09.2016 06:00,1995,24.82,245,254,1750
09.09.2016 07:00,2309,32.09,222,227,2087
09.09.2016 08:00,2676,39.26,174,191,2502
09.09.2016 09:00,2802,41.94,105,147,2697
09.09.2016 10:00,2870,40.99,45,111,2825
09.09.2016 11:00,2971,36.88,34,103,2937
09.09.2016 12:00,2913,34.06,54,89,2859
09.09.2016 13:00,2836,31.8,63,94,2773
09.09.2016 14:00,2802,29.2,70,113,2732
09.09.2016 15:00,2710,28.54,82,135,2628
09.09.2016 16:00,2628,29.49,92,142,2536
09.09.2016 17:00,2586,30.29,89,145,2497
09.09.2016 18:00,2586,35.02,77,129,2509
09.09.2016 19:00,2533,38.81,72,119,2461
09.09.2016 20:00,2473,37.81,88,119,2385
09.09.2016 21:00,2524,36.09,72,103,2452
09.09.2016 22:00,2356,32.57,56,104,2300
09.09.2016 23:00,2186,29.49,66,100,2120
09.10.2016 00:00,1986,27.48,76,96,1910
09.10.2016 01:00,1850,28.58,77,90,1773
09.10.2016 02:00,1736,26.27,64,86,1672
09.10.2016 03:00,1696,25.41,71,79,1625
09.10.2016 04:00,1678,24.08,83,74,1595
09.10.2016 05:00,1656,23.75,71,69,1585
09.10.2016 06:00,1695,24.08,69,67,1626
09.10.2016 07:00,1754,24.89,61,60,1693
09.10.2016 08:00,1873,28.62,48,53,1825
09.10.2016 09:00,2047,29.04,40,44,2007
09.10.2016 10:00,2181,29.18,16,25,2165
09.10.2016 11:00,2242,27.18,14,32,2228
09.10.2016 12:00,2245,26.87,25,34,2220
09.10.2016 13:00,2205,26.21,40,40,2165
09.10.2016 14:00,2168,25.6,43,40,2125
09.10.2016 15:00,2093,25.15,48,46,2045
09.10.2016 16:00,2099,26.24,61,62,2038
09.10.2016 17:00,2111,28.65,66,57,2045
09.10.2016 18:00,2174,31.22,77,76,2097
09.10.2016 19:00,2200,32.14,76,89,2124
09.10.2016 20:00,2195,31.96,90,101,2105
09.10.2016 21:00,2240,31.86,126,120,2114
09.10.2016 22:00,2095,29.73,177,146,1918
09.10.2016 23:00,1938,28.78,229,174,1709
09.11.2016 00:00,1845,26.12,254,203,1591
09.11.2016 01:00,1729,23.84,285,268,1444
09.11.2016 02:00,1655,22.87,334,302,1321
09.11.2016 03:00,1572,22.51,397,336,1175
09.11.2016 04:00,1552,21.73,438,365,1114
09.11.2016 05:00,1512,21.1,497,389,1015
09.11.2016 06:00,1500,22.09,553,404,947
09.11.2016 07:00,1489,22.21,596,402,893
09.11.2016 08:00,1566,22.38,546,386,1020
09.11.2016 09:00,1798,23.77,437,340,1361
09.11.2016 10:00,2025,25.11,347,309,1678
09.11.2016 11:00,2085,24.96,379,303,1706
09.11.2016 12:00,2104,25.48,423,307,1681
09.11.2016 13:00,2122,25.16,428,325,1694
09.11.2016 14:00,2089,24.54,475,338,1614
09.11.2016 15:00,1995,23.48,505,315,1490
09.11.2016 16:00,2010,23.42,450,299,1560
09.11.2016 17:00,2064,24.01,383,283,1681
09.11.2016 18:00,2174,28.21,328,270,1846
09.11.2016 19:00,2322,28.93,263,260,2059
09.11.2016 20:00,2363,30.11,241,229,2122
09.11.2016 21:00,2378,30.48,257,195,2121
09.11.2016 22:00,2233,29.15,247,172,1986
09.11.2016 23:00,2111,27.34,204,155,1907
09.12.2016 00:00,1932,25.11,196,137,1736
09.12.2016 01:00,1820,23.48,176,133,1644
09.12.2016 02:00,1789,22.93,143,123,1646
09.12.2016 03:00,1824,22.51,99,110,1725
09.12.2016 04:00,1823,22.15,92,98,1731
09.12.2016 05:00,1837,22.75,109,91,1728
09.12.2016 06:00,1997,24.11,116,86,1881
09.12.2016 07:00,2341,28.65,106,82,2235
09.12.2016 08:00,2659,32.05,101,80,2558
09.12.2016 09:00,2791,41.23,69,74,2722
09.12.2016 10:00,2825,39.43,29,56,2796
09.12.2016 11:00,2848,33.5,24,42,2824
09.12.2016 12:00,2858,31.44,28,35,2830
09.12.2016 13:00,2786,31.24,23,37,2763
09.12.2016 14:00,2849,30.99,17,39,2832
09.12.2016 15:00,2830,31.24,24,42,2806
09.12.2016 16:00,2815,32.59,28,44,2787
09.12.2016 17:00,2713,34.94,29,43,2684
09.12.2016 18:00,2730,37.07,35,52,2695
09.12.2016 19:00,2631,35.72,49,66,2582
09.12.2016 20:00,2639,35.84,82,87,2557
09.12.2016 21:00,2662,35.06,112,107,2550
09.12.2016 22:00,2465,30.98,137,123,2328
09.12.2016 23:00,2231,28.82,162,131,2069
13.09.2016 00:00,2065,26.59,165,137,1900
13.09.2016 01:00,2003,25.08,168,181,1835
13.09.2016 02:00,1935,24.8,171,190,1764
13.09.2016 03:00,1902,24.01,180,196,1722
13.09.2016 04:00,1872,23.52,214,199,1658
13.09.2016 05:00,1877,23.55,226,205,1651
13.09.2016 06:00,2045,26.39,222,212,1823
13.09.2016 07:00,2402,30.44,219,222,2183
13.09.2016 08:00,2728,34.83,231,228,2497
13.09.2016 09:00,2828,42.76,207,203,2621
13.09.2016 10:00,2841,38.92,152,170,2689
13.09.2016 11:00,2918,35.91,120,154,2798
13.09.2016 12:00,2929,32.84,116,154,2813
13.09.2016 13:00,2916,32.17,104,154,2812
13.09.2016 14:00,2916,31.81,107,152,2809
13.09.2016 15:00,2874,31.71,106,145,2768
13.09.2016 16:00,2887,31.35,91,141,2796
13.09.2016 17:00,2797,31.87,83,130,2714
13.09.2016 18:00,2793,33.58,63,123,2730
13.09.2016 19:00,2703,33.52,72,135,2631
13.09.2016 20:00,2684,32.77,106,150,2578
13.09.2016 21:00,2700,32.71,139,171,2561
13.09.2016 22:00,2494,31.32,159,178,2335
13.09.2016 23:00,2257,27.4,158,192,2099
14.09.2016 00:00,2085,25.01,152,203,1933
14.09.2016 01:00,1964,24.04,149,197,1815
14.09.2016 02:00,1869,23.59,164,193,1705
14.09.2016 03:00,1842,23.31,151,186,1691
14.09.2016 04:00,1858,23.31,128,180,1730
14.09.2016 05:00,1885,24.08,116,178,1769
14.09.2016 06:00,2042,26.19,108,168,1934
14.09.2016 07:00,2369,30.33,103,154,2266
14.09.2016 08:00,2711,35.52,98,142,2613
14.09.2016 09:00,2857,39.9,80,117,2777
14.09.2016 10:00,2897,34.95,47,89,2850
14.09.2016 11:00,2938,32.93,38,66,2900
14.09.2016 12:00,2949,33.61,27,56,2922
14.09.2016 13:00,2901,32.86,29,62,2872
14.09.2016 14:00,2869,32.58,30,62,2839
14.09.2016 15:00,2847,32.54,32,60,2815
14.09.2016 16:00,2816,31.8,34,58,2782
14.09.2016 17:00,2730,31.49,34,55,2696
14.09.2016 18:00,2725,32.75,31,59,2694
14.09.2016 19:00,2638,35.61,33,60,2605
14.09.2016 20:00,2671,37.44,40,62,2631
14.09.2016 21:00,2655,32.13,48,64,2607
14.09.2016 22:00,2447,31.25,55,68,2392
14.09.2016 23:00,2237,29.28,52,70,2185
15.09.2016 00:00,2069,25.05,44,71,2025
15.09.2016 01:00,1936,22.93,40,59,1896
15.09.2016 02:00,1869,21.88,32,54,1837
15.09.2016 03:00,1852,21.42,31,49,1821
15.09.2016 04:00,1835,21.4,38,45,1797
15.09.2016 05:00,1853,22.74,32,44,1821
15.09.2016 06:00,1988,24.08,32,41,1956
15.09.2016 07:00,2310,29.58,31,38,2279
15.09.2016 08:00,2681,34.51,28,32,2653
15.09.2016 09:00,2802,37.01,20,28,2782
15.09.2016 10:00,2845,33.71,5,26,2840
15.09.2016 11:00,2874,31.91,2,23,2872
15.09.2016 12:00,2923,32.98,5,22,2918
15.09.2016 13:00,2886,32.84,16,26,2870
15.09.2016 14:00,2891,32.49,28,32,2863
15.09.2016 15:00,2846,32.73,47,39,2799
15.09.2016 16:00,2853,31.94,51,44,2802
15.09.2016 17:00,2751,31.48,60,51,2691
15.09.2016 18:00,2723,32.15,57,61,2666
15.09.2016 19:00,2657,34.03,64,70,2593
15.09.2016 20:00,2686,34.8,86,79,2600
15.09.2016 21:00,2674,34.89,114,87,2560
15.09.2016 22:00,2474,31.52,149,95,2325
15.09.2016 23:00,2281,26.42,120,110,2161
16.09.2016 00:00,2115,24.79,86,120,2029
16.09.2016 01:00,1994,22.6,70,135,1924
16.09.2016 02:00,1951,21.64,71,133,1880
16.09.2016 03:00,1929,21.22,88,141,1841
16.09.2016 04:00,1906,21.29,102,148,1804
16.09.2016 05:00,1902,22.55,150,178,1752
16.09.2016 06:00,1996,25.1,214,222,1782
16.09.2016 07:00,2300,28.97,282,272,2018
16.09.2016 08:00,2636,31.68,318,307,2318
16.09.2016 09:00,2799,32.09,300,326,2499
16.09.2016 10:00,2759,31.85,328,338,2431
16.09.2016 11:00,2786,31.88,407,364,2379
16.09.2016 12:00,2787,31.64,446,398,2341
16.09.2016 13:00,2740,31.07,473,422,2267
16.09.2016 14:00,2654,29.9,481,427,2173
16.09.2016 15:00,2624,28.95,457,435,2167
16.09.2016 16:00,2557,28.96,458,451,2099
16.09.2016 17:00,2451,28.88,499,469,1952
16.09.2016 18:00,2448,28.94,530,474,1918
16.09.2016 19:00,2419,28.88,535,493,1884
16.09.2016 20:00,2495,28.95,484,519,2011
16.09.2016 21:00,2425,28.54,536,531,1889
16.09.2016 22:00,2258,26.81,537,545,1721
16.09.2016 23:00,2140,25.46,498,543,1642
17.09.2016 00:00,2037,24.67,456,540,1581
17.09.2016 01:00,1868,25.02,467,499,1401
17.09.2016 02:00,1761,24.02,465,468,1296
17.09.2016 03:00,1709,23.77,456,448,1253
17.09.2016 04:00,1655,22.81,511,444,1144
17.09.2016 05:00,1655,22.25,497,435,1158
17.09.2016 06:00,1701,22.91,477,425,1224
17.09.2016 07:00,1763,24.91,466,423,1297
17.09.2016 08:00,1863,26.01,459,417,1404
17.09.2016 09:00,2102,27.44,409,415,1693
17.09.2016 10:00,2239,28.98,407,425,1832
17.09.2016 11:00,2251,29.59,463,434,1788
17.09.2016 12:00,2233,29.64,498,433,1735
17.09.2016 13:00,2217,28.7,475,414,1742
17.09.2016 14:00,2181,26.93,442,404,1739
17.09.2016 15:00,2103,25.85,435,383,1668
17.09.2016 16:00,2101,25.83,415,370,1686
17.09.2016 17:00,2111,25.94,394,356,1717
17.09.2016 18:00,2150,27.85,378,347,1772
17.09.2016 19:00,2219,28.08,307,339,1912
17.09.2016 20:00,2294,30.22,267,327,2027
17.09.2016 21:00,2294,29.69,273,315,2021
17.09.2016 22:00,2171,26.87,293,309,1878
17.09.2016 23:00,1991,24.94,312,304,1679
18.09.2016 00:00,1849,23.65,337,307,1512
18.09.2016 01:00,1804,23.53,317,316,1487
18.09.2016 02:00,1732,22.53,333,310,1399
18.09.2016 03:00,1705,22.49,338,317,1367
18.09.2016 04:00,1674,22.49,359,325,1315
18.09.2016 05:00,1672,22.81,375,332,1297
18.09.2016 06:00,1691,22.98,402,346,1289
18.09.2016 07:00,1715,23.54,411,355,1304
18.09.2016 08:00,1815,24.63,386,356,1429
18.09.2016 09:00,1995,24.86,335,350,1660
18.09.2016 10:00,2159,25.83,268,329,1891
18.09.2016 11:00,2265,27.66,260,319,2005
18.09.2016 12:00,2266,27.91,307,322,1959
18.09.2016 13:00,2261,27.71,311,308,1950
18.09.2016 14:00,2231,26.99,323,308,1908
18.09.2016 15:00,2180,26.89,318,282,1862
18.09.2016 16:00,2213,26.64,280,265,1933
18.09.2016 17:00,2285,27.18,207,253,2078
18.09.2016 18:00,2362,27.85,158,230,2204
18.09.2016 19:00,2398,31.86,117,191,2281
18.09.2016 20:00,2520,35.24,123,182,2397
18.09.2016 21:00,2516,34.1,123,163,2393
18.09.2016 22:00,2382,31.1,112,159,2270
18.09.2016 23:00,2199,27.94,106,150,2093
19.09.2016 00:00,2034,25.46,104,144,1930
19.09.2016 01:00,1910,24.56,102,122,1808
19.09.2016 02:00,1876,24.15,84,117,1792
19.09.2016 03:00,1868,23.78,83,114,1785
19.09.2016 04:00,1874,23,97,127,1777
19.09.2016 05:00,1896,23.69,114,130,1782
19.09.2016 06:00,2043,26.2,123,122,1920
19.09.2016 07:00,2448,33.77,126,121,2322
19.09.2016 08:00,2779,42.31,124,115,2655
19.09.2016 09:00,2924,44.6,93,104,2831
19.09.2016 10:00,2940,43.91,51,89,2889
19.09.2016 11:00,2972,43.95,31,76,2941
19.09.2016 12:00,2947,43.97,25,68,2922
19.09.2016 13:00,2926,41.27,16,55,2910
19.09.2016 14:00,2882,39.31,14,48,2868
19.09.2016 15:00,2856,37.68,16,43,2840
19.09.2016 16:00,2804,37.93,29,42,2775
19.09.2016 17:00,2692,37.78,44,43,2648
19.09.2016 18:00,2691,39.22,41,44,2650
19.09.2016 19:00,2655,39.9,47,52,2608
19.09.2016 20:00,2707,41.99,88,58,2619
19.09.2016 21:00,2636,39.14,142,61,2494
19.09.2016 22:00,2417,30,197,70,2220
19.09.2016 23:00,2199,28.01,222,78,1977
20.09.2016 00:00,2008,26.02,228,90,1780
20.09.2016 01:00,1893,25.01,222,116,1671
20.09.2016 02:00,1886,24.83,173,126,1713
20.09.2016 03:00,1895,23.51,153,133,1742
20.09.2016 04:00,1869,23.54,156,133,1713
20.09.2016 05:00,1872,24.02,172,131,1700
20.09.2016 06:00,2056,25.86,153,130,1903
20.09.2016 07:00,2433,32.73,134,124,2299
20.09.2016 08:00,2686,42,175,118,2511
20.09.2016 09:00,2730,43.88,180,100,2550
20.09.2016 10:00,2775,43.25,146,102,2629
20.09.2016 11:00,2837,43.22,122,96,2715
20.09.2016 12:00,2819,42.19,149,111,2670
20.09.2016 13:00,2749,38.21,162,133,2587
20.09.2016 14:00,2768,36.47,168,145,2600
20.09.2016 15:00,2731,34.22,180,156,2551
20.09.2016 16:00,2658,34.55,227,164,2431
20.09.2016 17:00,2602,36.08,243,171,2359
20.09.2016 18:00,2600,38.19,244,174,2356
20.09.2016 19:00,2587,41.06,205,173,2382
20.09.2016 20:00,2678,46.47,203,171,2475
20.09.2016 21:00,2594,40.95,207,172,2387
20.09.2016 22:00,2383,34.22,260,177,2123
20.09.2016 23:00,2198,28.54,257,187,1941
21.09.2016 00:00,2036,26.03,210,177,1826
21.09.2016 01:00,1891,25.43,196,179,1695
21.09.2016 02:00,1887,24.94,145,159,1742
21.09.2016 03:00,1900,24.12,122,145,1778
21.09.2016 04:00,1896,24.25,141,141,1755
21.09.2016 05:00,1907,24.69,159,140,1748
21.09.2016 06:00,2026,26.34,175,139,1851
21.09.2016 07:00,2388,31.91,187,143,2201
21.09.2016 08:00,2639,34.73,211,144,2428
21.09.2016 09:00,2733,43.22,184,127,2549
21.09.2016 10:00,2765,43.23,115,118,2650
21.09.2016 11:00,2809,39.98,75,109,2734
21.09.2016 12:00,2811,36.03,62,98,2749
21.09.2016 13:00,2750,32.94,54,89,2696
21.09.2016 14:00,2740,32.7,55,85,2685
21.09.2016 15:00,2676,31.94,54,71,2622
21.09.2016 16:00,2657,32.81,56,68,2601
21.09.2016 17:00,2598,34.87,43,65,2555
21.09.2016 18:00,2600,34.36,35,62,2565
21.09.2016 19:00,2587,34.13,33,63,2554
21.09.2016 20:00,2690,37.14,40,68,2650
21.09.2016 21:00,2661,33.9,43,70,2618
21.09.2016 22:00,2489,31.75,46,71,2443
21.09.2016 23:00,2306,28.49,31,72,2275
22.09.2016 00:00,2126,26.12,22,67,2104
22.09.2016 01:00,2019,25.86,19,52,2000
22.09.2016 02:00,1971,25.09,17,48,1954
22.09.2016 03:00,1939,24.73,24,47,1915
22.09.2016 04:00,1937,24.32,29,47,1908
22.09.2016 05:00,2002,24.84,30,49,1972
22.09.2016 06:00,2182,27.36,26,49,2156
22.09.2016 07:00,2568,38.19,21,49,2547
22.09.2016 08:00,2843,43.35,19,49,2824
22.09.2016 09:00,2916,45.01,16,43,2900
22.09.2016 10:00,2874,36.65,10,37,2864
22.09.2016 11:00,2903,35.77,4,32,2899
22.09.2016 12:00,2890,35.39,3,30,2887
22.09.2016 13:00,2824,34.99,7,26,2817
22.09.2016 14:00,2790,33.83,13,27,2777
22.09.2016 15:00,2750,32.68,12,27,2738
22.09.2016 16:00,2725,32.99,11,27,2714
22.09.2016 17:00,2653,32.75,17,29,2636
22.09.2016 18:00,2634,40.91,23,29,2611
22.09.2016 19:00,2615,43.16,28,28,2587
22.09.2016 20:00,2720,50.27,31,30,2689
22.09.2016 21:00,2655,46.95,31,31,2624
22.09.2016 22:00,2514,38.95,24,31,2490
22.09.2016 23:00,2307,26.86,18,30,2289
23.09.2016 00:00,2115,25.89,13,32,2102
23.09.2016 01:00,1988,25.84,15,38,1973
23.09.2016 02:00,1915,25.09,18,42,1897
23.09.2016 03:00,1908,24.68,16,42,1892
23.09.2016 04:00,1902,24.78,20,42,1882
23.09.2016 05:00,1945,25.35,24,43,1921
23.09.2016 06:00,2091,27.4,33,44,2058
23.09.2016 07:00,2465,36.06,31,49,2434
23.09.2016 08:00,2787,43.23,41,50,2746
23.09.2016 09:00,2891,44.07,41,49,2850
23.09.2016 10:00,2857,39.9,42,47,2815
23.09.2016 11:00,2894,34.66,33,51,2861
23.09.2016 12:00,2827,33.18,42,65,2785
23.09.2016 13:00,2763,32.69,77,102,2686
23.09.2016 14:00,2663,31.85,139,128,2524
23.09.2016 15:00,2554,31,185,148,2369
23.09.2016 16:00,2470,30.89,258,188,2212
23.09.2016 17:00,2236,30.74,441,218,1795
23.09.2016 18:00,2256,31.54,478,246,1778
23.09.2016 19:00,2355,31.1,407,285,1948
23.09.2016 20:00,2446,32.17,405,322,2041
23.09.2016 21:00,2358,29.96,458,361,1900
23.09.2016 22:00,2209,27.83,494,419,1715
23.09.2016 23:00,2035,26.01,558,469,1477
24.09.2016 00:00,1855,25.21,625,498,1230
24.09.2016 01:00,1848,25.65,642,596,1206
24.09.2016 02:00,1772,24.68,656,600,1116
24.09.2016 03:00,1736,24.39,639,589,1097
24.09.2016 04:00,1724,25.07,626,563,1098
24.09.2016 05:00,1753,24.65,585,529,1168
24.09.2016 06:00,1819,24.59,527,487,1292
24.09.2016 07:00,1890,25.64,495,437,1395
24.09.2016 08:00,1969,26.69,445,379,1524
24.09.2016 09:00,2235,28.95,294,333,1941
24.09.2016 10:00,2377,31.95,179,287,2198
24.09.2016 11:00,2310,30.96,218,240,2092
24.09.2016 12:00,2211,30.97,238,218,1973
24.09.2016 13:00,2191,29.72,217,193,1974
24.09.2016 14:00,2143,29.42,214,180,1929
24.09.2016 15:00,2060,27.36,230,165,1830
24.09.2016 16:00,2067,27.53,187,145,1880
24.09.2016 17:00,2121,28.7,136,123,1985
24.09.2016 18:00,2210,30.93,69,103,2141
24.09.2016 19:00,2273,31.51,47,89,2226
24.09.2016 20:00,2359,32.31,70,89,2289
24.09.2016 21:00,2285,30.96,82,93,2203
24.09.2016 22:00,2159,28.35,126,104,2033
24.09.2016 23:00,2035,26.54,143,107,1892
25.09.2016 00:00,1875,25.46,164,108,1711
25.09.2016 01:00,1821,25.03,195,156,1626
25.09.2016 02:00,1786,23.51,170,153,1616
25.09.2016 03:00,1748,22.73,160,149,1588
25.09.2016 04:00,1752,22.07,177,149,1575
25.09.2016 05:00,1764,22.74,175,151,1589
25.09.2016 06:00,1825,22.93,164,155,1661
25.09.2016 07:00,1862,22.92,186,164,1676
25.09.2016 08:00,1859,23.78,241,174,1618
25.09.2016 09:00,1952,25.05,254,169,1698
25.09.2016 10:00,2075,26.25,200,158,1875
25.09.2016 11:00,2175,26.73,166,155,2009
25.09.2016 12:00,2166,27,213,168,1953
25.09.2016 13:00,2156,26.26,238,188,1918
25.09.2016 14:00,2160,25.99,226,206,1934
25.09.2016 15:00,2131,25.51,221,212,1910
25.09.2016 16:00,2110,25.5,230,215,1880
25.09.2016 17:00,2118,25.75,254,221,1864
25.09.2016 18:00,2178,27.12,276,248,1902
25.09.2016 19:00,2259,30.16,313,288,1946
25.09.2016 20:00,2346,30.83,411,328,1935
25.09.2016 21:00,2249,29.67,501,357,1748
25.09.2016 22:00,2052,26.92,576,375,1476
25.09.2016 23:00,1869,25.44,605,388,1264
26.09.2016 00:00,1785,24.52,578,394,1207
26.09.2016 01:00,1773,23.71,537,413,1236
26.09.2016 02:00,1726,23.55,511,397,1215
26.09.2016 03:00,1680,23.42,504,374,1176
26.09.2016 04:00,1727,23.28,463,357,1264
26.09.2016 05:00,1758,23.49,471,345,1287
26.09.2016 06:00,1909,25.46,459,326,1450
26.09.2016 07:00,2334,31.08,433,314,1901
26.09.2016 08:00,2644,36.89,408,296,2236
26.09.2016 09:00,2787,44.56,330,254,2457
26.09.2016 10:00,2852,47.95,220,222,2632
26.09.2016 11:00,2878,40.96,195,199,2683
26.09.2016 12:00,2877,38.31,199,188,2678
26.09.2016 13:00,2850,35.8,181,181,2669
26.09.2016 14:00,2869,34.79,169,191,2700
26.09.2016 15:00,2816,33.24,169,185,2647
26.09.2016 16:00,2789,35.86,171,166,2618
26.09.2016 17:00,2707,38.92,147,151,2560
26.09.2016 18:00,2731,43.06,122,140,2609
26.09.2016 19:00,2704,43.67,126,135,2578
26.09.2016 20:00,2802,55.45,156,140,2646
26.09.2016 21:00,2688,43.08,190,146,2498
26.09.2016 22:00,2441,30.27,223,153,2218
26.09.2016 23:00,2237,28.78,243,161,1994
27.09.2016 00:00,2039,27.05,232,152,1807
27.09.2016 01:00,1946,26.46,181,143,1765
27.09.2016 02:00,1923,26,157,134,1766
27.09.2016 03:00,1920,26.02,144,115,1776
27.09.2016 04:00,1927,26.01,111,97,1816
27.09.2016 05:00,1982,26.94,76,80,1906
27.09.2016 06:00,2134,28.83,67,67,2067
27.09.2016 07:00,2532,33.49,81,57,2451
27.09.2016 08:00,2815,42.6,76,53,2739
27.09.2016 09:00,2870,43.28,64,47,2806
27.09.2016 10:00,2884,43.28,48,47,2836
27.09.2016 11:00,2892,41.2,30,45,2862
27.09.2016 12:00,2852,34.76,54,55,2798
27.09.2016 13:00,2822,29.89,94,78,2728
27.09.2016 14:00,2751,29.6,135,99,2616
27.09.2016 15:00,2711,29.24,177,123,2534
27.09.2016 16:00,2652,28.99,238,150,2414
27.09.2016 17:00,2579,29.42,271,177,2308
27.09.2016 18:00,2642,37.97,260,215,2382
27.09.2016 19:00,2642,29.96,314,264,2328
27.09.2016 20:00,2710,30.91,446,335,2264
27.09.2016 21:00,2610,28.9,526,397,2084
27.09.2016 22:00,2425,26.38,599,471,1826
27.09.2016 23:00,2247,24.96,641,550,1606
28.09.2016 00:00,2041,23.32,732,640,1309
28.09.2016 01:00,1920,20.29,841,744,1079
28.09.2016 02:00,1885,18.8,905,839,980
28.09.2016 03:00,1933,16.19,942,945,991
28.09.2016 04:00,1951,14.66,989,1023,962
28.09.2016 05:00,2016,14.91,1001,1094,1015
28.09.2016 06:00,2103,19.88,1082,1130,1021
28.09.2016 07:00,2417,24.9,1151,1145,1266
28.09.2016 08:00,2731,25.98,1140,1120,1591
28.09.2016 09:00,2849,27.11,1123,1123,1726
28.09.2016 10:00,2959,26.88,1052,1146,1907
28.09.2016 11:00,2982,26,1053,1169,1929
28.09.2016 12:00,2945,25.69,1125,1191,1820
28.09.2016 13:00,2827,25.98,1145,1162,1682
28.09.2016 14:00,2816,25.92,1150,1147,1666
28.09.2016 15:00,2801,25.85,1116,1131,1685
28.09.2016 16:00,2808,25.7,1111,1152,1697
28.09.2016 17:00,2686,25.57,1133,1141,1553
28.09.2016 18:00,2827,26.45,1080,1147,1747
28.09.2016 19:00,2848,26.06,1079,1150,1769
28.09.2016 20:00,2924,26.97,1069,1141,1855
28.09.2016 21:00,2794,26.02,1073,1129,1721
28.09.2016 22:00,2618,25.64,1042,1103,1576
28.09.2016 23:00,2358,24.17,1018,1070,1340
29.09.2016 00:00,2225,22.02,905,1003,1320
29.09.2016 01:00,2104,19.93,783,890,1321
29.09.2016 02:00,2060,16.1,665,803,1395
29.09.2016 03:00,2015,18.63,577,698,1438
29.09.2016 04:00,2038,14.57,511,642,1527
29.09.2016 05:00,2021,14.83,536,637,1485
29.09.2016 06:00,2055,24.01,693,698,1362
29.09.2016 07:00,2428,26,821,815,1607
29.09.2016 08:00,2768,27.88,994,964,1774
29.09.2016 09:00,2824,29.04,1131,1082,1693
29.09.2016 10:00,2888,27.64,1210,1185,1678
29.09.2016 11:00,2977,25.97,1221,1242,1756
29.09.2016 12:00,2974,25.95,1238,1294,1736
29.09.2016 13:00,2946,25.91,1268,1348,1678
29.09.2016 14:00,2966,25.74,1287,1357,1679
29.09.2016 15:00,2876,25.61,1319,1366,1557
29.09.2016 16:00,2849,25.22,1321,1382,1528
29.09.2016 17:00,2837,25.03,1320,1393,1517
29.09.2016 18:00,2902,25.35,1285,1403,1617
29.09.2016 19:00,2949,25.85,1216,1375,1733
29.09.2016 20:00,2932,26.56,1249,1354,1683
29.09.2016 21:00,2806,26.3,1255,1349,1551
29.09.2016 22:00,2586,25.03,1252,1325,1334
29.09.2016 23:00,2334,22.69,1275,1339,1059
30.09.2016 00:00,2087,16.85,1299,1356,788
30.09.2016 01:00,1966,16.49,1288,1337,678
30.09.2016 02:00,1906,16.08,1299,1342,607
30.09.2016 03:00,1883,14.93,1280,1323,603
30.09.2016 04:00,1901,14.46,1267,1314,634
30.09.2016 05:00,1858,19.61,1296,1269,562
30.09.2016 06:00,2005,22.54,1265,1239,740
30.09.2016 07:00,2477,25.23,1153,1176,1324
30.09.2016 08:00,2843,26.8,1056,1110,1787
30.09.2016 09:00,2964,27.95,978,1050,1986
30.09.2016 10:00,2923,27.96,939,979,1984
30.09.2016 11:00,2904,28.3,957,945,1947
30.09.2016 12:00,2709,27.86,1033,949,1676
30.09.2016 13:00,2577,27.67,1046,937,1531
30.09.2016 14:00,2603,27.32,969,940,1634
30.09.2016 15:00,2587,26.96,970,953,1617
30.09.2016 16:00,2497,26.96,997,937,1500
30.09.2016 17:00,2578,26.91,906,935,1672
30.09.2016 18:00,2549,26.96,938,897,1611
30.09.2016 19:00,2661,27.4,834,898,1827
30.09.2016 20:00,2704,28.4,821,887,1883
30.09.2016 21:00,2513,27.49,874,893,1639
30.09.2016 22:00,2304,26.2,917,882,1387
30.09.2016 23:00,2183,25.03,927,883,1256
10.01.2016 00:00,2003,24.58,957,882,1046
10.01.2016 01:00,1925,23.14,946,890,979
10.01.2016 02:00,1854,22.93,924,841,930
10.01.2016 03:00,1817,22.87,859,796,958
10.01.2016 04:00,1810,23.01,820,750,990
10.01.2016 05:00,1897,23.18,675,672,1222
10.01.2016 06:00,1896,23.65,634,611,1262
10.01.2016 07:00,1959,24.74,577,523,1382
10.01.2016 08:00,2038,26.48,511,461,1527
10.01.2016 09:00,2270,27.42,369,392,1901
10.01.2016 10:00,2394,28.55,276,339,2118
10.01.2016 11:00,2400,28.96,268,297,2132
10.01.2016 12:00,2353,28.79,279,259,2074
10.01.2016 13:00,2354,28.36,210,233,2144
10.01.2016 14:00,2302,28.14,188,200,2114
10.01.2016 15:00,2273,28.04,154,168,2119
10.01.2016 16:00,2269,28.09,122,139,2147
10.01.2016 17:00,2271,28.52,127,113,2144
10.01.2016 18:00,2327,33.8,98,96,2229
10.01.2016 19:00,2396,38.97,83,88,2313
10.01.2016 20:00,2473,43.95,86,87,2387
10.01.2016 21:00,2350,39.09,103,86,2247
10.01.2016 22:00,2208,30,106,85,2102
10.01.2016 23:00,2113,28.15,86,89,2027
10.02.2016 00:00,2026,27.49,54,90,1972
10.02.2016 01:00,1923,27.05,29,90,1894
10.02.2016 02:00,1859,25.71,28,88,1831
10.02.2016 03:00,1840,25.38,41,93,1799
10.02.2016 04:00,1835,24.86,37,100,1798
10.02.2016 05:00,1864,24.9,58,124,1806
10.02.2016 06:00,1866,25.03,83,145,1783
10.02.2016 07:00,1941,25.43,130,170,1811
10.02.2016 08:00,1959,26.09,176,185,1783
10.02.2016 09:00,2089,28.08,203,184,1886
10.02.2016 10:00,2212,30.8,195,186,2017
10.02.2016 11:00,2271,29.88,202,189,2069
10.02.2016 12:00,2314,32.38,218,192,2096
10.02.2016 13:00,2330,29.11,222,201,2108
10.02.2016 14:00,2319,27.76,231,215,2088
10.02.2016 15:00,2278,27.33,247,227,2031
10.02.2016 16:00,2288,27.14,250,233,2038
10.02.2016 17:00,2328,27.36,268,256,2060
10.02.2016 18:00,2435,29.28,259,257,2176
10.02.2016 19:00,2516,29.96,338,290,2178
10.02.2016 20:00,2513,30.9,408,302,2105
10.02.2016 21:00,2424,30.16,450,354,1974
10.02.2016 22:00,2273,29,482,386,1791
10.02.2016 23:00,2095,28.68,499,412,1596
10.03.2016 00:00,1953,25.81,506,434,1447
10.03.2016 01:00,1861,25.85,540,467,1321
10.03.2016 02:00,1767,25.49,619,515,1148
10.03.2016 03:00,1754,25.09,686,569,1068
10.03.2016 04:00,1735,24.54,742,618,993
10.03.2016 05:00,1759,24.67,807,676,952
10.03.2016 06:00,1942,26.41,861,709,1081
10.03.2016 07:00,2323,29.79,931,740,1392
10.03.2016 08:00,2705,31.85,922,769,1783
10.03.2016 09:00,2846,33.32,902,796,1944
10.03.2016 10:00,2934,33.59,897,847,2037
10.03.2016 11:00,3002,32.37,890,866,2112
10.03.2016 12:00,3034,32.3,874,897,2160
10.03.2016 13:00,2977,31.02,861,893,2116
10.03.2016 14:00,2953,30.93,853,878,2100
10.03.2016 15:00,2933,30.58,797,840,2136
10.03.2016 16:00,2930,30.36,749,808,2181
10.03.2016 17:00,2810,31.04,740,762,2070
10.03.2016 18:00,2853,31.85,672,723,2181
10.03.2016 19:00,2954,32.7,607,720,2347
10.03.2016 20:00,3022,34.4,613,705,2409
10.03.2016 21:00,2816,32.2,685,701,2131
10.03.2016 22:00,2544,28.88,720,692,1824
10.03.2016 23:00,2279,27.92,758,703,1521
10.04.2016 00:00,2067,25.36,776,696,1291
10.04.2016 01:00,1942,25.62,797,696,1145
10.04.2016 02:00,1881,25.28,799,683,1082
10.04.2016 03:00,1885,24.05,790,676,1095
10.04.2016 04:00,1848,23.44,795,663,1053
10.04.2016 05:00,1896,24.01,789,658,1107
10.04.2016 06:00,2133,26.71,746,663,1387
10.04.2016 07:00,2554,30.25,742,662,1812
10.04.2016 08:00,2956,35.05,748,655,2208
10.04.2016 09:00,2941,35.93,667,620,2274
10.04.2016 10:00,3074,35.9,514,612,2560
10.04.2016 11:00,3075,32.68,524,639,2551
10.04.2016 12:00,2952,31.63,627,654,2325
10.04.2016 13:00,2838,32.06,706,699,2132
10.04.2016 14:00,2886,32.08,735,739,2151
10.04.2016 15:00,2853,31.99,763,768,2090
10.04.2016 16:00,2892,31.87,777,765,2115
10.04.2016 17:00,2788,30.78,728,770,2060
10.04.2016 18:00,2865,34.84,697,756,2168
10.04.2016 19:00,2969,33.46,646,740,2323
10.04.2016 20:00,3051,34.73,688,748,2363
10.04.2016 21:00,2847,31.73,770,756,2077
10.04.2016 22:00,2679,29.68,766,761,1913
10.04.2016 23:00,2482,28.38,768,789,1714
10.05.2016 00:00,2223,25.77,793,758,1430
10.05.2016 01:00,2163,25.27,790,783,1373
10.05.2016 02:00,2077,24.25,824,785,1253
10.05.2016 03:00,2071,23.2,804,797,1267
10.05.2016 04:00,2089,22.97,836,828,1253
10.05.2016 05:00,2110,24.71,907,874,1203
10.05.2016 06:00,2308,26.35,930,899,1378
10.05.2016 07:00,2744,31.17,926,916,1818
10.05.2016 08:00,3088,35.03,937,958,2151
10.05.2016 09:00,3201,36.4,901,960,2300
10.05.2016 10:00,3182,34.82,865,984,2317
10.05.2016 11:00,3185,34.9,910,1016,2275
10.05.2016 12:00,3109,34.94,965,1029,2144
10.05.2016 13:00,2933,33.18,1046,1024,1887
10.05.2016 14:00,2930,32.98,1032,1031,1898
10.05.2016 15:00,2894,32.6,1018,1045,1876
10.05.2016 16:00,2870,32.5,1031,1066,1839
10.05.2016 17:00,2849,32.07,999,1071,1850
10.05.2016 18:00,2953,33.39,944,1075,2009
10.05.2016 19:00,3066,34.25,955,1094,2111
10.05.2016 20:00,3178,35.07,989,1125,2189
10.05.2016 21:00,3021,33.37,1048,1157,1973
10.05.2016 22:00,2809,29.83,1079,1168,1730
10.05.2016 23:00,2594,27.91,1088,1188,1506
10.06.2016 00:00,2399,25.75,1070,1187,1329
10.06.2016 01:00,2387,25.94,1018,1197,1369
10.06.2016 02:00,2333,25.27,1047,1190,1286
10.06.2016 03:00,2256,25.14,1102,1186,1154
10.06.2016 04:00,2229,25.16,1141,1194,1088
10.06.2016 05:00,2248,26.02,1151,1203,1097
10.06.2016 06:00,2401,29.55,1171,1210,1230
10.06.2016 07:00,2811,32.15,1157,1217,1654
10.06.2016 08:00,3158,34.01,1142,1233,2016
10.06.2016 09:00,3225,35.75,1138,1224,2087
10.06.2016 10:00,3247,36.19,1135,1229,2112
10.06.2016 11:00,3277,36.45,1124,1210,2153
10.06.2016 12:00,3224,36.77,1165,1202,2059
10.06.2016 13:00,3194,36.97,1167,1223,2027
10.06.2016 14:00,3213,36.44,1146,1241,2067
10.06.2016 15:00,3169,34.87,1144,1241,2025
10.06.2016 16:00,3114,34.06,1120,1218,1994
10.06.2016 17:00,3065,33.42,1064,1206,2001
10.06.2016 18:00,3132,34.7,1006,1182,2126
10.06.2016 19:00,3211,36.04,985,1166,2226
10.06.2016 20:00,3193,37.05,1023,1168,2170
10.06.2016 21:00,3068,33.29,1054,1164,2014
10.06.2016 22:00,2834,32.26,1094,1154,1740
10.06.2016 23:00,2626,30.68,1081,1144,1545
10.07.2016 00:00,2416,27.75,1078,1120,1338
10.07.2016 01:00,2291,27.76,1033,1078,1258
10.07.2016 02:00,2196,26.9,1012,1039,1184
10.07.2016 03:00,2211,26.98,935,997,1276
10.07.2016 04:00,2258,27.12,832,955,1426
10.07.2016 05:00,2282,28.22,816,926,1466
10.07.2016 06:00,2444,31.24,790,918,1654
10.07.2016 07:00,2882,36.28,729,898,2153
10.07.2016 08:00,3161,37.72,768,892,2393
10.07.2016 09:00,3247,38.86,735,869,2512
10.07.2016 10:00,3349,37.93,685,877,2664
10.07.2016 11:00,3376,37.43,694,888,2682
10.07.2016 12:00,3293,36.9,732,879,2561
10.07.2016 13:00,3163,34.74,725,859,2438
10.07.2016 14:00,3004,33.71,703,846,2301
10.07.2016 15:00,2759,32.97,726,837,2033
10.07.2016 16:00,2808,32.55,752,828,2056
10.07.2016 17:00,2757,31.95,733,812,2024
10.07.2016 18:00,2889,35.34,672,812,2217
10.07.2016 19:00,2932,36.08,720,804,2212
10.07.2016 20:00,2894,37.12,744,791,2150
10.07.2016 21:00,2754,32.3,782,812,1972
10.07.2016 22:00,2584,30.53,826,842,1758
10.07.2016 23:00,2395,29.86,865,866,1530
10.08.2016 00:00,2313,28.05,827,875,1486
10.08.2016 01:00,2215,28.13,789,896,1426
10.08.2016 02:00,2177,27.95,746,894,1431
10.08.2016 03:00,2157,27.8,760,898,1397
10.08.2016 04:00,2168,27.77,771,909,1397
10.08.2016 05:00,2204,27.81,750,917,1454
10.08.2016 06:00,2228,28.21,804,933,1424
10.08.2016 07:00,2382,30.16,799,951,1583
10.08.2016 08:00,2506,31.44,794,970,1712
10.08.2016 09:00,2774,33.47,707,990,2067
10.08.2016 10:00,2885,35.09,725,1002,2160
10.08.2016 11:00,2802,34.9,811,991,1991
10.08.2016 12:00,2728,34.66,852,968,1876
10.08.2016 13:00,2711,33.26,857,970,1854
10.08.2016 14:00,2673,32.48,863,968,1810
10.08.2016 15:00,2662,32.69,850,960,1812
10.08.2016 16:00,2668,32.44,854,953,1814
10.08.2016 17:00,2695,33.1,843,935,1852
10.08.2016 18:00,2846,34.44,785,933,2061
10.08.2016 19:00,2955,37.51,765,930,2190
10.08.2016 20:00,2913,37.25,763,919,2150
10.08.2016 21:00,2773,33.73,758,901,2015
10.08.2016 22:00,2631,32.31,740,876,1891
10.08.2016 23:00,2508,31.66,718,856,1790
10.09.2016 00:00,2418,30.58,658,835,1760
10.09.2016 01:00,2306,28.71,654,659,1652
10.09.2016 02:00,2179,28.45,710,636,1469
10.09.2016 03:00,2148,28.32,703,647,1445
10.09.2016 04:00,2195,28.1,684,660,1511
10.09.2016 05:00,2167,28.03,730,675,1437
10.09.2016 06:00,2129,28.06,802,674,1327
10.09.2016 07:00,2271,28.34,779,699,1492
10.09.2016 08:00,2375,29.11,785,728,1590
10.09.2016 09:00,2498,31.87,795,713,1703
10.09.2016 10:00,2649,33.6,764,856,1885
10.09.2016 11:00,2733,33.68,744,839,1989
10.09.2016 12:00,2796,34.13,715,840,2081
10.09.2016 13:00,2768,32.85,738,842,2030
10.09.2016 14:00,2697,30.81,754,811,1943
10.09.2016 15:00,2691,30.42,719,788,1972
10.09.2016 16:00,2658,30.05,719,767,1939
10.09.2016 17:00,2696,30.66,656,733,2040
10.09.2016 18:00,2834,32.99,576,691,2258
10.09.2016 19:00,2996,38.36,547,658,2449
10.09.2016 20:00,2900,38.85,646,615,2254
10.09.2016 21:00,2740,35.85,646,593,2094
10.09.2016 22:00,2618,34.7,592,585,2026
10.09.2016 23:00,2512,32.74,523,570,1989
10.10.2016 00:00,2312,31.32,531,552,1781
10.10.2016 01:00,2179,29.58,528,540,1651
10.10.2016 02:00,2126,30.96,526,543,1600
10.10.2016 03:00,2182,30.32,470,548,1712
10.10.2016 04:00,2184,29.92,465,548,1719
10.10.2016 05:00,2207,29.46,471,559,1736
10.10.2016 06:00,2372,31.28,493,572,1879
10.10.2016 07:00,2784,44.37,543,598,2241
10.10.2016 08:00,3179,67.58,569,632,2610
10.10.2016 09:00,3295,75,573,667,2722
10.10.2016 10:00,3301,70.16,637,695,2664
10.10.2016 11:00,3324,60.13,694,715,2630
10.10.2016 12:00,3312,55.66,727,748,2585
10.10.2016 13:00,3291,51.99,774,778,2517
10.10.2016 14:00,3307,53.21,778,806,2529
10.10.2016 15:00,3213,52.65,778,816,2435
10.10.2016 16:00,3288,50.67,770,831,2518
10.10.2016 17:00,3240,46.49,811,862,2429
10.10.2016 18:00,3176,55.87,864,868,2312
10.10.2016 19:00,3191,69.94,906,884,2285
10.10.2016 20:00,3187,79.97,922,908,2265
10.10.2016 21:00,3047,45.08,929,927,2118
10.10.2016 22:00,3001,37,903,909,2098
10.10.2016 23:00,2929,33.24,870,895,2059
10.11.2016 00:00,2772,30.53,867,891,1905
10.11.2016 01:00,2607,31.56,846,826,1761
10.11.2016 02:00,2687,30.23,768,802,1919
10.11.2016 03:00,2825,29.08,677,795,2148
10.11.2016 04:00,2872,29.16,690,781,2182
10.11.2016 05:00,2953,30.18,694,778,2259
10.11.2016 06:00,3241,32.69,691,806,2550
10.11.2016 07:00,3453,36.9,684,813,2769
10.11.2016 08:00,3634,43.88,711,810,2923
10.11.2016 09:00,3788,49.39,695,805,3093
10.11.2016 10:00,3774,49.35,701,817,3073
10.11.2016 11:00,3844,47.58,703,825,3141
10.11.2016 12:00,3736,45.08,731,806,3005
10.11.2016 13:00,3803,40.08,761,803,3042
10.11.2016 14:00,3780,39.91,770,791,3010
10.11.2016 15:00,3348,37.88,781,790,2567
10.11.2016 16:00,3085,39.25,824,779,2261
10.11.2016 17:00,3074,39.96,770,748,2304
10.11.2016 18:00,3080,42.67,797,744,2283
10.11.2016 19:00,3210,44.97,793,756,2417
10.11.2016 20:00,3241,44.54,767,759,2474
10.11.2016 21:00,3090,36.41,764,764,2326
10.11.2016 22:00,2900,35.07,744,733,2156
10.11.2016 23:00,2674,32.58,707,720,1967
10.12.2016 00:00,2493,30.41,668,718,1825
10.12.2016 01:00,2355,30.82,658,683,1697
10.12.2016 02:00,2231,29.53,696,662,1535
10.12.2016 03:00,2228,28.78,668,663,1560
10.12.2016 04:00,2233,28.7,648,647,1585
10.12.2016 05:00,2298,30.5,627,658,1671
10.12.2016 06:00,2422,32.92,644,654,1778
10.12.2016 07:00,2832,37.19,672,661,2160
10.12.2016 08:00,3230,47.59,668,686,2562
10.12.2016 09:00,3311,48.15,627,679,2684
10.12.2016 10:00,3384,47.08,589,683,2795
10.12.2016 11:00,3376,45,585,662,2791
10.12.2016 12:00,3308,46.05,614,648,2694
10.12.2016 13:00,3221,43.87,630,624,2591
10.12.2016 14:00,3181,44.45,643,605,2538
10.12.2016 15:00,3131,43.13,643,586,2488
10.12.2016 16:00,3137,39.42,640,591,2497
10.12.2016 17:00,3061,38.62,622,567,2439
10.12.2016 18:00,3135,43.89,593,538,2542
10.12.2016 19:00,3158,48.09,567,518,2591
10.12.2016 20:00,3175,49,547,518,2628
10.12.2016 21:00,3048,39.2,521,513,2527
10.12.2016 22:00,2862,36.74,504,497,2358
10.12.2016 23:00,2642,34.76,477,486,2165
13.10.2016 00:00,2436,32.12,486,475,1950
13.10.2016 01:00,2285,30.04,525,476,1760
13.10.2016 02:00,2189,29.16,552,473,1637
13.10.2016 03:00,2155,28.77,564,471,1591
13.10.2016 04:00,2215,28.85,532,487,1683
13.10.2016 05:00,2270,29.37,529,509,1741
13.10.2016 06:00,2393,34.44,581,520,1812
13.10.2016 07:00,2793,39.99,585,533,2208
13.10.2016 08:00,3079,55.02,639,524,2440
13.10.2016 09:00,3092,56.69,670,521,2422
13.10.2016 10:00,3120,55.99,610,525,2510
13.10.2016 11:00,3260,55.02,542,534,2718
13.10.2016 12:00,3198,54.65,564,528,2634
13.10.2016 13:00,3173,53.07,576,529,2597
13.10.2016 14:00,3154,54.65,563,518,2591
13.10.2016 15:00,3139,45.56,526,522,2613
13.10.2016 16:00,3160,41.52,525,537,2635
13.10.2016 17:00,3103,39.92,546,552,2557
13.10.2016 18:00,3069,44.94,621,572,2448
13.10.2016 19:00,3190,51.26,628,610,2562
13.10.2016 20:00,3218,50.71,664,662,2554
13.10.2016 21:00,3046,39.68,723,691,2323
13.10.2016 22:00,2848,35.62,791,715,2057
13.10.2016 23:00,2576,32.87,837,728,1739
14.10.2016 00:00,2400,30.07,811,734,1589
14.10.2016 01:00,2305,30.67,767,723,1538
14.10.2016 02:00,2233,29.41,753,705,1480
14.10.2016 03:00,2284,28.96,684,694,1600
14.10.2016 04:00,2290,29.08,650,698,1640
14.10.2016 05:00,2327,30.62,657,699,1670
14.10.2016 06:00,2475,33.9,672,708,1803
14.10.2016 07:00,2823,39.39,751,718,2072
14.10.2016 08:00,3104,43.59,826,736,2278
14.10.2016 09:00,3155,46.35,882,784,2273
14.10.2016 10:00,3106,45.87,958,832,2148
14.10.2016 11:00,3071,39.76,1010,874,2061
14.10.2016 12:00,3029,39.12,1047,907,1982
14.10.2016 13:00,2965,38,1032,932,1933
14.10.2016 14:00,2963,36.77,1016,951,1947
14.10.2016 15:00,2916,36.35,983,956,1933
14.10.2016 16:00,2860,35.48,1012,977,1848
14.10.2016 17:00,2769,34.58,1088,1004,1681
14.10.2016 18:00,2793,36.52,1121,1003,1672
14.10.2016 19:00,2940,38.27,1125,1054,1815
14.10.2016 20:00,2896,37.59,1134,1076,1762
14.10.2016 21:00,2730,33.24,1153,1076,1577
14.10.2016 22:00,2585,30.79,1154,1087,1431
14.10.2016 23:00,2414,29.38,1182,1096,1232
15.10.2016 00:00,2294,28.56,1158,1086,1136
15.10.2016 01:00,2188,28.34,1165,1107,1023
15.10.2016 02:00,2131,27.75,1170,1129,961
15.10.2016 03:00,2121,27.49,1166,1149,955
15.10.2016 04:00,2113,27.27,1185,1159,928
15.10.2016 05:00,2128,27.14,1215,1213,913
15.10.2016 06:00,2171,28.02,1243,1237,928
15.10.2016 07:00,2249,29.03,1239,1252,1010
15.10.2016 08:00,2414,29.79,1242,1271,1172
15.10.2016 09:00,2516,30.59,1263,1274,1253
15.10.2016 10:00,2662,31.62,1263,1276,1399
15.10.2016 11:00,2683,31.89,1279,1268,1404
15.10.2016 12:00,2676,33.16,1299,1268,1377
15.10.2016 13:00,2630,31.39,1273,1267,1357
15.10.2016 14:00,2655,31.36,1268,1265,1387
15.10.2016 15:00,2620,31.47,1277,1262,1343
15.10.2016 16:00,2635,31.8,1269,1266,1366
15.10.2016 17:00,2707,32.32,1266,1267,1441
15.10.2016 18:00,2784,34.12,1266,1255,1518
15.10.2016 19:00,2917,36.2,1253,1236,1664
15.10.2016 20:00,2816,35.14,1255,1209,1561
15.10.2016 21:00,2662,32.78,1241,1168,1421
15.10.2016 22:00,2524,31.2,1205,1130,1319
15.10.2016 23:00,2431,30.68,1099,1070,1332
16.10.2016 00:00,2352,30,993,1028,1359
16.10.2016 01:00,2210,30.24,950,942,1260
16.10.2016 02:00,2142,29.85,906,894,1236
16.10.2016 03:00,2129,29.75,859,860,1270
16.10.2016 04:00,2140,29.61,829,848,1311
16.10.2016 05:00,2148,29.68,828,854,1320
16.10.2016 06:00,2155,29.88,821,829,1334
16.10.2016 07:00,2224,30.26,810,815,1414
16.10.2016 08:00,2345,30.77,788,800,1557
16.10.2016 09:00,2492,31.44,736,786,1756
16.10.2016 10:00,2660,32.38,717,764,1943
16.10.2016 11:00,2751,33.25,723,738,2028
16.10.2016 12:00,2806,33.58,708,705,2098
16.10.2016 13:00,2770,32.72,703,672,2067
16.10.2016 14:00,2781,31.92,690,649,2091
16.10.2016 15:00,2720,30.82,677,624,2043
16.10.2016 16:00,2679,31.19,667,592,2012
16.10.2016 17:00,2713,31.81,660,585,2053
16.10.2016 18:00,2849,34.43,652,574,2197
16.10.2016 19:00,2944,36.45,628,566,2316
16.10.2016 20:00,2914,36.59,604,566,2310
16.10.2016 21:00,2765,33.67,588,511,2177
16.10.2016 22:00,2568,31.54,574,488,1994
16.10.2016 23:00,2478,30.57,481,476,1997
17.10.2016 00:00,2311,29.38,455,452,1856
17.10.2016 01:00,2259,30.01,419,476,1840
17.10.2016 02:00,2205,29.56,399,459,1806
17.10.2016 03:00,2169,29.17,394,439,1775
17.10.2016 04:00,2158,28.44,395,435,1763
17.10.2016 05:00,2193,29.1,409,431,1784
17.10.2016 06:00,2315,30.46,457,434,1858
17.10.2016 07:00,2728,37.89,509,447,2219
17.10.2016 08:00,3120,44.03,542,473,2578
17.10.2016 09:00,3193,46.63,577,501,2616
17.10.2016 10:00,3207,45.08,601,516,2606
17.10.2016 11:00,3251,43.03,631,543,2620
17.10.2016 12:00,3249,44.91,651,554,2598
17.10.2016 13:00,3230,41.9,627,547,2603
17.10.2016 14:00,3227,45.21,594,536,2633
17.10.2016 15:00,3102,46.61,629,519,2473
17.10.2016 16:00,3098,42.08,639,519,2459
17.10.2016 17:00,3087,42,618,521,2469
17.10.2016 18:00,3180,41.07,595,524,2585
17.10.2016 19:00,3288,47.75,561,524,2727
17.10.2016 20:00,3198,46.04,552,510,2646
17.10.2016 21:00,3019,41.05,534,471,2485
17.10.2016 22:00,2842,35.37,485,434,2357
17.10.2016 23:00,2690,35.02,371,381,2319
18.10.2016 00:00,2527,31.79,279,332,2248
18.10.2016 01:00,2402,31.5,227,302,2175
18.10.2016 02:00,2318,30.82,192,266,2126
18.10.2016 03:00,2266,30.46,165,239,2101
18.10.2016 04:00,2257,30.5,150,223,2107
18.10.2016 05:00,2277,31.11,136,205,2141
18.10.2016 06:00,2423,32.96,119,192,2304
18.10.2016 07:00,2790,41.14,119,179,2671
18.10.2016 08:00,3168,50.1,114,173,3054
18.10.2016 09:00,3256,53.63,123,170,3133
18.10.2016 10:00,3274,51.93,118,173,3156
18.10.2016 11:00,3300,50.35,119,177,3181
18.10.2016 12:00,3291,50.81,124,182,3167
18.10.2016 13:00,3219,47.63,105,154,3114
18.10.2016 14:00,3215,46.31,91,146,3124
18.10.2016 15:00,3186,42.03,73,141,3113
18.10.2016 16:00,3189,41.1,69,142,3120
18.10.2016 17:00,3104,40.06,75,144,3029
18.10.2016 18:00,3166,46.01,101,147,3065
18.10.2016 19:00,3235,50.11,112,160,3123
18.10.2016 20:00,3154,48.64,129,173,3025
18.10.2016 21:00,2990,38.56,144,179,2846
18.10.2016 22:00,2798,35.29,139,181,2659
18.10.2016 23:00,2588,32.7,125,180,2463
19.10.2016 00:00,2368,30.99,126,180,2242
19.10.2016 01:00,2258,31.63,112,178,2146
19.10.2016 02:00,2206,31.07,103,184,2103
19.10.2016 03:00,2172,30.98,102,182,2070
19.10.2016 04:00,2186,31.01,98,188,2088
19.10.2016 05:00,2236,31.39,109,201,2127
19.10.2016 06:00,2386,33.44,125,204,2261
19.10.2016 07:00,2786,38.01,139,221,2647
19.10.2016 08:00,3155,47.5,181,233,2974
19.10.2016 09:00,3195,48.68,214,244,2981
19.10.2016 10:00,3192,48.47,235,258,2957
19.10.2016 11:00,3261,49.29,243,270,3018
19.10.2016 12:00,3289,50.09,268,286,3021
19.10.2016 13:00,3153,49.17,317,296,2836
19.10.2016 14:00,3171,47.05,324,306,2847
19.10.2016 15:00,3142,43.05,340,325,2802
19.10.2016 16:00,3150,42.29,350,338,2800
19.10.2016 17:00,3073,43.16,375,366,2698
19.10.2016 18:00,3117,47.16,394,388,2723
19.10.2016 19:00,3151,50.16,461,425,2690
19.10.2016 20:00,3097,49,521,467,2576
19.10.2016 21:00,2797,44.49,628,468,2169
19.10.2016 22:00,2592,36.48,670,491,1922
19.10.2016 23:00,2419,34.99,649,499,1770
20.10.2016 00:00,2274,32.03,573,496,1701
20.10.2016 01:00,2283,31.73,551,615,1732
20.10.2016 02:00,2232,31.51,530,605,1702
20.10.2016 03:00,2190,30.96,495,548,1695
20.10.2016 04:00,2269,31.02,407,540,1862
20.10.2016 05:00,2342,31.57,341,491,2001
20.10.2016 06:00,2492,32.68,332,463,2160
20.10.2016 07:00,2846,38,351,431,2495
20.10.2016 08:00,3195,42.66,379,415,2816
20.10.2016 09:00,3225,46.12,406,392,2819
20.10.2016 10:00,3217,46.83,394,379,2823
20.10.2016 11:00,3266,47.06,374,385,2892
20.10.2016 12:00,3220,47.16,353,372,2867
20.10.2016 13:00,3197,44.93,322,367,2875
20.10.2016 14:00,3197,44.71,307,362,2890
20.10.2016 15:00,3158,43.22,320,369,2838
20.10.2016 16:00,3101,42.97,382,381,2719
20.10.2016 17:00,3076,43.9,431,414,2645
20.10.2016 18:00,3119,46.42,485,448,2634
20.10.2016 19:00,3181,47.31,527,476,2654
20.10.2016 20:00,3123,47.15,555,510,2568
20.10.2016 21:00,3003,41.94,572,531,2431
20.10.2016 22:00,2841,37.61,563,548,2278
20.10.2016 23:00,2601,34.67,564,565,2037
21.10.2016 00:00,2433,32.87,551,596,1882
21.10.2016 01:00,2290,32.65,620,654,1670
21.10.2016 02:00,2168,31.94,729,714,1439
21.10.2016 03:00,2122,31.39,859,802,1263
21.10.2016 04:00,2072,31.17,974,866,1098
21.10.2016 05:00,2160,32.33,980,941,1180
21.10.2016 06:00,2362,33.4,969,964,1393
21.10.2016 07:00,2745,37.42,1002,986,1743
21.10.2016 08:00,3117,42.39,1013,956,2104
21.10.2016 09:00,3243,44.53,992,947,2251
21.10.2016 10:00,3331,44.81,962,945,2369
21.10.2016 11:00,3364,45.12,923,930,2441
21.10.2016 12:00,3381,44.68,888,901,2493
21.10.2016 13:00,3309,44.21,853,859,2456
21.10.2016 14:00,3254,41.84,808,823,2446
21.10.2016 15:00,3215,39.03,726,811,2489
21.10.2016 16:00,3183,38.33,717,791,2466
21.10.2016 17:00,3172,38.45,689,773,2483
21.10.2016 18:00,3262,41.57,676,761,2586
21.10.2016 19:00,3286,45.33,684,751,2602
21.10.2016 20:00,3152,43.39,672,741,2480
21.10.2016 21:00,2981,38.29,646,726,2335
21.10.2016 22:00,2774,36.09,654,717,2120
21.10.2016 23:00,2579,34.14,661,706,1918
22.10.2016 00:00,2418,33.08,650,697,1768
22.10.2016 01:00,2249,33.28,678,664,1571
22.10.2016 02:00,2174,33.04,723,690,1451
22.10.2016 03:00,2124,32.88,777,725,1347
22.10.2016 04:00,2123,32.84,785,760,1338
22.10.2016 05:00,2206,32.92,752,760,1454
22.10.2016 06:00,2198,33.09,779,764,1419
22.10.2016 07:00,2333,33.44,788,758,1545
22.10.2016 08:00,2489,33.84,782,754,1707
22.10.2016 09:00,2556,34.36,782,753,1774
22.10.2016 10:00,2762,36.12,786,741,1976
22.10.2016 11:00,2860,36.96,799,741,2061
22.10.2016 12:00,2908,36.38,819,742,2089
22.10.2016 13:00,2883,37.16,817,729,2066
22.10.2016 14:00,2862,35.08,797,725,2065
22.10.2016 15:00,2834,34.31,754,699,2080
22.10.2016 16:00,2819,34.17,752,698,2067
22.10.2016 17:00,2818,35.19,762,703,2056
22.10.2016 18:00,2928,39.9,788,688,2140
22.10.2016 19:00,2997,40.96,787,691,2210
22.10.2016 20:00,2943,40.05,734,691,2209
22.10.2016 21:00,2836,36.47,702,694,2134
22.10.2016 22:00,2674,35.02,673,679,2001
22.10.2016 23:00,2485,33.76,683,657,1802
23.10.2016 00:00,2388,33.4,679,639,1709
23.10.2016 01:00,2187,33.09,677,550,1510
23.10.2016 02:00,2148,32.69,625,526,1523
23.10.2016 03:00,2220,32.41,543,516,1677
23.10.2016 04:00,2233,31.85,500,488,1733
23.10.2016 05:00,2213,32.03,471,446,1742
23.10.2016 06:00,2240,31.9,440,407,1800
23.10.2016 07:00,2319,32.52,401,373,1918
23.10.2016 08:00,2443,33.04,358,350,2085
23.10.2016 09:00,2560,33.75,332,331,2228
23.10.2016 10:00,2697,35.22,299,301,2398
23.10.2016 11:00,2820,35.74,254,265,2566
23.10.2016 12:00,2862,36.13,193,243,2669
23.10.2016 13:00,2841,35.93,167,217,2674
23.10.2016 14:00,2775,35.26,149,195,2626
23.10.2016 15:00,2733,35.38,138,183,2595
23.10.2016 16:00,2755,35.23,115,186,2640
23.10.2016 17:00,2757,36.4,137,191,2620
23.10.2016 18:00,2882,38.15,142,209,2740
23.10.2016 19:00,3073,41.81,171,225,2902
23.10.2016 20:00,2953,41.73,287,229,2666
23.10.2016 21:00,2866,38.81,245,240,2621
23.10.2016 22:00,2661,36.86,255,242,2406
23.10.2016 23:00,2530,34.75,233,254,2297
24.10.2016 00:00,2407,33.6,233,255,2174
24.10.2016 01:00,2260,32.22,249,227,2011
24.10.2016 02:00,2155,31.85,299,213,1856
24.10.2016 03:00,2174,31.81,289,225,1885
24.10.2016 04:00,2156,31.66,331,252,1825
24.10.2016 05:00,2215,32,326,264,1889
24.10.2016 06:00,2433,34.04,292,282,2141
24.10.2016 07:00,2971,40.92,254,297,2717
24.10.2016 08:00,3375,45.52,276,300,3099
24.10.2016 09:00,3473,45.07,253,295,3220
24.10.2016 10:00,3427,45.75,295,288,3132
24.10.2016 11:00,3478,46.39,293,297,3185
24.10.2016 12:00,3459,45.53,289,290,3170
24.10.2016 13:00,3434,45.38,286,281,3148
24.10.2016 14:00,3447,44.97,280,279,3167
24.10.2016 15:00,3344,43.65,278,278,3066
24.10.2016 16:00,3272,43.66,296,280,2976
24.10.2016 17:00,3174,43.26,322,286,2852
24.10.2016 18:00,3282,46.7,320,291,2962
24.10.2016 19:00,3332,47.33,361,286,2971
24.10.2016 20:00,3264,46.03,338,292,2926
24.10.2016 21:00,3107,41.07,329,291,2778
24.10.2016 22:00,2902,37.49,302,285,2600
24.10.2016 23:00,2659,35.78,312,274,2347
25.10.2016 00:00,2465,33.36,299,269,2166
25.10.2016 01:00,2382,33.73,284,277,2098
25.10.2016 02:00,2323,33.47,276,273,2047
25.10.2016 03:00,2313,33.57,255,270,2058
25.10.2016 04:00,2344,33.65,233,267,2111
25.10.2016 05:00,2351,34.13,228,256,2123
25.10.2016 06:00,2506,37.01,233,246,2273
25.10.2016 07:00,2916,43.3,212,234,2704
25.10.2016 08:00,3339,66.46,190,222,3149
25.10.2016 09:00,3448,66.38,170,204,3278
25.10.2016 10:00,3419,65.66,148,185,3271
25.10.2016 11:00,3457,66.95,110,172,3347
25.10.2016 12:00,3431,69.17,88,155,3343
25.10.2016 13:00,3367,65.99,67,138,3300
25.10.2016 14:00,3332,64.43,95,134,3237
25.10.2016 15:00,3256,56.58,125,139,3131
25.10.2016 16:00,3194,52.74,180,154,3014
25.10.2016 17:00,3113,54.65,198,175,2915
25.10.2016 18:00,3222,67.71,206,197,3016
25.10.2016 19:00,3337,67.18,241,214,3096
25.10.2016 20:00,3277,59.9,256,223,3021
25.10.2016 21:00,3235,48.61,225,217,3010
25.10.2016 22:00,3043,40.13,204,213,2839
25.10.2016 23:00,2846,37.38,165,187,2681
26.10.2016 00:00,2640,34.7,155,182,2485
26.10.2016 01:00,2533,35.81,181,172,2352
26.10.2016 02:00,2517,34.6,190,165,2327
26.10.2016 03:00,2435,34.71,193,149,2242
26.10.2016 04:00,2481,35.03,175,141,2306
26.10.2016 05:00,2458,35.03,168,105,2290
26.10.2016 06:00,2647,37.06,153,100,2494
26.10.2016 07:00,3125,43.03,109,95,3016
26.10.2016 08:00,3552,52.3,77,88,3475
26.10.2016 09:00,3591,54.32,86,61,3505
26.10.2016 10:00,3606,54.5,84,57,3522
26.10.2016 11:00,3644,53.69,56,65,3588
26.10.2016 12:00,3561,54.34,43,64,3518
26.10.2016 13:00,3452,50.9,46,72,3406
26.10.2016 14:00,3422,49.05,51,75,3371
26.10.2016 15:00,3374,46.79,65,93,3309
26.10.2016 16:00,3345,46.81,92,111,3253
26.10.2016 17:00,3289,47.92,131,133,3158
26.10.2016 18:00,3372,49.89,188,170,3184
26.10.2016 19:00,3419,53.84,282,215,3137
26.10.2016 20:00,3324,51.23,339,264,2985
26.10.2016 21:00,3143,41.28,411,319,2732
26.10.2016 22:00,2867,39.11,517,384,2350
26.10.2016 23:00,2650,36.47,580,447,2070
27.10.2016 00:00,2434,33.3,668,517,1766
27.10.2016 01:00,2443,32.84,656,649,1787
27.10.2016 02:00,2388,32.26,660,698,1728
27.10.2016 03:00,2402,31.87,682,748,1720
27.10.2016 04:00,2400,32.02,686,758,1714
27.10.2016 05:00,2444,32.75,675,764,1769
27.10.2016 06:00,2557,34.36,671,728,1886
27.10.2016 07:00,2974,38.65,611,680,2363
27.10.2016 08:00,3423,44.59,537,617,2886
27.10.2016 09:00,3481,46.61,484,550,2997
27.10.2016 10:00,3450,46.29,405,498,3045
27.10.2016 11:00,3448,45.89,352,447,3096
27.10.2016 12:00,3425,44.6,329,402,3096
27.10.2016 13:00,3308,43.81,326,405,2982
27.10.2016 14:00,3260,42.06,307,403,2953
27.10.2016 15:00,3167,40.47,320,388,2847
27.10.2016 16:00,3163,40,321,395,2842
27.10.2016 17:00,3123,40.72,372,428,2751
27.10.2016 18:00,3221,42.87,472,490,2749
27.10.2016 19:00,3257,42.7,645,566,2612
27.10.2016 20:00,3121,40.37,762,649,2359
27.10.2016 21:00,3000,37.71,832,758,2168
27.10.2016 22:00,2793,36.08,920,843,1873
27.10.2016 23:00,2542,33.59,988,905,1554
28.10.2016 00:00,2328,31.05,1073,982,1255
28.10.2016 01:00,2206,29.67,1140,1063,1066
28.10.2016 02:00,2138,27.82,1201,1112,937
28.10.2016 03:00,2125,27.33,1221,1149,904
28.10.2016 04:00,2099,27.53,1221,1157,878
28.10.2016 05:00,2181,28.38,1194,1157,987
28.10.2016 06:00,2330,31.22,1213,1179,1117
28.10.2016 07:00,2719,35,1217,1178,1502
28.10.2016 08:00,3078,37.07,1205,1172,1873
28.10.2016 09:00,3213,38.35,1192,1203,2021
28.10.2016 10:00,3200,37.72,1199,1215,2001
28.10.2016 11:00,3244,37.76,1218,1242,2026
28.10.2016 12:00,3137,37.95,1290,1265,1847
28.10.2016 13:00,2992,37.17,1335,1273,1657
28.10.2016 14:00,2932,36.82,1339,1299,1593
28.10.2016 15:00,2887,36.31,1347,1348,1540
28.10.2016 16:00,2820,36.33,1348,1348,1472
28.10.2016 17:00,2850,37.07,1329,1356,1521
28.10.2016 18:00,3025,38.57,1316,1355,1709
28.10.2016 19:00,3124,38.57,1321,1358,1803
28.10.2016 20:00,2972,37.65,1349,1359,1623
28.10.2016 21:00,2801,35.08,1370,1359,1431
28.10.2016 22:00,2643,34.29,1389,1362,1254
28.10.2016 23:00,2490,33.51,1382,1358,1108
29.10.2016 00:00,2364,31.95,1376,1372,988
29.10.2016 01:00,2290,30.31,1358,1381,932
29.10.2016 02:00,2234,28.18,1334,1371,900
29.10.2016 03:00,2196,28.27,1351,1368,845
29.10.2016 04:00,2157,27.97,1337,1360,820
29.10.2016 05:00,2207,28.08,1305,1354,902
29.10.2016 06:00,2272,28.84,1268,1329,1004
29.10.2016 07:00,2392,30.77,1220,1298,1172
29.10.2016 08:00,2564,32.5,1169,1256,1395
29.10.2016 09:00,2709,33.93,1088,1209,1621
29.10.2016 10:00,2787,34.66,1071,1163,1716
29.10.2016 11:00,2736,34.86,1071,1111,1665
29.10.2016 12:00,2630,34.77,1126,1074,1504
29.10.2016 13:00,2530,33.79,1158,1065,1372
29.10.2016 14:00,2513,32.66,1126,1054,1387
29.10.2016 15:00,2471,32.23,1093,1033,1378
29.10.2016 16:00,2475,32.15,1020,981,1455
29.10.2016 17:00,2612,32.79,901,939,1711
29.10.2016 18:00,2820,35.31,840,901,1980
29.10.2016 19:00,2973,36.18,816,869,2157
29.10.2016 20:00,2854,35.65,792,815,2062
29.10.2016 21:00,2705,34.35,810,793,1895
29.10.2016 22:00,2520,34.11,859,778,1661
29.10.2016 23:00,2437,33.99,854,783,1583
30.10.2016 00:00,2296,33,881,786,1415
30.10.2016 01:00,2206,32.57,905,807,1301
30.10.2016 02:00,2155,32.15,892,810,1263
30.10.2016 03:00,2131,31.55,886,775,1245
30.10.2016 03:00,2183,31.55,841,782,1342
30.10.2016 04:00,2170,31.4,809,767,1361
30.10.2016 05:00,2195,31.52,799,735,1396
30.10.2016 06:00,2215,32.73,794,687,1421
30.10.2016 07:00,2324,33.37,754,651,1570
30.10.2016 08:00,2452,34.17,678,627,1774
30.10.2016 09:00,2618,35.02,559,578,2059
30.10.2016 10:00,2716,36.49,399,499,2317
30.10.2016 11:00,2703,36.99,319,419,2384
30.10.2016 12:00,2670,38.33,273,362,2397
30.10.2016 13:00,2671,37.2,236,312,2435
30.10.2016 14:00,2605,35.02,220,280,2385
30.10.2016 15:00,2562,34.76,225,273,2337
30.10.2016 16:00,2634,34.9,209,277,2425
30.10.2016 17:00,2777,37.72,290,301,2487
30.10.2016 18:00,3030,45.84,336,304,2694
30.10.2016 19:00,3051,44.69,285,291,2766
30.10.2016 20:00,2964,43.88,253,243,2711
30.10.2016 21:00,2805,40.25,258,226,2547
30.10.2016 22:00,2635,39,246,210,2389
30.10.2016 23:00,2541,38.06,196,197,2345
31.10.2016 00:00,2440,36.73,152,186,2288
31.10.2016 01:00,2356,35.36,147,190,2209
31.10.2016 02:00,2334,34.94,130,177,2204
31.10.2016 03:00,2311,34.66,121,162,2190
31.10.2016 04:00,2304,34.35,106,159,2198
31.10.2016 05:00,2373,35.08,83,147,2290
31.10.2016 06:00,2556,40.03,91,136,2465
31.10.2016 07:00,2935,45.29,126,129,2809
31.10.2016 08:00,3257,51.68,125,126,3132
31.10.2016 09:00,3347,50.47,111,124,3236
31.10.2016 10:00,3344,47.38,106,120,3238
31.10.2016 11:00,3396,46.2,81,119,3315
31.10.2016 12:00,3357,46.06,66,109,3291
31.10.2016 13:00,3316,45.05,68,97,3248
31.10.2016 14:00,3328,43.91,69,100,3259
31.10.2016 15:00,3282,43.08,62,94,3220
31.10.2016 16:00,3292,46.04,55,92,3237
31.10.2016 17:00,3323,49.73,53,84,3270
31.10.2016 18:00,3422,59.2,47,81,3375
31.10.2016 19:00,3304,55.98,47,84,3257
31.10.2016 20:00,3224,47.79,67,94,3157
31.10.2016 21:00,3070,44.13,74,123,2996
31.10.2016 22:00,2894,40.26,106,179,2788
31.10.2016 23:00,2683,38.62,144,207,2539
11.01.2016 00:00,2463,36.78,226,251,2237
11.01.2016 01:00,2275,34.42,301,310,1974
11.01.2016 02:00,2178,33.68,381,388,1797
11.01.2016 03:00,2122,33.31,499,483,1623
11.01.2016 04:00,2132,33.01,575,584,1557
11.01.2016 05:00,2142,33.54,671,654,1471
11.01.2016 06:00,2265,34.92,770,711,1495
11.01.2016 07:00,2616,40.13,836,774,1780
11.01.2016 08:00,2968,42.08,834,810,2134
11.01.2016 09:00,3131,42.88,800,857,2331
11.01.2016 10:00,3149,42.36,818,878,2331
11.01.2016 11:00,3194,39.89,878,927,2316
11.01.2016 12:00,3218,39.93,927,994,2291
11.01.2016 13:00,3115,40.85,1001,1033,2114
11.01.2016 14:00,3112,40.13,1028,1070,2084
11.01.2016 15:00,3047,39.19,1132,1124,1915
11.01.2016 16:00,3063,39.64,1145,1142,1918
11.01.2016 17:00,3157,40.72,1136,1159,2021
11.01.2016 18:00,3375,44.61,1125,1175,2250
11.01.2016 19:00,3341,43.06,1119,1178,2222
11.01.2016 20:00,3237,39.35,1124,1166,2113
11.01.2016 21:00,3026,37.15,1144,1143,1882
11.01.2016 22:00,2872,36.55,1113,1132,1759
11.01.2016 23:00,2744,34.56,1021,1137,1723
11.02.2016 00:00,2578,33.05,999,1144,1579
11.02.2016 01:00,2429,33.01,973,1110,1456
11.02.2016 02:00,2363,32.61,954,1082,1409
11.02.2016 03:00,2404,32.44,894,1066,1510
11.02.2016 04:00,2394,32.28,909,1055,1485
11.02.2016 05:00,2448,33.32,938,1041,1510
11.02.2016 06:00,2621,35.1,956,1041,1665
11.02.2016 07:00,3056,39,953,1034,2103
11.02.2016 08:00,3355,42.59,981,1066,2374
11.02.2016 09:00,3500,41.96,979,1089,2521
11.02.2016 10:00,3500,40.01,1006,1111,2494
11.02.2016 11:00,3590,39,1011,1133,2579
11.02.2016 12:00,3579,38.62,1042,1155,2537
11.02.2016 13:00,3549,38.94,1084,1175,2465
11.02.2016 14:00,3570,38.85,1076,1173,2494
11.02.2016 15:00,3572,38.58,1032,1166,2540
11.02.2016 16:00,3623,39.22,996,1156,2627
11.02.2016 17:00,3726,41.81,961,1138,2765
11.02.2016 18:00,3871,47.52,945,1115,2926
11.02.2016 19:00,3785,46.06,939,1092,2846
11.02.2016 20:00,3711,41.79,890,1060,2821
11.02.2016 21:00,3558,39.98,878,1038,2680
11.02.2016 22:00,3391,38.45,846,1011,2545
11.02.2016 23:00,3147,37,850,970,2297
11.03.2016 00:00,2933,35.67,861,931,2072
11.03.2016 01:00,2829,35.89,826,877,2003
11.03.2016 02:00,2816,35.66,740,834,2076
11.03.2016 03:00,2823,35.6,687,782,2136
11.03.2016 04:00,2859,35.87,605,720,2254
11.03.2016 05:00,2857,37.05,587,659,2270
11.03.2016 06:00,2991,39.91,565,608,2426
11.03.2016 07:00,3345,46.1,537,550,2808
11.03.2016 08:00,3660,52.94,451,505,3209
11.03.2016 09:00,3756,56.06,366,445,3390
11.03.2016 10:00,3697,50.11,293,389,3404
11.03.2016 11:00,3668,46.86,240,336,3428
11.03.2016 12:00,3604,47.63,217,290,3387
11.03.2016 13:00,3449,47.86,235,253,3214
11.03.2016 14:00,3449,47.77,197,221,3252
11.03.2016 15:00,3463,47.68,161,190,3302
11.03.2016 16:00,3511,48.51,135,163,3376
11.03.2016 17:00,3621,56,111,147,3510
11.03.2016 18:00,3756,59.99,103,141,3653
11.03.2016 19:00,3681,56.03,93,126,3588
11.03.2016 20:00,3567,47.71,99,115,3468
11.03.2016 21:00,3408,42.91,112,103,3296
11.03.2016 22:00,3200,39.78,140,97,3060
11.03.2016 23:00,2989,38.05,147,102,2842
11.04.2016 00:00,2792,36.77,168,112,2624
11.04.2016 01:00,2705,37.09,151,145,2554
11.04.2016 02:00,2626,36.09,181,163,2445
11.04.2016 03:00,2572,35.88,206,161,2366
11.04.2016 04:00,2561,36.07,221,188,2340
11.04.2016 05:00,2648,37.28,234,243,2414
11.04.2016 06:00,2799,38.81,239,251,2560
11.04.2016 07:00,3207,40.66,240,273,2967
11.04.2016 08:00,3575,45.65,242,323,3333
11.04.2016 09:00,3694,47.52,232,329,3462
11.04.2016 10:00,3692,47.52,215,338,3477
11.04.2016 11:00,3726,45.02,227,340,3499
11.04.2016 12:00,3712,44.84,269,361,3443
11.04.2016 13:00,3657,44.57,312,398,3345
11.04.2016 14:00,3579,44.03,374,435,3205
11.04.2016 15:00,3453,43.15,436,453,3017
11.04.2016 16:00,3442,44.52,483,481,2959
11.04.2016 17:00,3535,46.3,512,515,3023
11.04.2016 18:00,3597,47.87,574,559,3023
11.04.2016 19:00,3467,46.23,593,591,2874
11.04.2016 20:00,3331,41.89,575,609,2756
11.04.2016 21:00,3142,39.69,562,622,2580
11.04.2016 22:00,2911,38.99,561,618,2350
11.04.2016 23:00,2746,37.9,563,608,2183
11.05.2016 00:00,2618,35.96,527,591,2091
11.05.2016 01:00,2509,37.28,503,575,2006
11.05.2016 02:00,2443,37.07,515,572,1928
11.05.2016 03:00,2393,36.77,519,566,1874
11.05.2016 04:00,2343,36.38,553,557,1790
11.05.2016 05:00,2303,36.41,596,566,1707
11.05.2016 06:00,2312,36.81,639,579,1673
11.05.2016 07:00,2402,37.4,685,610,1717
11.05.2016 08:00,2517,38.12,699,631,1818
11.05.2016 09:00,2640,38.96,717,641,1923
11.05.2016 10:00,2800,39.89,710,628,2090
11.05.2016 11:00,2875,41.16,734,641,2141
11.05.2016 12:00,2900,41.64,779,685,2121
11.05.2016 13:00,2971,41.11,756,740,2215
11.05.2016 14:00,3000,39.82,779,806,2221
11.05.2016 15:00,2905,39.35,927,881,1978
11.05.2016 16:00,2900,39.13,1027,955,1873
11.05.2016 17:00,3094,41.63,1064,1009,2030
11.05.2016 18:00,3184,43.34,1102,1036,2082
11.05.2016 19:00,3148,42.52,1083,1058,2065
11.05.2016 20:00,3052,39.92,1034,1047,2018
11.05.2016 21:00,2906,38.86,995,1013,1911
11.05.2016 22:00,2804,38.77,945,982,1859
11.05.2016 23:00,2701,37.68,890,965,1811
11.06.2016 00:00,2617,36.1,867,943,1750
11.06.2016 01:00,2488,35.58,855,887,1633
11.06.2016 02:00,2415,34.93,847,868,1568
11.06.2016 03:00,2393,35.03,836,853,1557
11.06.2016 04:00,2407,34.14,820,856,1587
11.06.2016 05:00,2396,34.14,849,867,1547
11.06.2016 06:00,2415,34.57,888,892,1527
11.06.2016 07:00,2528,35.28,908,928,1620
11.06.2016 08:00,2608,36.94,960,955,1648
11.06.2016 09:00,2709,37.73,1024,990,1685
11.06.2016 10:00,2867,38.44,1050,1026,1817
11.06.2016 11:00,2970,39.26,1106,1046,1864
11.06.2016 12:00,3001,40.59,1128,1069,1873
11.06.2016 13:00,2998,39.89,1165,1076,1833
11.06.2016 14:00,2993,39.18,1176,1087,1817
11.06.2016 15:00,2951,39.3,1232,1121,1719
11.06.2016 16:00,2996,39.72,1246,1120,1750
11.06.2016 17:00,3201,41.71,1235,1146,1966
11.06.2016 18:00,3364,43.72,1228,1160,2136
11.06.2016 19:00,3389,43.69,1208,1153,2181
11.06.2016 20:00,3342,41.67,1201,1169,2141
11.06.2016 21:00,3259,39.76,1185,1169,2074
11.06.2016 22:00,3131,39.19,1159,1161,1972
11.06.2016 23:00,2998,38.04,1110,1145,1888
11.07.2016 00:00,2920,36.22,1039,1135,1881
11.07.2016 01:00,2919,34.1,959,1137,1960
11.07.2016 02:00,2907,33.65,891,1102,2016
11.07.2016 03:00,2939,33.87,855,1087,2084
11.07.2016 04:00,2991,34.24,816,1075,2175
11.07.2016 05:00,3052,35.82,815,1057,2237
11.07.2016 06:00,3197,39.72,835,1039,2362
11.07.2016 07:00,3608,44.33,852,1023,2756
11.07.2016 08:00,3903,47.95,861,996,3042
11.07.2016 09:00,3952,49.01,869,966,3083
11.07.2016 10:00,3940,49.01,836,928,3104
11.07.2016 11:00,3980,45.54,757,886,3223
11.07.2016 12:00,3977,44.94,694,834,3283
11.07.2016 13:00,3904,47.72,612,761,3292
11.07.2016 14:00,3925,47.82,556,720,3369
11.07.2016 15:00,3868,48.05,534,689,3334
11.07.2016 16:00,3969,51.76,512,664,3457
11.07.2016 17:00,4077,57.04,505,638,3572
11.07.2016 18:00,4184,66.43,505,617,3679
11.07.2016 19:00,4137,59.26,453,593,3684
11.07.2016 20:00,4092,47.95,394,561,3698
11.07.2016 21:00,3919,44.65,362,526,3557
11.07.2016 22:00,3738,42.3,314,491,3424
11.07.2016 23:00,3472,40.17,316,458,3156
11.08.2016 00:00,3264,38.98,288,439,2976
11.08.2016 01:00,3118,38.39,250,382,2868
11.08.2016 02:00,3081,37.55,212,362,2869
11.08.2016 03:00,3082,37.06,178,340,2904
11.08.2016 04:00,3090,37.15,170,317,2920
11.08.2016 05:00,3110,38.85,192,298,2918
11.08.2016 06:00,3319,41.87,203,281,3116
11.08.2016 07:00,3716,47.92,205,267,3511
11.08.2016 08:00,4045,61.65,202,240,3843
11.08.2016 09:00,4075,63.79,182,208,3893
11.08.2016 10:00,4047,62.35,117,175,3930
11.08.2016 11:00,4045,57.55,72,157,3973
11.08.2016 12:00,4018,57.58,44,130,3974
11.08.2016 13:00,3905,57.09,47,98,3858
11.08.2016 14:00,3913,58.09,40,85,3873
11.08.2016 15:00,3926,60.08,49,85,3877
11.08.2016 16:00,3955,66.28,58,93,3897
11.08.2016 17:00,4020,84.92,80,128,3940
11.08.2016 18:00,4107,104.96,114,152,3993
11.08.2016 19:00,4030,70.03,167,174,3863
11.08.2016 20:00,3873,55.07,244,207,3629
11.08.2016 21:00,3659,45.23,307,242,3352
11.08.2016 22:00,3387,43.5,379,276,3008
11.08.2016 23:00,3141,40.98,432,312,2709
11.09.2016 00:00,2929,38.89,492,344,2437
11.09.2016 01:00,2921,38.29,529,493,2392
11.09.2016 02:00,2895,37.61,552,524,2343
11.09.2016 03:00,2899,37.03,548,539,2351
11.09.2016 04:00,2938,37.05,536,547,2402
11.09.2016 05:00,3007,38.49,537,570,2470
11.09.2016 06:00,3183,41.97,512,559,2671
11.09.2016 07:00,3587,47.57,484,532,3103
11.09.2016 08:00,3933,54.73,451,493,3482
11.09.2016 09:00,3901,56.56,463,450,3438
11.09.2016 10:00,3880,54.43,408,394,3472
11.09.2016 11:00,3877,50.91,355,353,3522
11.09.2016 12:00,3894,53.86,305,332,3589
11.09.2016 13:00,3825,54.48,292,307,3533
11.09.2016 14:00,3875,54.25,244,303,3631
11.09.2016 15:00,3914,52.97,202,283,3712
11.09.2016 16:00,3932,54.11,200,272,3732
11.09.2016 17:00,4033,63.74,174,242,3859
11.09.2016 18:00,4023,80.36,180,209,3843
11.09.2016 19:00,4027,62.43,146,202,3881
11.09.2016 20:00,3923,57.1,117,187,3806
11.09.2016 21:00,3746,48.22,88,171,3658
11.09.2016 22:00,3542,44.39,87,163,3455
11.09.2016 23:00,3318,41.92,89,163,3229
11.10.2016 00:00,3085,39.49,103,153,2982
11.10.2016 01:00,2969,38.76,84,118,2885
11.10.2016 02:00,2918,38.29,85,121,2833
11.10.2016 03:00,2881,37.9,98,120,2783
11.10.2016 04:00,2870,38.27,96,119,2774
11.10.2016 05:00,2980,39.38,81,143,2899
11.10.2016 06:00,3125,43.58,128,173,2997
11.10.2016 07:00,3553,50.62,166,190,3387
11.10.2016 08:00,3914,55.76,196,203,3718
11.10.2016 09:00,3926,60.36,222,220,3704
11.10.2016 10:00,3958,59.98,214,211,3744
11.10.2016 11:00,3999,58.52,186,210,3813
11.10.2016 12:00,3941,59.93,156,183,3785
11.10.2016 13:00,3835,61.1,133,174,3702
11.10.2016 14:00,3862,65.01,125,180,3737
11.10.2016 15:00,3796,61.72,148,193,3648
11.10.2016 16:00,3802,65.08,200,209,3602
11.10.2016 17:00,3872,75.06,260,229,3612
11.10.2016 18:00,3934,100.57,290,262,3644
11.10.2016 19:00,3922,69.54,321,322,3601
11.10.2016 20:00,3757,58.79,380,332,3377
11.10.2016 21:00,3593,49.71,383,354,3210
11.10.2016 22:00,3419,44.63,397,368,3022
11.10.2016 23:00,3210,42.6,392,386,2818
11.11.2016 00:00,3010,39.23,403,396,2607
11.11.2016 01:00,2952,39.73,400,429,2552
11.11.2016 02:00,2846,39.17,420,429,2426
11.11.2016 03:00,2847,38.98,457,431,2390
11.11.2016 04:00,2859,39.19,462,434,2397
11.11.2016 05:00,2921,40.33,438,438,2483
11.11.2016 06:00,3133,45.77,402,429,2731
11.11.2016 07:00,3617,53.27,350,419,3267
11.11.2016 08:00,3939,89.07,338,390,3601
11.11.2016 09:00,3992,99.93,295,349,3697
11.11.2016 10:00,3942,89.88,250,299,3692
11.11.2016 11:00,3931,60.04,192,253,3739
11.11.2016 12:00,3844,57.31,136,215,3708
11.11.2016 13:00,3750,56.28,98,167,3652
11.11.2016 14:00,3676,54.42,74,143,3602
11.11.2016 15:00,3561,51.7,63,123,3498
11.11.2016 16:00,3643,52.98,47,110,3596
11.11.2016 17:00,3817,59.34,42,101,3775
11.11.2016 18:00,3932,74.91,44,91,3888
11.11.2016 19:00,3878,56.94,41,76,3837
11.11.2016 20:00,3752,54.9,28,67,3724
11.11.2016 21:00,3592,45.79,22,60,3570
11.11.2016 22:00,3439,44.42,15,64,3424
11.11.2016 23:00,3322,44.5,8,66,3314
11.12.2016 00:00,3163,41.27,9,73,3154
11.12.2016 01:00,3061,41.2,10,77,3051
11.12.2016 02:00,3010,39.25,25,84,2985
11.12.2016 03:00,2996,38.51,51,95,2945
11.12.2016 04:00,2973,38.55,86,105,2887
11.12.2016 05:00,2986,39.3,110,115,2876
11.12.2016 06:00,3010,41.76,168,142,2842
11.12.2016 07:00,3138,43.41,206,163,2932
11.12.2016 08:00,3204,42.62,230,127,2974
11.12.2016 09:00,3369,43.25,224,127,3145
11.12.2016 10:00,3491,44.67,212,130,3279
11.12.2016 11:00,3469,45.4,173,122,3296
11.12.2016 12:00,3453,44.4,109,113,3344
11.12.2016 13:00,3390,42.99,75,108,3315
11.12.2016 14:00,3285,42.79,73,104,3212
11.12.2016 15:00,3237,42.33,68,112,3169
11.12.2016 16:00,3278,44.06,88,122,3190
11.12.2016 17:00,3552,47.03,106,131,3446
11.12.2016 18:00,3667,51.33,126,133,3541
11.12.2016 19:00,3607,48.2,131,148,3476
11.12.2016 20:00,3504,44.73,138,154,3366
11.12.2016 21:00,3349,42.68,148,165,3201
11.12.2016 22:00,3270,42.09,151,171,3119
11.12.2016 23:00,3127,41.35,163,182,2964
13.11.2016 00:00,3048,38.6,159,194,2889
13.11.2016 01:00,2961,38.55,145,177,2816
13.11.2016 02:00,2908,36.4,143,185,2765
13.11.2016 03:00,2933,35.27,134,190,2799
13.11.2016 04:00,2938,35.3,133,191,2805
13.11.2016 05:00,2958,36,134,188,2824
13.11.2016 06:00,2987,36.83,168,192,2819
13.11.2016 07:00,3087,38.44,199,200,2888
13.11.2016 08:00,3157,38.65,230,207,2927
13.11.2016 09:00,3238,40.35,254,219,2984
13.11.2016 10:00,3316,41.72,251,223,3065
13.11.2016 11:00,3327,41.99,227,220,3100
13.11.2016 12:00,3325,42.47,206,215,3119
13.11.2016 13:00,3279,41.98,219,218,3060
13.11.2016 14:00,3173,41.95,248,223,2925
13.11.2016 15:00,3115,42.16,276,239,2839
13.11.2016 16:00,3126,43.5,340,257,2786
13.11.2016 17:00,3319,45.84,415,284,2904
13.11.2016 18:00,3468,48.02,475,309,2993
13.11.2016 19:00,3406,47.13,516,332,2890
13.11.2016 20:00,3353,44.61,571,362,2782
13.11.2016 21:00,3196,42.93,616,392,2580
13.11.2016 22:00,3012,42.36,664,427,2348
13.11.2016 23:00,2928,40.28,637,458,2291
14.11.2016 00:00,2766,38.18,617,470,2149
14.11.2016 01:00,2744,37.79,598,518,2146
14.11.2016 02:00,2738,36.01,544,504,2194
14.11.2016 03:00,2776,35.13,490,496,2286
14.11.2016 04:00,2811,36.66,478,483,2333
14.11.2016 05:00,2843,39.3,510,475,2333
14.11.2016 06:00,3022,41.04,508,466,2514
14.11.2016 07:00,3520,45,472,456,3048
14.11.2016 08:00,3941,48.97,444,472,3497
14.11.2016 09:00,4017,48.64,421,469,3596
14.11.2016 10:00,3974,45.51,372,463,3602
14.11.2016 11:00,3919,43.94,356,448,3563
14.11.2016 12:00,3781,44.56,427,442,3354
14.11.2016 13:00,3652,44.42,468,452,3184
14.11.2016 14:00,3683,44.53,455,464,3228
14.11.2016 15:00,3737,44.53,419,488,3318
14.11.2016 16:00,3820,45.55,460,509,3360
14.11.2016 17:00,3919,47.17,538,541,3381
14.11.2016 18:00,3917,49.1,614,563,3303
14.11.2016 19:00,3739,45.85,709,603,3030
14.11.2016 20:00,3631,43.95,741,657,2890
14.11.2016 21:00,3506,41.62,715,711,2791
14.11.2016 22:00,3360,40.82,695,712,2665
14.11.2016 23:00,3142,39.21,707,732,2435
15.11.2016 00:00,2881,37.12,770,750,2111
15.11.2016 01:00,2727,34.13,825,778,1902
15.11.2016 02:00,2664,33.48,848,801,1816
15.11.2016 03:00,2649,33.17,859,813,1790
15.11.2016 04:00,2582,33.3,895,801,1687
15.11.2016 05:00,2662,34.75,844,781,1818
15.11.2016 06:00,2806,38.39,838,764,1968
15.11.2016 07:00,3190,41.52,798,726,2392
15.11.2016 08:00,3586,44.61,740,711,2846
15.11.2016 09:00,3644,45.02,706,684,2938
15.11.2016 10:00,3623,45.04,684,641,2939
15.11.2016 11:00,3630,43.52,708,616,2922
15.11.2016 12:00,3624,43.58,742,610,2882
15.11.2016 13:00,3520,44.21,759,607,2761
15.11.2016 14:00,3543,44.44,750,620,2793
15.11.2016 15:00,3558,43.6,739,643,2819
15.11.2016 16:00,3650,45.09,740,660,2910
15.11.2016 17:00,3632,45.5,807,684,2825
15.11.2016 18:00,3651,46.97,791,689,2860
15.11.2016 19:00,3610,45.11,708,702,2902
15.11.2016 20:00,3559,42.93,619,690,2940
15.11.2016 21:00,3350,40.66,601,642,2749
15.11.2016 22:00,3151,39.46,561,586,2590
15.11.2016 23:00,2892,38.64,568,535,2324
16.11.2016 00:00,2682,36.27,537,519,2145
16.11.2016 01:00,2603,35.55,424,447,2179
16.11.2016 02:00,2647,34.98,314,404,2333
16.11.2016 03:00,2628,34.5,288,365,2340
16.11.2016 04:00,2577,34.79,310,316,2267
16.11.2016 05:00,2643,37.41,236,266,2407
16.11.2016 06:00,2886,40.19,138,220,2748
16.11.2016 07:00,3317,45.22,96,179,3221
16.11.2016 08:00,3675,50.67,64,151,3611
16.11.2016 09:00,3706,52.23,70,135,3636
16.11.2016 10:00,3645,49.95,93,124,3552
16.11.2016 11:00,3639,44.09,126,141,3513
16.11.2016 12:00,3543,44.28,223,187,3320
16.11.2016 13:00,3486,45.29,299,237,3187
16.11.2016 14:00,3469,44.98,385,297,3084
16.11.2016 15:00,3489,45.25,460,374,3029
16.11.2016 16:00,3524,48.78,553,460,2971
16.11.2016 17:00,3572,48.68,682,563,2890
16.11.2016 18:00,3580,47.72,794,641,2786
16.11.2016 19:00,3473,45.82,851,729,2622
16.11.2016 20:00,3395,42.23,888,814,2507
16.11.2016 21:00,3249,39.62,923,883,2326
16.11.2016 22:00,3012,39.07,1000,937,2012
16.11.2016 23:00,2817,38.04,974,947,1843
17.11.2016 00:00,2735,34.95,835,947,1900
17.11.2016 01:00,2646,31.59,769,900,1877
17.11.2016 02:00,2574,31.01,768,860,1806
17.11.2016 03:00,2601,30.84,684,823,1917
17.11.2016 04:00,2596,31.39,670,779,1926
17.11.2016 05:00,2610,32.7,682,757,1928
17.11.2016 06:00,2764,37.01,709,735,2055
17.11.2016 07:00,3151,41.01,702,734,2449
17.11.2016 08:00,3564,44.45,671,711,2893
17.11.2016 09:00,3695,44.44,580,695,3115
17.11.2016 10:00,3612,44.2,551,658,3061
17.11.2016 11:00,3583,42.27,476,581,3107
17.11.2016 12:00,3600,42.85,403,559,3197
17.11.2016 13:00,3547,43.71,355,520,3192
17.11.2016 14:00,3563,42.69,331,508,3232
17.11.2016 15:00,3530,42.95,385,488,3145
17.11.2016 16:00,3533,44.29,450,499,3083
17.11.2016 17:00,3521,44.48,607,526,2914
17.11.2016 18:00,3547,45.34,673,559,2874
17.11.2016 19:00,3456,44.44,705,595,2751
17.11.2016 20:00,3427,42.31,668,650,2759
17.11.2016 21:00,3408,40.21,586,688,2822
17.11.2016 22:00,3209,39.04,630,700,2579
17.11.2016 23:00,2941,37.62,704,729,2237
18.11.2016 00:00,2685,34.86,820,800,1865
18.11.2016 01:00,2481,33.04,948,867,1533
18.11.2016 02:00,2335,32.05,1120,958,1215
18.11.2016 03:00,2334,30.74,1204,1056,1130
18.11.2016 04:00,2394,31.02,1248,1159,1146
18.11.2016 05:00,2522,32.43,1186,1204,1336
18.11.2016 06:00,2889,35.61,996,1202,1893
18.11.2016 07:00,3307,38.32,864,1128,2443
18.11.2016 08:00,3631,41.68,814,1020,2817
18.11.2016 09:00,3703,41.98,770,934,2933
18.11.2016 10:00,3742,41.9,629,828,3113
18.11.2016 11:00,3798,40.14,502,742,3296
18.11.2016 12:00,3821,39.74,475,705,3346
18.11.2016 13:00,3676,40.41,551,688,3125
18.11.2016 14:00,3559,39.79,646,735,2913
18.11.2016 15:00,3371,39.44,842,817,2529
18.11.2016 16:00,3393,39.71,933,903,2460
18.11.2016 17:00,3467,40.49,1016,996,2451
18.11.2016 18:00,3455,40.96,1129,1038,2326
18.11.2016 19:00,3338,40.19,1194,1088,2144
18.11.2016 20:00,3152,37.85,1243,1121,1909
18.11.2016 21:00,2994,36.71,1262,1124,1732
18.11.2016 22:00,2946,35.54,1156,1114,1790
18.11.2016 23:00,2815,34.49,1173,1116,1642
19.11.2016 00:00,2661,32.52,1183,1105,1478
19.11.2016 01:00,2658,29.87,1173,1210,1485
19.11.2016 02:00,2604,28.65,1164,1212,1440
19.11.2016 03:00,2563,27.98,1175,1203,1388
19.11.2016 04:00,2533,27.18,1172,1186,1361
19.11.2016 05:00,2490,28.42,1160,1143,1330
19.11.2016 06:00,2516,29.58,1144,1096,1372
19.11.2016 07:00,2587,32.56,1076,1041,1511
19.11.2016 08:00,2717,34.12,1052,994,1665
19.11.2016 09:00,2859,36.06,990,954,1869
19.11.2016 10:00,2962,36.61,941,901,2021
19.11.2016 11:00,3013,37.2,878,845,2135
19.11.2016 12:00,3065,37.17,701,759,2364
19.11.2016 13:00,3073,36.68,608,709,2465
19.11.2016 14:00,3071,36.33,546,645,2525
19.11.2016 15:00,2958,36.44,588,627,2370
19.11.2016 16:00,3044,37.77,580,620,2464
19.11.2016 17:00,3236,40.44,619,605,2617
19.11.2016 18:00,3334,41.31,599,610,2735
19.11.2016 19:00,3292,39.81,489,563,2803
19.11.2016 20:00,3140,38.14,475,530,2665
19.11.2016 21:00,2931,36.52,495,502,2436
19.11.2016 22:00,2767,35.7,474,467,2293
19.11.2016 23:00,2686,34.04,421,433,2265
20.11.2016 00:00,2609,33.05,399,433,2210
20.11.2016 01:00,2541,32.98,372,438,2169
20.11.2016 02:00,2482,32.18,428,460,2054
20.11.2016 03:00,2435,31.08,450,467,1985
20.11.2016 04:00,2423,32.08,481,479,1942
20.11.2016 05:00,2444,32.38,490,485,1954
20.11.2016 06:00,2526,32.77,463,494,2063
20.11.2016 07:00,2555,34,542,513,2013
20.11.2016 08:00,2675,35.33,549,528,2126
20.11.2016 09:00,2781,36.65,587,561,2194
20.11.2016 10:00,2840,37.52,618,568,2222
20.11.2016 11:00,2845,38.56,673,581,2172
20.11.2016 12:00,2733,38.53,869,656,1864
20.11.2016 13:00,2779,38.02,921,755,1858
20.11.2016 14:00,2770,37.51,1111,915,1659
20.11.2016 15:00,2783,37.08,1194,1003,1589
20.11.2016 16:00,2925,38.34,1232,1095,1693
20.11.2016 17:00,3133,39.32,1279,1160,1854
20.11.2016 18:00,3184,39.75,1336,1220,1848
20.11.2016 19:00,3163,38.81,1351,1275,1812
20.11.2016 20:00,3116,37.22,1332,1303,1784
20.11.2016 21:00,3021,36.21,1309,1324,1712
20.11.2016 22:00,2861,35.03,1295,1328,1566
20.11.2016 23:00,2619,33.82,1330,1325,1289
21.11.2016 00:00,2422,29.41,1358,1303,1064
21.11.2016 01:00,2454,17.01,1356,1373,1098
21.11.2016 02:00,2462,9.03,1315,1383,1147
21.11.2016 03:00,2449,9.79,1269,1335,1180
21.11.2016 04:00,2455,14.19,1221,1281,1234
21.11.2016 05:00,2434,28.69,1174,1179,1260
21.11.2016 06:00,2601,34.44,1063,1058,1538
21.11.2016 07:00,3090,38.71,901,928,2189
21.11.2016 08:00,3491,42.57,760,798,2731
21.11.2016 09:00,3513,42.98,639,669,2874
21.11.2016 10:00,3572,41.76,436,551,3136
21.11.2016 11:00,3590,40.16,326,452,3264
21.11.2016 12:00,3544,40.62,256,352,3288
21.11.2016 13:00,3473,41.7,213,321,3260
21.11.2016 14:00,3481,42.27,269,349,3212
21.11.2016 15:00,3419,42.63,329,369,3090
21.11.2016 16:00,3462,43.41,409,427,3053
21.11.2016 17:00,3578,43.65,456,477,3122
21.11.2016 18:00,3653,44.02,435,508,3218
21.11.2016 19:00,3510,42.38,454,522,3056
21.11.2016 20:00,3337,40.05,551,539,2786
21.11.2016 21:00,3156,37.82,584,542,2572
21.11.2016 22:00,3000,36.24,533,540,2467
21.11.2016 23:00,2786,34.88,565,553,2221
22.11.2016 00:00,2613,33.17,554,566,2059
22.11.2016 01:00,2397,32.94,614,578,1783
22.11.2016 02:00,2271,30.59,686,583,1585
22.11.2016 03:00,2283,29.5,647,593,1636
22.11.2016 04:00,2395,30.42,572,582,1823
22.11.2016 05:00,2320,32.84,638,565,1682
22.11.2016 06:00,2516,35.12,584,535,1932
22.11.2016 07:00,2939,40.86,563,533,2376
22.11.2016 08:00,3284,41.89,578,517,2706
22.11.2016 09:00,3373,42.4,572,520,2801
22.11.2016 10:00,3416,41.9,478,488,2938
22.11.2016 11:00,3500,41.08,373,457,3127
22.11.2016 12:00,3483,41.44,321,393,3162
22.11.2016 13:00,3390,41.68,290,321,3100
22.11.2016 14:00,3416,41.76,243,311,3173
22.11.2016 15:00,3415,42.62,227,282,3188
22.11.2016 16:00,3460,44.22,220,265,3240
22.11.2016 17:00,3623,46.14,184,249,3439
22.11.2016 18:00,3647,46.12,183,223,3464
22.11.2016 19:00,3536,44.18,180,206,3356
22.11.2016 20:00,3401,41.61,162,193,3239
22.11.2016 21:00,3265,40.46,153,183,3112
22.11.2016 22:00,3065,37.84,148,170,2917
22.11.2016 23:00,2815,36.28,156,161,2659
23.11.2016 00:00,2577,34.8,149,148,2428
23.11.2016 01:00,2485,33.78,93,122,2392
23.11.2016 02:00,2462,33.11,56,113,2406
23.11.2016 03:00,2380,32.8,66,106,2314
23.11.2016 04:00,2375,32.08,97,98,2278
23.11.2016 05:00,2385,33.54,129,100,2256
23.11.2016 06:00,2463,34.72,185,106,2278
23.11.2016 07:00,2906,39.94,204,116,2702
23.11.2016 08:00,3341,42.29,229,126,3112
23.11.2016 09:00,3334,44.01,264,127,3070
23.11.2016 10:00,3271,43.07,277,134,2994
23.11.2016 11:00,3351,42.04,216,141,3135
23.11.2016 12:00,3362,42.32,174,147,3188
23.11.2016 13:00,3355,42.77,146,167,3209
23.11.2016 14:00,3352,43.09,153,157,3199
23.11.2016 15:00,3351,43.05,206,170,3145
23.11.2016 16:00,3331,44.27,294,186,3037
23.11.2016 17:00,3447,46.23,378,220,3069
23.11.2016 18:00,3486,52.2,448,266,3038
23.11.2016 19:00,3384,44.08,505,319,2879
23.11.2016 20:00,3298,41.83,542,365,2756
23.11.2016 21:00,3184,38.99,538,408,2646
23.11.2016 22:00,2974,37.14,590,452,2384
23.11.2016 23:00,2772,35.8,647,511,2125
24.11.2016 00:00,2516,33.99,709,555,1807
24.11.2016 01:00,2444,32.66,762,648,1682
24.11.2016 02:00,2448,31.61,762,680,1686
24.11.2016 03:00,2442,30.8,755,673,1687
24.11.2016 04:00,2466,29.58,727,652,1739
24.11.2016 05:00,2566,30.52,651,617,1915
24.11.2016 06:00,2790,33.85,576,578,2214
24.11.2016 07:00,3175,37.39,531,512,2644
24.11.2016 08:00,3648,42.22,522,469,3126
24.11.2016 09:00,3675,44.04,521,416,3154
24.11.2016 10:00,3591,43.88,450,376,3141
24.11.2016 11:00,3598,42.64,342,336,3256
24.11.2016 12:00,3588,43.11,302,324,3286
24.11.2016 13:00,3458,42.87,334,281,3124
24.11.2016 14:00,3428,42.55,306,260,3122
24.11.2016 15:00,3416,42.77,318,257,3098
24.11.2016 16:00,3467,44.26,351,291,3116
24.11.2016 17:00,3711,49.36,356,352,3355
24.11.2016 18:00,3721,50.97,395,337,3326
24.11.2016 19:00,3561,45.23,403,298,3158
24.11.2016 20:00,3513,42.8,345,300,3168
24.11.2016 21:00,3398,39.37,275,298,3123
24.11.2016 22:00,3242,38.35,227,288,3015
24.11.2016 23:00,3042,35.88,205,262,2837
25.11.2016 00:00,2849,34.43,198,240,2651
25.11.2016 01:00,2711,34.7,188,203,2523
25.11.2016 02:00,2657,33.8,178,176,2479
25.11.2016 03:00,2648,33.08,156,161,2492
25.11.2016 04:00,2685,32.89,155,159,2530
25.11.2016 05:00,2682,33.98,170,150,2512
25.11.2016 06:00,2876,35.71,178,172,2698
25.11.2016 07:00,3256,40.02,207,139,3049
25.11.2016 08:00,3660,45.06,273,164,3387
25.11.2016 09:00,3628,48.49,395,197,3233
25.11.2016 10:00,3606,47.97,439,246,3167
25.11.2016 11:00,3596,47.42,473,308,3123
25.11.2016 12:00,3605,47.09,489,385,3116
25.11.2016 13:00,3564,47.95,511,433,3053
25.11.2016 14:00,3506,46.8,563,493,2943
25.11.2016 15:00,3437,46.77,604,560,2833
25.11.2016 16:00,3490,47.64,652,625,2838
25.11.2016 17:00,3542,48.76,746,672,2796
25.11.2016 18:00,3478,53.44,864,729,2614
25.11.2016 19:00,3387,47.13,927,778,2460
25.11.2016 20:00,3217,37.16,979,799,2238
25.11.2016 21:00,3130,35.08,920,827,2210
25.11.2016 22:00,2986,34.75,907,854,2079
25.11.2016 23:00,2788,34.39,930,889,1858
26.11.2016 00:00,2592,32.97,998,923,1594
26.11.2016 01:00,2435,31.72,1036,983,1399
26.11.2016 02:00,2421,30.13,1076,1035,1345
26.11.2016 03:00,2383,29.63,1153,1070,1230
26.11.2016 04:00,2357,29.02,1195,1099,1162
26.11.2016 05:00,2324,28.32,1225,1123,1099
26.11.2016 06:00,2400,29.47,1239,1150,1161
26.11.2016 07:00,2514,31.55,1261,1176,1253
26.11.2016 08:00,2660,32.58,1280,1207,1380
26.11.2016 09:00,2787,33.26,1315,1232,1472
26.11.2016 10:00,2929,33.91,1339,1257,1590
26.11.2016 11:00,3019,34.12,1357,1288,1662
26.11.2016 12:00,3063,34.09,1344,1308,1719
26.11.2016 13:00,3045,33.74,1353,1328,1692
26.11.2016 14:00,2985,33.27,1359,1319,1626
26.11.2016 15:00,2955,33.87,1331,1300,1624
26.11.2016 16:00,3061,34.75,1227,1271,1834
26.11.2016 17:00,3261,36.14,1154,1235,2107
26.11.2016 18:00,3298,36.19,1134,1197,2164
26.11.2016 19:00,3196,35.72,1106,1148,2090
26.11.2016 20:00,3155,34.26,1011,1100,2144
26.11.2016 21:00,3060,32.91,957,1076,2103
26.11.2016 22:00,2972,32.75,939,1058,2033
26.11.2016 23:00,2864,31.72,916,1036,1948
27.11.2016 00:00,2738,28.26,950,1023,1788
27.11.2016 01:00,2570,22.92,952,1007,1618
27.11.2016 02:00,2495,21.14,947,988,1548
27.11.2016 03:00,2489,20.25,935,992,1554
27.11.2016 04:00,2478,20.28,957,995,1521
27.11.2016 05:00,2484,20.95,971,996,1513
27.11.2016 06:00,2498,27,1018,1024,1480
27.11.2016 07:00,2629,28.71,1033,1040,1596
27.11.2016 08:00,2767,29.69,1033,1068,1734
27.11.2016 09:00,2844,32.12,1074,1079,1770
27.11.2016 10:00,3006,33.19,1059,1095,1947
27.11.2016 11:00,3044,34.24,1115,1121,1929
27.11.2016 12:00,3093,34.99,1139,1159,1954
27.11.2016 13:00,3061,34.44,1113,1155,1948
27.11.2016 14:00,3058,33.44,1131,1184,1927
27.11.2016 15:00,3051,33.53,1150,1199,1901
27.11.2016 16:00,3111,34.2,1210,1196,1901
27.11.2016 17:00,3386,36.28,1232,1198,2154
27.11.2016 18:00,3453,36.94,1210,1197,2243
27.11.2016 19:00,3437,36.34,1223,1204,2214
27.11.2016 20:00,3367,35.22,1219,1207,2148
27.11.2016 21:00,3271,34.69,1209,1200,2062
27.11.2016 22:00,3159,33.43,1179,1181,1980
27.11.2016 23:00,3044,32.9,1161,1168,1883
28.11.2016 00:00,2923,32.32,1122,1158,1801
28.11.2016 01:00,2787,28.96,1116,1135,1671
28.11.2016 02:00,2678,28.94,1135,1117,1543
28.11.2016 03:00,2690,28.45,1113,1084,1577
28.11.2016 04:00,2775,29.1,1082,1052,1693
28.11.2016 05:00,2819,32.49,1076,1004,1743
28.11.2016 06:00,3062,33.9,1008,955,2054
28.11.2016 07:00,3546,39.61,909,899,2637
28.11.2016 08:00,4048,46.22,820,841,3228
28.11.2016 09:00,4115,45.86,766,771,3349
28.11.2016 10:00,4106,43.95,644,700,3462
28.11.2016 11:00,4146,40.4,476,630,3670
28.11.2016 12:00,4185,43.53,344,564,3841
28.11.2016 13:00,4077,41,259,506,3818
28.11.2016 14:00,4069,44.14,229,480,3840
28.11.2016 15:00,4035,45.77,284,491,3751
28.11.2016 16:00,4026,51.38,413,517,3613
28.11.2016 17:00,4035,57.21,567,544,3468
28.11.2016 18:00,4056,65.11,630,569,3426
28.11.2016 19:00,3972,51.42,672,608,3300
28.11.2016 20:00,3792,42.93,796,649,2996
28.11.2016 21:00,3586,42.05,896,694,2690
28.11.2016 22:00,3340,38.35,1004,782,2336
28.11.2016 23:00,3079,36.14,1041,805,2038
29.11.2016 00:00,2835,34.59,1051,833,1784
29.11.2016 01:00,2747,35.4,1043,879,1704
29.11.2016 02:00,2678,34.81,1027,871,1651
29.11.2016 03:00,2610,33.98,1011,841,1599
29.11.2016 04:00,2606,33.88,946,803,1660
29.11.2016 05:00,2672,34.89,858,739,1814
29.11.2016 06:00,2812,36.75,835,667,1977
29.11.2016 07:00,3211,41.03,798,590,2413
29.11.2016 08:00,3609,45.08,754,529,2855
29.11.2016 09:00,3694,50.29,685,522,3009
29.11.2016 10:00,3714,45.4,574,473,3140
29.11.2016 11:00,3752,42.64,544,510,3208
29.11.2016 12:00,3694,41.19,558,500,3136
29.11.2016 13:00,3557,40.42,640,525,2917
29.11.2016 14:00,3574,40.74,689,575,2885
29.11.2016 15:00,3565,40.79,742,644,2823
29.11.2016 16:00,3657,41.4,811,721,2846
29.11.2016 17:00,3817,44.24,828,808,2989
29.11.2016 18:00,3808,43.5,913,868,2895
29.11.2016 19:00,3594,40.84,1056,904,2538
29.11.2016 20:00,3437,38.41,1167,979,2270
29.11.2016 21:00,3291,36.58,1183,1059,2108
29.11.2016 22:00,3100,35.03,1225,1098,1875
29.11.2016 23:00,2858,32.9,1273,1149,1585
30.11.2016 00:00,2570,30.38,1353,1199,1217
30.11.2016 01:00,2517,27.75,1364,1331,1153
30.11.2016 02:00,2480,27.36,1346,1342,1134
30.11.2016 03:00,2496,27.02,1285,1322,1211
30.11.2016 04:00,2484,25.3,1248,1301,1236
30.11.2016 05:00,2609,28.04,1230,1282,1379
30.11.2016 06:00,2866,31.51,1201,1256,1665
30.11.2016 07:00,3359,34.97,1170,1230,2189
30.11.2016 08:00,3699,39.08,1153,1212,2546
30.11.2016 09:00,3716,39.44,1162,1169,2554
30.11.2016 10:00,3695,38.53,1130,1141,2565
30.11.2016 11:00,3753,36.94,1085,1122,2668
30.11.2016 12:00,3780,37.91,1025,1073,2755
30.11.2016 13:00,3722,37.42,989,1020,2733
30.11.2016 14:00,3764,36.87,931,992,2833
30.11.2016 15:00,3725,38.44,908,939,2817
30.11.2016 16:00,3812,38.74,898,911,2914
30.11.2016 17:00,3974,41.41,821,863,3153
30.11.2016 18:00,3968,41.82,766,806,3202
30.11.2016 19:00,3877,39.95,685,739,3192
30.11.2016 20:00,3789,38.6,598,666,3191
30.11.2016 21:00,3598,35.94,563,587,3035
30.11.2016 22:00,3366,34.51,515,523,2851
30.11.2016 23:00,3151,33.1,459,478,2692
12.01.2016 00:00,3009,31.13,373,458,2636
12.01.2016 01:00,2828,31.38,307,319,2521
12.01.2016 02:00,2789,30.03,251,304,2538
12.01.2016 03:00,2821,30.75,193,297,2628
12.01.2016 04:00,2796,30.86,204,282,2592
12.01.2016 05:00,2858,31.7,197,293,2661
12.01.2016 06:00,3036,34.36,199,323,2837
12.01.2016 07:00,3432,38.79,273,355,3159
12.01.2016 08:00,3706,40.88,372,389,3334
12.01.2016 09:00,3740,42.82,447,426,3293
12.01.2016 10:00,3699,39.42,505,507,3194
12.01.2016 11:00,3763,38.98,561,588,3202
12.01.2016 12:00,3790,38.37,586,654,3204
12.01.2016 13:00,3823,38.85,564,720,3259
12.01.2016 14:00,3761,38.43,599,765,3162
12.01.2016 15:00,3649,38.32,672,799,2977
12.01.2016 16:00,3759,39,722,892,3037
12.01.2016 17:00,3947,40.51,800,958,3147
12.01.2016 18:00,3881,39.92,904,1001,2977
12.01.2016 19:00,3664,38.34,1004,986,2660
12.01.2016 20:00,3588,36.97,996,1012,2592
12.01.2016 21:00,3446,35.25,1055,1057,2391
12.01.2016 22:00,3284,33.95,1068,1067,2216
12.01.2016 23:00,3102,32.43,1084,1071,2018
12.02.2016 00:00,2901,29.41,1107,1075,1794
12.02.2016 01:00,2943,27.47,1084,1209,1859
12.02.2016 02:00,2994,27.28,1001,1165,1993
12.02.2016 03:00,2947,22.26,988,1096,1959
12.02.2016 04:00,2944,26.22,962,1037,1982
12.02.2016 05:00,2993,30.9,888,978,2105
12.02.2016 06:00,3178,33,854,942,2324
12.02.2016 07:00,3566,36.31,873,904,2693
12.02.2016 08:00,3966,41.62,886,865,3080
12.02.2016 09:00,3988,42.07,904,828,3084
12.02.2016 10:00,3990,40.08,837,819,3153
12.02.2016 11:00,3991,38.79,761,812,3230
12.02.2016 12:00,3948,38.83,716,788,3232
12.02.2016 13:00,3826,39.3,679,759,3147
12.02.2016 14:00,3763,40.07,672,738,3091
12.02.2016 15:00,3714,40.25,649,718,3065
12.02.2016 16:00,3758,41.48,643,704,3115
12.02.2016 17:00,3894,43.59,648,678,3246
12.02.2016 18:00,3874,43.85,664,658,3210
12.02.2016 19:00,3675,42.3,715,624,2960
12.02.2016 20:00,3522,38.85,708,602,2814
12.02.2016 21:00,3379,38.26,663,569,2716
12.02.2016 22:00,3278,38.41,607,548,2671
12.02.2016 23:00,3136,36.76,553,499,2583
12.03.2016 00:00,3053,34.87,470,457,2583
12.03.2016 01:00,3010,33.68,402,461,2608
12.03.2016 02:00,2963,33.11,357,419,2606
12.03.2016 03:00,2882,33.71,381,373,2501
12.03.2016 04:00,2855,33.49,400,342,2455
12.03.2016 05:00,2840,33.63,451,362,2389
12.03.2016 06:00,2825,33.67,506,335,2319
12.03.2016 07:00,2963,36.24,539,359,2424
12.03.2016 08:00,3093,36.14,594,380,2499
12.03.2016 09:00,3235,38.07,614,431,2621
12.03.2016 10:00,3347,39.44,604,423,2743
12.03.2016 11:00,3371,39.17,551,423,2820
12.03.2016 12:00,3294,38.22,468,389,2826
12.03.2016 13:00,3231,37.32,413,359,2818
12.03.2016 14:00,3204,37.07,360,335,2844
12.03.2016 15:00,3261,38.74,318,318,2943
12.03.2016 16:00,3384,40.48,295,275,3089
12.03.2016 17:00,3551,43.73,286,252,3265
12.03.2016 18:00,3603,44.06,217,244,3386
12.03.2016 19:00,3590,42.57,169,215,3421
12.03.2016 20:00,3529,40.04,109,198,3420
12.03.2016 21:00,3382,38.99,81,165,3301
12.03.2016 22:00,3241,39.75,85,127,3156
12.03.2016 23:00,3124,39.62,77,112,3047
12.04.2016 00:00,3028,36.57,71,147,2957
12.04.2016 01:00,2869,35.6,60,73,2809
12.04.2016 02:00,2798,33.9,67,71,2731
12.04.2016 03:00,2802,34.22,78,106,2724
12.04.2016 04:00,2757,34.28,88,82,2669
12.04.2016 05:00,2689,33.75,170,98,2519
12.04.2016 06:00,2675,33.75,217,112,2458
12.04.2016 07:00,2781,33.85,221,140,2560
12.04.2016 08:00,2881,33.92,239,165,2642
12.04.2016 09:00,2948,35.08,297,187,2651
12.04.2016 10:00,3086,36.28,315,210,2771
12.04.2016 11:00,3173,36.15,346,234,2827
12.04.2016 12:00,3213,36.33,356,257,2857
12.04.2016 13:00,3218,35.27,372,286,2846
12.04.2016 14:00,3179,34.32,381,310,2798
12.04.2016 15:00,3154,34.23,419,348,2735
12.04.2016 16:00,3282,35.65,440,414,2842
12.04.2016 17:00,3454,38.36,503,462,2951
12.04.2016 18:00,3472,38.29,569,503,2903
12.04.2016 19:00,3392,37.84,696,589,2696
12.04.2016 20:00,3289,36.49,756,637,2533
12.04.2016 21:00,3143,35.14,837,681,2306
12.04.2016 22:00,2982,34.43,882,707,2100
12.04.2016 23:00,2805,33.44,931,760,1874
12.05.2016 00:00,2666,32.21,952,798,1714
12.05.2016 01:00,2623,31.79,956,827,1667
12.05.2016 02:00,2544,31.23,1024,862,1520
12.05.2016 03:00,2492,30.96,1089,899,1403
12.05.2016 04:00,2484,30.94,1108,934,1376
12.05.2016 05:00,2557,31.49,1147,969,1410
12.05.2016 06:00,2713,32.76,1197,995,1516
12.05.2016 07:00,3142,36.91,1238,1007,1904
12.05.2016 08:00,3576,39.04,1234,1026,2342
12.05.2016 09:00,3696,38.97,1202,1027,2494
12.05.2016 10:00,3732,38.14,1180,1034,2552
12.05.2016 11:00,3776,37.67,1131,1028,2645
12.05.2016 12:00,3780,37.61,1085,1009,2695
12.05.2016 13:00,3824,38,980,984,2844
12.05.2016 14:00,3831,38.54,902,944,2929
12.05.2016 15:00,3800,38.92,870,887,2930
12.05.2016 16:00,3895,40.75,826,842,3069
12.05.2016 17:00,4021,42.56,728,783,3293
12.05.2016 18:00,4028,42.33,669,721,3359
12.05.2016 19:00,3910,41.02,607,642,3303
12.05.2016 20:00,3790,38.64,524,562,3266
12.05.2016 21:00,3594,37.58,472,498,3122
12.05.2016 22:00,3455,35.97,379,438,3076
12.05.2016 23:00,3190,33.87,333,378,2857
12.06.2016 00:00,2877,32.89,382,335,2495
12.06.2016 01:00,2718,32.46,392,301,2326
12.06.2016 02:00,2680,32.69,397,287,2283
12.06.2016 03:00,2671,33.1,411,284,2260
12.06.2016 04:00,2700,34.44,402,282,2298
12.06.2016 05:00,2796,36.82,371,275,2425
12.06.2016 06:00,3030,39.16,357,277,2673
12.06.2016 07:00,3509,45.95,355,266,3154
12.06.2016 08:00,3817,74.73,377,247,3440
12.06.2016 09:00,3904,80.09,331,225,3573
12.06.2016 10:00,3943,74.18,243,209,3700
12.06.2016 11:00,4013,64.8,162,193,3851
12.06.2016 12:00,3970,57.57,107,145,3863
12.06.2016 13:00,3854,55.4,81,105,3773
12.06.2016 14:00,3860,56.72,69,77,3791
12.06.2016 15:00,3901,62.08,64,64,3837
12.06.2016 16:00,3978,66.31,61,53,3917
12.06.2016 17:00,4157,72.97,52,49,4105
12.06.2016 18:00,4209,89.25,37,48,4172
12.06.2016 19:00,4200,80.73,15,47,4185
12.06.2016 20:00,4109,47.78,15,45,4094
12.06.2016 21:00,3936,44.92,23,57,3913
12.06.2016 22:00,3834,38.87,56,78,3778
12.06.2016 23:00,3568,36.8,131,100,3437
12.07.2016 00:00,3341,33.77,221,145,3120
12.07.2016 01:00,3125,31.94,374,226,2751
12.07.2016 02:00,3007,31.17,491,299,2516
12.07.2016 03:00,2908,30.81,552,294,2356
12.07.2016 04:00,2895,30.66,599,343,2296
12.07.2016 05:00,2965,30.97,557,388,2408
12.07.2016 06:00,3138,32.43,590,445,2548
12.07.2016 07:00,3517,37.09,670,480,2847
12.07.2016 08:00,3972,40.61,666,515,3306
12.07.2016 09:00,4017,45,680,537,3337
12.07.2016 10:00,3991,38.28,729,599,3262
12.07.2016 11:00,3967,37.82,846,680,3121
12.07.2016 12:00,3981,37.95,882,741,3099
12.07.2016 13:00,3958,38.43,909,806,3049
12.07.2016 14:00,3954,38.19,958,856,2996
12.07.2016 15:00,3921,38.17,1008,890,2913
12.07.2016 16:00,4068,40.08,1064,953,3004
12.07.2016 17:00,4022,41.04,1135,981,2887
12.07.2016 18:00,3993,40.69,1162,1020,2831
12.07.2016 19:00,3819,38.45,1194,1044,2625
12.07.2016 20:00,3746,36.03,1166,1073,2580
12.07.2016 21:00,3539,34.14,1188,1098,2351
12.07.2016 22:00,3352,32.19,1197,1118,2155
12.07.2016 23:00,3147,30.85,1188,1153,1959
12.08.2016 00:00,2836,29.26,1226,1170,1610
12.08.2016 01:00,2654,27.85,1228,1174,1426
12.08.2016 02:00,2567,27.22,1214,1180,1353
12.08.2016 03:00,2518,26.94,1242,1196,1276
12.08.2016 04:00,2389,27.08,1324,1214,1065
12.08.2016 05:00,2476,27.81,1368,1227,1108
12.08.2016 06:00,2640,28.05,1393,1256,1247
12.08.2016 07:00,3044,29.81,1409,1286,1635
12.08.2016 08:00,3405,33.11,1420,1297,1985
12.08.2016 09:00,3530,33.63,1395,1301,2135
12.08.2016 10:00,3536,33.88,1382,1303,2154
12.08.2016 11:00,3571,32.84,1381,1307,2190
12.08.2016 12:00,3535,32.01,1377,1287,2158
12.08.2016 13:00,3468,31.35,1370,1272,2098
12.08.2016 14:00,3458,31.93,1359,1255,2099
12.08.2016 15:00,3439,32.68,1345,1242,2094
12.08.2016 16:00,3543,33.43,1339,1243,2204
12.08.2016 17:00,3627,33.97,1357,1252,2270
12.08.2016 18:00,3680,33.92,1315,1251,2365
12.08.2016 19:00,3634,32.49,1272,1239,2362
12.08.2016 20:00,3553,31.95,1227,1219,2326
12.08.2016 21:00,3447,31.93,1142,1182,2305
12.08.2016 22:00,3332,30.7,992,1128,2340
12.08.2016 23:00,3063,29.9,938,1072,2125
12.09.2016 00:00,2849,27.27,868,1025,1981
12.09.2016 01:00,2623,27.1,815,892,1808
12.09.2016 02:00,2498,25.56,846,884,1652
12.09.2016 03:00,2455,25.12,859,891,1596
12.09.2016 04:00,2450,25.52,885,902,1565
12.09.2016 05:00,2496,26.86,915,937,1581
12.09.2016 06:00,2607,27.55,1005,958,1602
12.09.2016 07:00,3016,29.21,1071,994,1945
12.09.2016 08:00,3414,33.58,1135,1033,2279
12.09.2016 09:00,3526,34.09,1175,1079,2351
12.09.2016 10:00,3462,34.02,1221,1101,2241
12.09.2016 11:00,3494,33.49,1230,1113,2264
12.09.2016 12:00,3427,32.61,1237,1113,2190
12.09.2016 13:00,3348,32,1244,1115,2104
12.09.2016 14:00,3361,31.75,1183,1085,2178
12.09.2016 15:00,3286,33.54,1144,1027,2142
12.09.2016 16:00,3342,34,1078,955,2264
12.09.2016 17:00,3456,35.31,990,884,2466
12.09.2016 18:00,3497,35.82,871,813,2626
12.09.2016 19:00,3425,35.59,728,726,2697
12.09.2016 20:00,3399,33.88,536,650,2863
12.09.2016 21:00,3148,32.81,533,565,2615
12.09.2016 22:00,2897,31.68,502,491,2395
12.09.2016 23:00,2670,30.06,455,435,2215
12.10.2016 00:00,2537,28.54,417,425,2120
12.10.2016 01:00,2373,27.8,478,435,1895
12.10.2016 02:00,2258,26.85,544,486,1714
12.10.2016 03:00,2225,26.55,657,579,1568
12.10.2016 04:00,2157,26.65,794,675,1363
12.10.2016 05:00,2190,26.88,801,722,1389
12.10.2016 06:00,2265,27.47,785,744,1480
12.10.2016 07:00,2398,28.43,778,759,1620
12.10.2016 08:00,2500,28.69,805,741,1695
12.10.2016 09:00,2637,29.8,822,746,1815
12.10.2016 10:00,2738,32.29,830,727,1908
12.10.2016 11:00,2878,33.07,803,734,2075
12.10.2016 12:00,2910,33.77,795,728,2115
12.10.2016 13:00,2947,33,772,737,2175
12.10.2016 14:00,2920,33.15,798,755,2122
12.10.2016 15:00,3010,33.82,743,778,2267
12.10.2016 16:00,3019,34.32,838,816,2181
12.10.2016 17:00,3097,35.91,918,830,2179
12.10.2016 18:00,3155,36.05,914,864,2241
12.10.2016 19:00,3015,35.58,975,845,2040
12.10.2016 20:00,2960,34.5,892,830,2068
12.10.2016 21:00,2925,33.51,793,788,2132
12.10.2016 22:00,2818,33.58,727,759,2091
12.10.2016 23:00,2752,32.91,622,718,2130
12.11.2016 00:00,2602,31.03,547,644,2055
12.11.2016 01:00,2433,30.58,484,512,1949
12.11.2016 02:00,2367,29,432,467,1935
12.11.2016 03:00,2378,28.95,367,451,2011
12.11.2016 04:00,2353,28.08,313,427,2040
12.11.2016 05:00,2390,28.24,270,411,2120
12.11.2016 06:00,2475,28.63,220,402,2255
12.11.2016 07:00,2576,29.18,251,414,2325
12.11.2016 08:00,2717,30.45,271,426,2446
12.11.2016 09:00,2849,31.09,281,434,2568
12.11.2016 10:00,2981,32.81,271,434,2710
12.11.2016 11:00,3125,33.9,272,465,2853
12.11.2016 12:00,3242,34.21,282,482,2960
12.11.2016 13:00,3223,33.38,330,503,2893
12.11.2016 14:00,3186,32.92,404,524,2782
12.11.2016 15:00,3116,32.95,466,533,2650
12.11.2016 16:00,3181,34.22,486,523,2695
12.11.2016 17:00,3298,34.97,496,516,2802
12.11.2016 18:00,3389,35,456,520,2933
12.11.2016 19:00,3373,34.91,442,488,2931
12.11.2016 20:00,3289,34.04,454,487,2835
12.11.2016 21:00,3123,32.94,494,497,2629
12.11.2016 22:00,3026,32,536,532,2490
12.11.2016 23:00,2899,31.02,577,572,2322
12.12.2016 00:00,2796,29.58,587,633,2209
12.12.2016 01:00,2728,28.53,631,693,2097
12.12.2016 02:00,2700,28.82,653,700,2047
12.12.2016 03:00,2665,28.36,681,673,1984
12.12.2016 04:00,2735,28.47,580,606,2155
12.12.2016 05:00,2781,29.35,545,526,2236
12.12.2016 06:00,2959,32.92,503,441,2456
12.12.2016 07:00,3526,38.43,384,382,3142
12.12.2016 08:00,3978,55.99,321,322,3657
12.12.2016 09:00,4004,47.93,294,242,3710
12.12.2016 10:00,4029,47.6,215,187,3814
12.12.2016 11:00,4089,44.88,129,145,3960
12.12.2016 12:00,4027,45.42,69,108,3958
12.12.2016 13:00,3956,43.15,39,77,3917
12.12.2016 14:00,3973,43.73,34,63,3939
12.12.2016 15:00,3955,45.76,61,74,3894
12.12.2016 16:00,4090,53.11,120,127,3970
12.12.2016 17:00,4188,68.56,202,134,3986
12.12.2016 18:00,4164,78.69,311,172,3853
12.12.2016 19:00,4051,59.92,409,259,3642
12.12.2016 20:00,3890,42.94,487,293,3403
12.12.2016 21:00,3689,37.6,570,322,3119
12.12.2016 22:00,3462,36.08,616,370,2846
12.12.2016 23:00,3166,34.22,660,394,2506
13.12.2016 00:00,2924,32.53,662,419,2262
13.12.2016 01:00,2812,31.31,660,480,2152
13.12.2016 02:00,2765,30.83,611,467,2154
13.12.2016 03:00,2816,30.8,538,485,2278
13.12.2016 04:00,2841,30.87,452,423,2389
13.12.2016 05:00,2906,31.78,372,383,2534
13.12.2016 06:00,3071,32.84,336,370,2735
13.12.2016 07:00,3548,36.08,293,323,3255
13.12.2016 08:00,3930,43.57,276,308,3654
13.12.2016 09:00,3934,48.8,298,268,3636
13.12.2016 10:00,3831,44.41,321,256,3510
13.12.2016 11:00,3896,44.03,310,279,3586
13.12.2016 12:00,3912,44.09,313,291,3599
13.12.2016 13:00,3800,44.04,357,319,3443
13.12.2016 14:00,3806,44.08,405,343,3401
13.12.2016 15:00,3816,44.05,442,391,3374
13.12.2016 16:00,3940,45.37,447,439,3493
13.12.2016 17:00,3996,51.59,477,516,3519
13.12.2016 18:00,3954,48.72,505,510,3449
13.12.2016 19:00,3767,43.51,557,504,3210
13.12.2016 20:00,3629,35.75,568,488,3061
13.12.2016 21:00,3460,34.74,556,461,2904
13.12.2016 22:00,3279,33.79,506,432,2773
13.12.2016 23:00,3024,31.93,457,406,2567
14.12.2016 00:00,2738,31.17,471,376,2267
14.12.2016 01:00,2567,31.1,501,368,2066
14.12.2016 02:00,2523,30.72,525,366,1998
14.12.2016 03:00,2479,30.39,573,365,1906
14.12.2016 04:00,2513,30.89,580,370,1933
14.12.2016 05:00,2561,31.31,616,376,1945
14.12.2016 06:00,2779,33.24,637,384,2142
14.12.2016 07:00,3249,35.98,659,381,2590
14.12.2016 08:00,3705,41.25,635,378,3070
14.12.2016 09:00,3791,49.52,606,365,3185
14.12.2016 10:00,3847,43.61,527,363,3320
14.12.2016 11:00,3949,43.63,437,328,3512
14.12.2016 12:00,3891,45.07,332,285,3559
14.12.2016 13:00,3840,48.12,250,242,3590
14.12.2016 14:00,3809,48.71,195,209,3614
14.12.2016 15:00,3862,48.57,178,195,3684
14.12.2016 16:00,3991,56.18,199,190,3792
14.12.2016 17:00,4111,73.35,236,189,3875
14.12.2016 18:00,4134,74.56,244,179,3890
14.12.2016 19:00,4035,55.84,231,179,3804
14.12.2016 20:00,3993,45.15,185,169,3808
14.12.2016 21:00,3866,40.42,162,137,3704
14.12.2016 22:00,3706,36.03,141,118,3565
14.12.2016 23:00,3475,34.59,104,95,3371
15.12.2016 00:00,3260,33.64,85,76,3175
15.12.2016 01:00,3172,32.61,54,71,3118
15.12.2016 02:00,3142,31.59,28,52,3114
15.12.2016 03:00,3154,31.64,19,43,3135
15.12.2016 04:00,3148,31.7,21,39,3127
15.12.2016 05:00,3200,33.7,17,36,3183
15.12.2016 06:00,3441,34.76,17,51,3424
15.12.2016 07:00,3923,39.59,27,54,3896
15.12.2016 08:00,4288,65.06,48,51,4240
15.12.2016 09:00,4298,57.1,74,58,4224
15.12.2016 10:00,4262,45.6,90,79,4172
15.12.2016 11:00,4267,45.24,115,89,4152
15.12.2016 12:00,4224,45.08,140,92,4084
15.12.2016 13:00,4123,48.15,139,96,3984
15.12.2016 14:00,4124,53.64,129,114,3995
15.12.2016 15:00,4109,53.68,139,125,3970
15.12.2016 16:00,4146,58.79,152,122,3994
15.12.2016 17:00,4200,60.56,194,152,4006
15.12.2016 18:00,4188,68.35,218,164,3970
15.12.2016 19:00,4104,57.54,227,205,3877
15.12.2016 20:00,3991,44.82,221,198,3770
15.12.2016 21:00,3830,35.76,235,211,3595
15.12.2016 22:00,3633,34.65,250,222,3383
15.12.2016 23:00,3349,33.39,283,226,3066
16.12.2016 00:00,3074,31.55,333,253,2741
16.12.2016 01:00,2925,31.46,348,259,2577
16.12.2016 02:00,2869,31.07,324,245,2545
16.12.2016 03:00,2869,30.97,295,228,2574
16.12.2016 04:00,2881,31.03,268,223,2613
16.12.2016 05:00,2966,32.24,233,212,2733
16.12.2016 06:00,3159,35.2,193,196,2966
16.12.2016 07:00,3657,44.65,155,190,3502
16.12.2016 08:00,4078,57.04,127,176,3951
16.12.2016 09:00,4134,58.07,110,156,4024
16.12.2016 10:00,4082,50.09,120,138,3962
16.12.2016 11:00,4083,48.54,131,119,3952
16.12.2016 12:00,4062,49.41,135,116,3927
16.12.2016 13:00,4009,55.6,120,116,3889
16.12.2016 14:00,3975,56.17,95,108,3880
16.12.2016 15:00,3939,52.65,74,106,3865
16.12.2016 16:00,4008,61.9,54,104,3954
16.12.2016 17:00,4069,67.8,39,101,4030
16.12.2016 18:00,4059,71.79,28,91,4031
16.12.2016 19:00,3916,53.57,25,89,3891
16.12.2016 20:00,3767,48.69,29,81,3738
16.12.2016 21:00,3547,38.82,31,67,3516
16.12.2016 22:00,3365,37.67,27,57,3338
16.12.2016 23:00,3177,35.57,19,52,3158
17.12.2016 00:00,2993,34.71,22,54,2971
17.12.2016 01:00,2868,34.83,31,44,2837
17.12.2016 02:00,2806,33.9,32,43,2774
17.12.2016 03:00,2769,33,35,42,2734
17.12.2016 04:00,2778,31.64,30,41,2748
17.12.2016 05:00,2790,32.25,22,45,2768
17.12.2016 06:00,2851,33.72,23,60,2828
17.12.2016 07:00,2967,34.03,34,51,2933
17.12.2016 08:00,3176,33.66,36,53,3140
17.12.2016 09:00,3352,34.89,46,60,3306
17.12.2016 10:00,3449,36.79,61,66,3388
17.12.2016 11:00,3553,38.83,60,96,3493
17.12.2016 12:00,3637,39.29,55,113,3582
17.12.2016 13:00,3633,36.75,72,125,3561
17.12.2016 14:00,3619,34.73,93,141,3526
17.12.2016 15:00,3612,35,112,171,3500
17.12.2016 16:00,3702,36.81,125,204,3577
17.12.2016 17:00,3837,44.26,137,247,3700
17.12.2016 18:00,3785,42.61,208,274,3577
17.12.2016 19:00,3663,36.85,288,322,3375
17.12.2016 20:00,3513,35.55,334,373,3179
17.12.2016 21:00,3328,33.67,423,422,2905
17.12.2016 22:00,3153,33.57,495,463,2658
17.12.2016 23:00,2966,32.08,514,488,2452
18.12.2016 00:00,2864,30.54,496,492,2368
18.12.2016 01:00,2683,29.73,496,477,2187
18.12.2016 02:00,2593,28.8,453,444,2140
18.12.2016 03:00,2618,28.78,349,419,2269
18.12.2016 04:00,2646,28.67,246,368,2400
18.12.2016 05:00,2645,29.01,210,341,2435
18.12.2016 06:00,2664,29.71,160,299,2504
18.12.2016 07:00,2762,30.16,142,260,2620
18.12.2016 08:00,2867,30.75,124,242,2743
18.12.2016 09:00,3048,31.31,80,221,2968
18.12.2016 10:00,3176,33.37,63,189,3113
18.12.2016 11:00,3279,34.48,42,159,3237
18.12.2016 12:00,3311,34.94,53,127,3258
18.12.2016 13:00,3279,34.86,46,103,3233
18.12.2016 14:00,3300,34.84,25,84,3275
18.12.2016 15:00,3297,34.51,15,69,3282
18.12.2016 16:00,3383,35.15,20,64,3363
18.12.2016 17:00,3573,40.16,27,62,3546
18.12.2016 18:00,3559,47.47,33,53,3526
18.12.2016 19:00,3514,45.1,44,48,3470
18.12.2016 20:00,3423,38.18,63,48,3360
18.12.2016 21:00,3278,35.43,103,57,3175
18.12.2016 22:00,3098,34.36,136,73,2962
18.12.2016 23:00,2885,33.58,174,88,2711
19.12.2016 00:00,2685,30.97,222,111,2463
19.12.2016 01:00,2546,30.55,259,177,2287
19.12.2016 02:00,2479,30.27,304,213,2175
19.12.2016 03:00,2445,30.18,371,247,2074
19.12.2016 04:00,2440,30.26,416,277,2024
19.12.2016 05:00,2527,30.74,423,297,2104
19.12.2016 06:00,2755,31.67,413,316,2342
19.12.2016 07:00,3255,34.62,396,330,2859
19.12.2016 08:00,3626,39.39,445,334,3181
19.12.2016 09:00,3775,42.02,456,324,3319
19.12.2016 10:00,3730,37.48,459,334,3271
19.12.2016 11:00,3776,37.47,440,301,3336
19.12.2016 12:00,3781,34.7,435,299,3346
19.12.2016 13:00,3773,37.47,400,295,3373
19.12.2016 14:00,3766,38.87,397,281,3369
19.12.2016 15:00,3760,38.82,392,277,3368
19.12.2016 16:00,3827,40.09,404,279,3423
19.12.2016 17:00,3883,61.86,361,267,3522
19.12.2016 18:00,3927,67.67,328,259,3599
19.12.2016 19:00,3842,44.06,325,256,3517
19.12.2016 20:00,3717,34.25,299,257,3418
19.12.2016 21:00,3567,33.45,270,253,3297
19.12.2016 22:00,3402,32.67,287,256,3115
19.12.2016 23:00,3143,31.39,293,261,2850
20.12.2016 00:00,2899,30.52,299,266,2600
20.12.2016 01:00,2719,29.62,310,260,2409
20.12.2016 02:00,2631,28.94,315,258,2316
20.12.2016 03:00,2617,28.57,316,252,2301
20.12.2016 04:00,2624,28.79,317,241,2307
20.12.2016 05:00,2663,29.74,320,224,2343
20.12.2016 06:00,2870,30.43,263,206,2607
20.12.2016 07:00,3391,33.11,192,182,3199
20.12.2016 08:00,3800,43.79,171,170,3629
20.12.2016 09:00,3950,53.42,143,160,3807
20.12.2016 10:00,3881,53.43,132,151,3749
20.12.2016 11:00,3918,50.66,124,143,3794
20.12.2016 12:00,3951,43.03,113,141,3838
20.12.2016 13:00,3895,43,98,136,3797
20.12.2016 14:00,3913,50.68,94,137,3819
20.12.2016 15:00,3913,48.15,82,131,3831
20.12.2016 16:00,3993,49.36,79,136,3914
20.12.2016 17:00,4004,56.43,93,152,3911
20.12.2016 18:00,4025,64.74,131,178,3894
20.12.2016 19:00,3968,57.05,178,213,3790
20.12.2016 20:00,3847,44.03,235,266,3612
20.12.2016 21:00,3668,33.02,326,332,3342
20.12.2016 22:00,3528,31.36,370,405,3158
20.12.2016 23:00,3254,30.46,416,424,2838
21.12.2016 00:00,2935,29.32,514,472,2421
21.12.2016 01:00,2780,28.18,585,497,2195
21.12.2016 02:00,2702,27.8,624,520,2078
21.12.2016 03:00,2707,27.33,627,552,2080
21.12.2016 04:00,2724,27.76,673,599,2051
21.12.2016 05:00,2806,28.73,663,604,2143
21.12.2016 06:00,2922,29.7,739,624,2183
21.12.2016 07:00,3382,30.39,749,643,2633
21.12.2016 08:00,3866,31.88,738,700,3128
21.12.2016 09:00,3958,32.1,760,685,3198
21.12.2016 10:00,3927,30.78,808,706,3119
21.12.2016 11:00,3955,30.54,836,725,3119
21.12.2016 12:00,3851,30.51,930,711,2921
21.12.2016 13:00,3823,30.72,902,704,2921
21.12.2016 14:00,3896,30.68,826,697,3070
21.12.2016 15:00,3847,30.69,773,692,3074
21.12.2016 16:00,4011,30.89,706,696,3305
21.12.2016 17:00,4112,30.93,688,715,3424
21.12.2016 18:00,4062,30.65,775,773,3287
21.12.2016 19:00,3934,30.67,851,843,3083
21.12.2016 20:00,3811,30.27,883,870,2928
21.12.2016 21:00,3557,29.8,950,848,2607
21.12.2016 22:00,3283,29.65,984,837,2299
21.12.2016 23:00,3061,29.04,976,849,2085
22.12.2016 00:00,2864,27.84,906,810,1958
22.12.2016 01:00,2746,26.29,832,815,1914
22.12.2016 02:00,2669,25.9,777,769,1892
22.12.2016 03:00,2651,26.07,734,714,1917
22.12.2016 04:00,2687,26.32,644,663,2043
22.12.2016 05:00,2635,27.95,663,608,1972
22.12.2016 06:00,2752,28.96,663,560,2089
22.12.2016 07:00,3154,29.69,613,531,2541
22.12.2016 08:00,3602,39.04,558,496,3044
22.12.2016 09:00,3789,40.51,479,481,3310
22.12.2016 10:00,3763,42.11,463,451,3300
22.12.2016 11:00,3780,42.58,490,439,3290
22.12.2016 12:00,3699,49.01,539,433,3160
22.12.2016 13:00,3684,50.17,487,422,3197
22.12.2016 14:00,3658,49.71,506,443,3152
22.12.2016 15:00,3600,43.11,567,474,3033
22.12.2016 16:00,3594,45.69,611,475,2983
22.12.2016 17:00,3638,55.34,693,515,2945
22.12.2016 18:00,3623,53.15,783,567,2840
22.12.2016 19:00,3502,35.02,855,610,2647
22.12.2016 20:00,3359,29.87,918,670,2441
22.12.2016 21:00,3185,29.5,1001,732,2184
22.12.2016 22:00,3028,29.22,1004,789,2024
22.12.2016 23:00,2826,28.62,1019,843,1807
23.12.2016 00:00,2606,27.36,1066,885,1540
23.12.2016 01:00,2401,24.45,1108,932,1293
23.12.2016 02:00,2309,22.08,1095,938,1214
23.12.2016 03:00,2276,18.71,1112,944,1164
23.12.2016 04:00,2273,22.01,1111,954,1162
23.12.2016 05:00,2280,25.09,1112,960,1168
23.12.2016 06:00,2414,27,1132,968,1282
23.12.2016 07:00,2847,28.32,1032,978,1815
23.12.2016 08:00,3269,29.29,947,962,2322
23.12.2016 09:00,3436,29.9,907,919,2529
23.12.2016 10:00,3418,29.7,924,885,2494
23.12.2016 11:00,3428,29.54,873,857,2555
23.12.2016 12:00,3415,29.34,804,808,2611
23.12.2016 13:00,3345,29.35,772,767,2573
23.12.2016 14:00,3296,29.18,727,742,2569
23.12.2016 15:00,3268,29.13,696,706,2572
23.12.2016 16:00,3293,29.24,742,690,2551
23.12.2016 17:00,3333,29.38,863,709,2470
23.12.2016 18:00,3345,29.29,913,789,2432
23.12.2016 19:00,3211,28.95,980,851,2231
23.12.2016 20:00,3048,28.52,1079,946,1969
23.12.2016 21:00,2921,28.09,1129,1024,1792
23.12.2016 22:00,2788,27.84,1212,1119,1576
23.12.2016 23:00,2646,27.26,1318,1211,1328
24.12.2016 00:00,2505,23.51,1390,1304,1115
24.12.2016 01:00,2371,23.51,1436,1372,935
24.12.2016 02:00,2310,18.27,1449,1425,861
24.12.2016 03:00,2229,14.93,1460,1445,769
24.12.2016 04:00,2273,4.6,1453,1448,820
24.12.2016 05:00,2283,7.64,1435,1416,848
24.12.2016 06:00,2294,16.08,1403,1370,891
24.12.2016 07:00,2343,18.08,1384,1306,959
24.12.2016 08:00,2450,24.01,1353,1263,1097
24.12.2016 09:00,2623,25.18,1282,1227,1341
24.12.2016 10:00,2825,26.56,1214,1214,1611
24.12.2016 11:00,2994,27.04,1136,1185,1858
24.12.2016 12:00,2969,26.62,1173,1182,1796
24.12.2016 13:00,2878,25.86,1234,1206,1644
24.12.2016 14:00,2810,25.63,1261,1225,1549
24.12.2016 15:00,2819,25.47,1257,1250,1562
24.12.2016 16:00,2853,26.61,1229,1249,1624
24.12.2016 17:00,2949,27.19,1202,1229,1747
24.12.2016 18:00,2918,25.62,1182,1218,1736
24.12.2016 19:00,2807,23.8,1231,1214,1576
24.12.2016 20:00,2851,23.02,1133,1210,1718
24.12.2016 21:00,2899,22.84,1054,1213,1845
24.12.2016 22:00,2856,22.83,1024,1204,1832
24.12.2016 23:00,2711,22.76,1091,1180,1620
25.12.2016 00:00,2629,18.05,1096,1170,1533
25.12.2016 01:00,2535,16.11,1109,1185,1426
25.12.2016 02:00,2467,14.93,1143,1196,1324
25.12.2016 03:00,2450,4.02,1149,1211,1301
25.12.2016 04:00,2426,4.16,1151,1210,1275
25.12.2016 05:00,2390,14.92,1186,1216,1204
25.12.2016 06:00,2434,16.11,1181,1207,1253
25.12.2016 07:00,2527,16.12,1147,1184,1380
25.12.2016 08:00,2572,21.06,1112,1137,1460
25.12.2016 09:00,2678,24.05,986,1069,1692
25.12.2016 10:00,2758,24.44,868,957,1890
25.12.2016 11:00,2817,23.86,828,895,1989
25.12.2016 12:00,2884,24.79,722,813,2162
25.12.2016 13:00,2960,24.77,621,759,2339
25.12.2016 14:00,2857,24.93,690,753,2167
25.12.2016 15:00,2781,25.44,778,787,2003
25.12.2016 16:00,2815,26.21,852,845,1963
25.12.2016 17:00,2863,27.68,953,913,1910
25.12.2016 18:00,2846,27.26,1027,984,1819
25.12.2016 19:00,2793,27.02,1120,1057,1673
25.12.2016 20:00,2744,26.9,1158,1113,1586
25.12.2016 21:00,2602,25.99,1239,1154,1363
25.12.2016 22:00,2494,26.32,1274,1175,1220
25.12.2016 23:00,2322,25.46,1331,1196,991
26.12.2016 00:00,2230,24.54,1308,1228,922
26.12.2016 01:00,2089,23.37,1331,1247,758
26.12.2016 02:00,2040,15.95,1322,1246,718
26.12.2016 03:00,2009,13.08,1319,1237,690
26.12.2016 04:00,2038,11.91,1275,1228,763
26.12.2016 05:00,2075,12,1253,1212,822
26.12.2016 06:00,2113,15.92,1287,1225,826
26.12.2016 07:00,2353,20.82,1162,1232,1191
26.12.2016 08:00,2619,24,1015,1212,1604
26.12.2016 09:00,2755,24.83,987,1183,1768
26.12.2016 10:00,2836,24.3,1015,1160,1821
26.12.2016 11:00,2847,24.81,1126,1184,1721
26.12.2016 12:00,2845,24.91,1207,1235,1638
26.12.2016 13:00,2816,25,1296,1282,1520
26.12.2016 14:00,2871,24.38,1327,1332,1544
26.12.2016 15:00,2918,25.23,1351,1371,1567
26.12.2016 16:00,3090,26.05,1342,1387,1748
26.12.2016 17:00,3243,27.06,1334,1393,1909
26.12.2016 18:00,3232,27.26,1376,1402,1856
26.12.2016 19:00,3188,27.22,1385,1404,1803
26.12.2016 20:00,3110,25.95,1411,1415,1699
26.12.2016 21:00,3045,25.46,1379,1423,1666
26.12.2016 22:00,2976,25.44,1275,1401,1701
26.12.2016 23:00,2916,25.33,1182,1380,1734
27.12.2016 00:00,2811,24.31,1118,1351,1693
27.12.2016 01:00,2749,15.99,1040,443.144979,1709
27.12.2016 02:00,2723,15.96,988,443.144979,1735
27.12.2016 03:00,2672,15.54,1054,443.144979,1618
27.12.2016 04:00,2616,14.94,1112,443.144979,1504
27.12.2016 05:00,2624,15.97,1176,443.144979,1448
27.12.2016 06:00,2724,24.9,1185,443.144979,1539
27.12.2016 07:00,3034,26.89,1200,443.144979,1834
27.12.2016 08:00,3237,27.7,1232,443.144979,2005
27.12.2016 09:00,3297,27.92,1281,443.144979,2016
27.12.2016 10:00,3320,28.04,1290,443.144979,2030
27.12.2016 11:00,3384,28.14,1288,443.144979,2096
27.12.2016 12:00,3439,28.39,1303,443.144979,2136
27.12.2016 13:00,3403,28.42,1289,443.144979,2114
27.12.2016 14:00,3383,28.53,1300,443.144979,2083
27.12.2016 15:00,3354,28.68,1258,443.144979,2096
27.12.2016 16:00,3502,28.88,1181,443.144979,2321
27.12.2016 17:00,3697,29.58,1088,443.144979,2609
27.12.2016 18:00,3723,29.76,1014,443.144979,2709
27.12.2016 19:00,3669,29.69,933,443.144979,2736
27.12.2016 20:00,3575,29.45,864,443.144979,2711
27.12.2016 21:00,3500,29.21,785,443.144979,2715
27.12.2016 22:00,3236,28.5,764,443.144979,2472
27.12.2016 23:00,3041,27.01,717,443.144979,2324
28.12.2016 00:00,2862,24.72,680,443.144979,2182
28.12.2016 01:00,2723,25.37,658,638,2065
28.12.2016 02:00,2679,25.19,575,566,2104
28.12.2016 03:00,2654,25.24,511,511,2143
28.12.2016 04:00,2685,25.63,458,463,2227
28.12.2016 05:00,2708,27.26,436,418,2272
28.12.2016 06:00,2826,28.78,423,378,2403
28.12.2016 07:00,3188,30,391,351,2797
28.12.2016 08:00,3520,32.07,370,319,3150
28.12.2016 09:00,3658,33.93,358,288,3300
28.12.2016 10:00,3760,33.44,284,266,3476
28.12.2016 11:00,3837,33.01,197,226,3640
28.12.2016 12:00,3831,33.36,136,188,3695
28.12.2016 13:00,3751,33.8,105,160,3646
28.12.2016 14:00,3709,34.21,76,123,3633
28.12.2016 15:00,3685,35.01,66,112,3619
28.12.2016 16:00,3775,36.41,75,101,3700
28.12.2016 17:00,3891,42.3,97,97,3794
28.12.2016 18:00,3906,46.54,101,93,3805
28.12.2016 19:00,3820,38.59,113,86,3707
28.12.2016 20:00,3663,33.13,144,89,3519
28.12.2016 21:00,3448,31.85,233,124,3215
28.12.2016 22:00,3160,30.73,387,175,2773
28.12.2016 23:00,2885,30.02,533,227,2352
29.12.2016 00:00,2711,29.36,553,275,2158
29.12.2016 01:00,2582,29.31,587,341,1995
29.12.2016 02:00,2476,28.79,623,383,1853
29.12.2016 03:00,2396,28.33,687,414,1709
29.12.2016 04:00,2468,28.35,651,446,1817
29.12.2016 05:00,2479,29.02,662,469,1817
29.12.2016 06:00,2642,29.94,627,483,2015
29.12.2016 07:00,2977,30.68,594,498,2383
29.12.2016 08:00,3327,31.08,611,527,2716
29.12.2016 09:00,3474,32.11,639,551,2835
29.12.2016 10:00,3474,31.53,692,573,2782
29.12.2016 11:00,3516,31.04,726,621,2790
29.12.2016 12:00,3470,31.06,769,651,2701
29.12.2016 13:00,3463,31.63,795,679,2668
29.12.2016 14:00,3413,31.11,880,703,2533
29.12.2016 15:00,3407,31.08,904,712,2503
29.12.2016 16:00,3521,31.8,878,719,2643
29.12.2016 17:00,3612,32.56,888,723,2724
29.12.2016 18:00,3611,36,860,714,2751
29.12.2016 19:00,3534,31.25,817,703,2717
29.12.2016 20:00,3424,30.5,792,692,2632
29.12.2016 21:00,3286,30.2,771,691,2515
29.12.2016 22:00,3155,29.98,766,689,2389
29.12.2016 23:00,3036,29.43,734,688,2302
30.12.2016 00:00,2921,28.73,682,686,2239
30.12.2016 01:00,2774,27.08,641,680,2133
30.12.2016 02:00,2755,26.15,635,700,2120
30.12.2016 03:00,2706,25.2,661,710,2045
30.12.2016 04:00,2694,25.24,691,722,2003
30.12.2016 05:00,2685,26.44,762,738,1923
30.12.2016 06:00,2821,28.32,776,757,2045
30.12.2016 07:00,3155,29.4,744,771,2411
30.12.2016 08:00,3470,29.97,742,784,2728
30.12.2016 09:00,3610,30.14,759,794,2851
30.12.2016 10:00,3628,30.23,779,802,2849
30.12.2016 11:00,3602,30.21,805,802,2797
30.12.2016 12:00,3527,30.17,815,796,2712
30.12.2016 13:00,3502,30.08,794,788,2708
30.12.2016 14:00,3424,29.99,823,792,2601
30.12.2016 15:00,3301,29.96,904,791,2397
30.12.2016 16:00,3349,30.14,905,792,2444
30.12.2016 17:00,3440,30.39,898,806,2542
30.12.2016 18:00,3425,30.34,926,819,2499
30.12.2016 19:00,3321,30.15,932,826,2389
30.12.2016 20:00,3222,30.18,920,842,2302
30.12.2016 21:00,3009,29.5,940,859,2069
30.12.2016 22:00,2761,28.87,1032,871,1729
30.12.2016 23:00,2520,27.64,1096,896,1424
31.12.2016 00:00,2333,25.03,1084,906,1249
31.12.2016 01:00,2274,21.87,1068,941,1206
31.12.2016 02:00,2208,14.12,1060,957,1148
31.12.2016 03:00,2152,9.99,1086,969,1066
31.12.2016 04:00,2116,4.28,1105,986,1011
31.12.2016 05:00,2109,4.04,1114,994,995
31.12.2016 06:00,2142,17.31,1128,999,1014
31.12.2016 07:00,2194,21.43,1172,1015,1022
31.12.2016 08:00,2292,25.09,1199,1033,1093
31.12.2016 09:00,2479,26.22,1178,1055,1301
31.12.2016 10:00,2576,26.84,1204,1071,1372
31.12.2016 11:00,2699,27.9,1223,1089,1476
31.12.2016 12:00,2835,27.95,1145,1086,1690
31.12.2016 13:00,2897,27.73,1137,1102,1760
31.12.2016 14:00,2912,27.16,1141,1097,1771
31.12.2016 15:00,2875,27.85,1172,1081,1703
31.12.2016 16:00,2940,29.11,1192,1075,1748
31.12.2016 17:00,3024,29.5,1205,1079,1819
31.12.2016 18:00,3045,29.58,1190,1090,1855
31.12.2016 19:00,2931,29.23,1182,1087,1749
31.12.2016 20:00,2756,27.82,1171,1081,1585
31.12.2016 21:00,2619,27.16,1189,1078,1430
31.12.2016 22:00,2454,26.57,1214,1075,1240
31.12.2016 23:00,2334,26.21,1237,1073,1097
01.01.2017 00:00,2161,25.95,1216,958,945
